data,coduf,regiao,continente,casosNovos,casosAcumulado,obitosNovos,obitosAcumulado
2020-03-29,AF,Afghanistan,EMRO,11,91,0,2
2020-03-30,AF,Afghanistan,EMRO,15,106,1,3
2020-03-31,AF,Afghanistan,EMRO,8,114,1,4
2020-04-01,AF,Afghanistan,EMRO,52,166,0,4
2020-04-02,AF,Afghanistan,EMRO,26,192,0,4
2020-04-03,AF,Afghanistan,EMRO,2,194,0,4
2020-04-04,AF,Afghanistan,EMRO,60,254,1,5
2020-04-05,AF,Afghanistan,EMRO,20,274,0,5
2020-04-06,AF,Afghanistan,EMRO,25,299,2,7
2020-04-07,AF,Afghanistan,EMRO,38,337,0,7
2020-04-08,AF,Afghanistan,EMRO,30,367,4,11
2020-04-09,AF,Afghanistan,EMRO,56,423,3,14
2020-04-10,AF,Afghanistan,EMRO,21,444,1,15
2020-04-11,AF,Afghanistan,EMRO,40,484,0,15
2020-04-12,AF,Afghanistan,EMRO,37,521,0,15
2020-04-13,AF,Afghanistan,EMRO,34,555,3,18
2020-04-14,AF,Afghanistan,EMRO,52,607,1,19
2020-04-15,AF,Afghanistan,EMRO,58,665,3,22
2020-04-16,AF,Afghanistan,EMRO,56,721,3,25
2020-04-17,AF,Afghanistan,EMRO,73,794,4,29
2020-04-18,AF,Afghanistan,EMRO,51,845,1,30
2020-04-19,AF,Afghanistan,EMRO,63,908,0,30
2020-04-20,AF,Afghanistan,EMRO,25,933,0,30
2020-04-21,AF,Afghanistan,EMRO,63,996,3,33
2020-04-22,AF,Afghanistan,EMRO,30,1026,3,36
2020-04-23,AF,Afghanistan,EMRO,66,1092,0,36
2020-04-24,AF,Afghanistan,EMRO,84,1176,4,40
2020-04-25,AF,Afghanistan,EMRO,50,1226,0,40
2020-04-26,AF,Afghanistan,EMRO,104,1330,3,43
2020-04-27,AF,Afghanistan,EMRO,133,1463,6,49
2020-04-28,AF,Afghanistan,EMRO,68,1531,1,50
2020-04-29,AF,Afghanistan,EMRO,172,1703,10,60
2020-04-30,AF,Afghanistan,EMRO,124,1827,0,60
2020-05-01,AF,Afghanistan,EMRO,110,1937,0,60
2020-05-02,AF,Afghanistan,EMRO,234,2171,4,64
2020-05-03,AF,Afghanistan,EMRO,0,2171,0,64
2020-05-04,AF,Afghanistan,EMRO,298,2469,8,72
2020-05-05,AF,Afghanistan,EMRO,0,2469,0,72
2020-05-06,AF,Afghanistan,EMRO,0,2469,0,72
2020-05-07,AF,Afghanistan,EMRO,755,3224,23,95
2020-05-08,AF,Afghanistan,EMRO,168,3392,9,104
2020-05-09,AF,Afghanistan,EMRO,171,3563,1,105
2020-05-10,AF,Afghanistan,EMRO,0,3563,0,105
2020-05-11,AF,Afghanistan,EMRO,478,4041,10,115
2020-05-12,AF,Afghanistan,EMRO,361,4402,4,119
2020-05-13,AF,Afghanistan,EMRO,262,4664,2,121
2020-05-14,AF,Afghanistan,EMRO,303,4967,6,127
2020-05-15,AF,Afghanistan,EMRO,259,5226,5,132
2020-05-16,AF,Afghanistan,EMRO,413,5639,4,136
2020-05-17,AF,Afghanistan,EMRO,414,6053,17,153
2020-05-18,AF,Afghanistan,EMRO,349,6402,15,168
2020-05-19,AF,Afghanistan,EMRO,262,6664,1,169
2020-05-20,AF,Afghanistan,EMRO,408,7072,4,173
2020-05-21,AF,Afghanistan,EMRO,581,7653,4,177
2020-05-22,AF,Afghanistan,EMRO,567,8220,12,189
2020-05-23,AF,Afghanistan,EMRO,910,9130,12,201
2020-05-24,AF,Afghanistan,EMRO,736,9866,10,211
2020-05-25,AF,Afghanistan,EMRO,716,10582,7,218
2020-05-26,AF,Afghanistan,EMRO,512,11094,1,219
2020-05-27,AF,Afghanistan,EMRO,737,11831,1,220
2020-05-28,AF,Afghanistan,EMRO,548,12379,6,226
2020-05-29,AF,Afghanistan,EMRO,637,13016,9,235
2020-05-30,AF,Afghanistan,EMRO,643,13659,11,246
2020-05-31,AF,Afghanistan,EMRO,784,14443,2,248
2020-06-01,AF,Afghanistan,EMRO,651,15094,2,250
2020-06-02,AF,Afghanistan,EMRO,656,15750,15,265
2020-06-03,AF,Afghanistan,EMRO,742,16492,5,270
2020-06-04,AF,Afghanistan,EMRO,775,17267,24,294
2020-06-05,AF,Afghanistan,EMRO,624,17891,5,299
2020-06-06,AF,Afghanistan,EMRO,1078,18969,10,309
2020-06-07,AF,Afghanistan,EMRO,582,19551,18,327
2020-06-08,AF,Afghanistan,EMRO,791,20342,30,357
2020-03-29,AL,Albania,EURO,12,186,2,8
2020-03-30,AL,Albania,EURO,11,197,2,10
2020-03-31,AL,Albania,EURO,15,212,0,10
2020-04-01,AL,Albania,EURO,11,223,1,11
2020-04-02,AL,Albania,EURO,20,243,2,13
2020-04-03,AL,Albania,EURO,16,259,2,15
2020-04-04,AL,Albania,EURO,18,277,1,16
2020-04-05,AL,Albania,EURO,27,304,1,17
2020-04-06,AL,Albania,EURO,29,333,1,18
2020-04-07,AL,Albania,EURO,28,361,2,20
2020-04-08,AL,Albania,EURO,16,377,1,21
2020-04-09,AL,Albania,EURO,6,383,1,22
2020-04-10,AL,Albania,EURO,17,400,0,22
2020-04-11,AL,Albania,EURO,9,409,0,22
2020-04-12,AL,Albania,EURO,7,416,1,23
2020-04-13,AL,Albania,EURO,17,433,0,23
2020-04-14,AL,Albania,EURO,13,446,0,23
2020-04-15,AL,Albania,EURO,21,467,0,23
2020-04-16,AL,Albania,EURO,8,475,1,24
2020-04-17,AL,Albania,EURO,19,494,1,25
2020-04-18,AL,Albania,EURO,24,518,1,26
2020-04-19,AL,Albania,EURO,21,539,0,26
2020-04-20,AL,Albania,EURO,9,548,0,26
2020-04-21,AL,Albania,EURO,14,562,0,26
2020-04-22,AL,Albania,EURO,22,584,0,26
2020-04-23,AL,Albania,EURO,25,609,0,26
2020-04-24,AL,Albania,EURO,25,634,1,27
2020-04-25,AL,Albania,EURO,29,663,0,27
2020-04-26,AL,Albania,EURO,15,678,0,27
2020-04-27,AL,Albania,EURO,34,712,0,27
2020-04-28,AL,Albania,EURO,14,726,1,28
2020-04-29,AL,Albania,EURO,10,736,0,28
2020-04-30,AL,Albania,EURO,14,750,2,30
2020-05-01,AL,Albania,EURO,16,766,0,30
2020-05-02,AL,Albania,EURO,7,773,1,31
2020-05-03,AL,Albania,EURO,9,782,0,31
2020-05-04,AL,Albania,EURO,7,789,0,31
2020-05-05,AL,Albania,EURO,6,795,0,31
2020-05-06,AL,Albania,EURO,8,803,0,31
2020-05-07,AL,Albania,EURO,17,820,0,31
2020-05-08,AL,Albania,EURO,12,832,0,31
2020-05-09,AL,Albania,EURO,10,842,0,31
2020-05-10,AL,Albania,EURO,8,850,0,31
2020-05-11,AL,Albania,EURO,6,856,0,31
2020-05-12,AL,Albania,EURO,12,868,0,31
2020-05-13,AL,Albania,EURO,4,872,0,31
2020-05-14,AL,Albania,EURO,4,876,0,31
2020-05-15,AL,Albania,EURO,4,880,0,31
2020-05-16,AL,Albania,EURO,18,898,0,31
2020-05-17,AL,Albania,EURO,18,916,0,31
2020-05-18,AL,Albania,EURO,17,933,0,31
2020-05-19,AL,Albania,EURO,13,946,0,31
2020-05-20,AL,Albania,EURO,2,948,0,31
2020-05-21,AL,Albania,EURO,1,949,0,31
2020-05-22,AL,Albania,EURO,15,964,0,31
2020-05-23,AL,Albania,EURO,5,969,0,31
2020-05-24,AL,Albania,EURO,12,981,0,31
2020-05-25,AL,Albania,EURO,8,989,0,31
2020-05-26,AL,Albania,EURO,9,998,1,32
2020-05-27,AL,Albania,EURO,6,1004,0,32
2020-05-28,AL,Albania,EURO,25,1029,1,33
2020-05-29,AL,Albania,EURO,21,1050,0,33
2020-05-30,AL,Albania,EURO,26,1076,0,33
2020-05-31,AL,Albania,EURO,23,1099,0,33
2020-06-01,AL,Albania,EURO,23,1122,0,33
2020-06-02,AL,Albania,EURO,15,1137,0,33
2020-06-03,AL,Albania,EURO,6,1143,0,33
2020-06-04,AL,Albania,EURO,21,1164,0,33
2020-06-05,AL,Albania,EURO,20,1184,0,33
2020-06-06,AL,Albania,EURO,13,1197,0,33
2020-06-07,AL,Albania,EURO,15,1212,0,33
2020-06-08,AL,Albania,EURO,20,1232,1,34
2020-03-29,DZ,Algeria,AFRO,45,454,0,30
2020-03-30,DZ,Algeria,AFRO,57,511,0,30
2020-03-31,DZ,Algeria,AFRO,73,584,5,35
2020-04-01,DZ,Algeria,AFRO,132,716,9,44
2020-04-02,DZ,Algeria,AFRO,106,822,14,58
2020-04-03,DZ,Algeria,AFRO,164,986,25,83
2020-04-04,DZ,Algeria,AFRO,185,1171,22,105
2020-04-05,DZ,Algeria,AFRO,80,1251,25,130
2020-04-06,DZ,Algeria,AFRO,70,1321,22,152
2020-04-07,DZ,Algeria,AFRO,102,1423,21,173
2020-04-08,DZ,Algeria,AFRO,45,1468,21,194
2020-04-09,DZ,Algeria,AFRO,104,1572,12,206
2020-04-10,DZ,Algeria,AFRO,94,1666,30,236
2020-04-11,DZ,Algeria,AFRO,95,1761,21,257
2020-04-12,DZ,Algeria,AFRO,64,1825,19,276
2020-04-13,DZ,Algeria,AFRO,89,1914,18,294
2020-04-14,DZ,Algeria,AFRO,69,1983,20,314
2020-04-15,DZ,Algeria,AFRO,87,2070,13,327
2020-04-16,DZ,Algeria,AFRO,90,2160,10,337
2020-04-17,DZ,Algeria,AFRO,108,2268,12,349
2020-04-18,DZ,Algeria,AFRO,150,2418,16,365
2020-04-19,DZ,Algeria,AFRO,116,2534,3,368
2020-04-20,DZ,Algeria,AFRO,95,2629,8,376
2020-04-21,DZ,Algeria,AFRO,89,2718,9,385
2020-04-22,DZ,Algeria,AFRO,93,2811,8,393
2020-04-23,DZ,Algeria,AFRO,99,2910,10,403
2020-04-24,DZ,Algeria,AFRO,97,3007,5,408
2020-04-25,DZ,Algeria,AFRO,120,3127,8,416
2020-04-26,DZ,Algeria,AFRO,129,3256,0,416
2020-04-27,DZ,Algeria,AFRO,126,3382,6,422
2020-04-28,DZ,Algeria,AFRO,135,3517,7,429
2020-04-29,DZ,Algeria,AFRO,132,3649,5,434
2020-04-30,DZ,Algeria,AFRO,199,3848,7,441
2020-05-01,DZ,Algeria,AFRO,158,4006,6,447
2020-05-02,DZ,Algeria,AFRO,148,4154,3,450
2020-05-03,DZ,Algeria,AFRO,141,4295,6,456
2020-05-04,DZ,Algeria,AFRO,179,4474,4,460
2020-05-05,DZ,Algeria,AFRO,174,4648,2,462
2020-05-06,DZ,Algeria,AFRO,190,4838,5,467
2020-05-07,DZ,Algeria,AFRO,159,4997,6,473
2020-05-08,DZ,Algeria,AFRO,185,5182,7,480
2020-05-09,DZ,Algeria,AFRO,187,5369,5,485
2020-05-10,DZ,Algeria,AFRO,189,5558,6,491
2020-05-11,DZ,Algeria,AFRO,165,5723,8,499
2020-05-12,DZ,Algeria,AFRO,168,5891,5,504
2020-05-13,DZ,Algeria,AFRO,176,6067,8,512
2020-05-14,DZ,Algeria,AFRO,186,6253,7,519
2020-05-15,DZ,Algeria,AFRO,189,6442,7,526
2020-05-16,DZ,Algeria,AFRO,188,6630,7,533
2020-05-17,DZ,Algeria,AFRO,191,6821,6,539
2020-05-18,DZ,Algeria,AFRO,198,7019,6,545
2020-05-19,DZ,Algeria,AFRO,182,7201,7,552
2020-05-20,DZ,Algeria,AFRO,176,7377,6,558
2020-05-21,DZ,Algeria,AFRO,165,7542,7,565
2020-05-22,DZ,Algeria,AFRO,186,7728,7,572
2020-05-23,DZ,Algeria,AFRO,190,7918,7,579
2020-05-24,DZ,Algeria,AFRO,195,8113,10,589
2020-05-25,DZ,Algeria,AFRO,193,8306,8,597
2020-05-26,DZ,Algeria,AFRO,197,8503,9,606
2020-05-27,DZ,Algeria,AFRO,194,8697,8,614
2020-05-28,DZ,Algeria,AFRO,160,8857,6,620
2020-05-29,DZ,Algeria,AFRO,140,8997,7,627
2020-05-30,DZ,Algeria,AFRO,137,9134,8,635
2020-05-31,DZ,Algeria,AFRO,133,9267,8,643
2020-06-01,DZ,Algeria,AFRO,127,9394,7,650
2020-06-02,DZ,Algeria,AFRO,119,9513,8,658
2020-06-03,DZ,Algeria,AFRO,113,9626,6,664
2020-06-04,DZ,Algeria,AFRO,107,9733,6,670
2020-06-05,DZ,Algeria,AFRO,98,9831,8,678
2020-06-06,DZ,Algeria,AFRO,104,9935,9,687
2020-06-07,DZ,Algeria,AFRO,115,10050,8,695
2020-06-08,DZ,Algeria,AFRO,104,10154,0,695
2020-03-29,AS,American Samoa,WPRO,0,0,0,0
2020-03-30,AS,American Samoa,WPRO,0,0,0,0
2020-03-31,AS,American Samoa,WPRO,0,0,0,0
2020-04-01,AS,American Samoa,WPRO,0,0,0,0
2020-04-02,AS,American Samoa,WPRO,0,0,0,0
2020-04-03,AS,American Samoa,WPRO,0,0,0,0
2020-04-04,AS,American Samoa,WPRO,0,0,0,0
2020-04-05,AS,American Samoa,WPRO,0,0,0,0
2020-04-06,AS,American Samoa,WPRO,0,0,0,0
2020-04-07,AS,American Samoa,WPRO,0,0,0,0
2020-04-08,AS,American Samoa,WPRO,0,0,0,0
2020-04-09,AS,American Samoa,WPRO,0,0,0,0
2020-04-10,AS,American Samoa,WPRO,0,0,0,0
2020-04-11,AS,American Samoa,WPRO,0,0,0,0
2020-04-12,AS,American Samoa,WPRO,0,0,0,0
2020-04-13,AS,American Samoa,WPRO,0,0,0,0
2020-04-14,AS,American Samoa,WPRO,0,0,0,0
2020-04-15,AS,American Samoa,WPRO,0,0,0,0
2020-04-16,AS,American Samoa,WPRO,0,0,0,0
2020-04-17,AS,American Samoa,WPRO,0,0,0,0
2020-04-18,AS,American Samoa,WPRO,0,0,0,0
2020-04-19,AS,American Samoa,WPRO,0,0,0,0
2020-04-20,AS,American Samoa,WPRO,0,0,0,0
2020-04-21,AS,American Samoa,WPRO,0,0,0,0
2020-04-22,AS,American Samoa,WPRO,0,0,0,0
2020-04-23,AS,American Samoa,WPRO,0,0,0,0
2020-04-24,AS,American Samoa,WPRO,0,0,0,0
2020-04-25,AS,American Samoa,WPRO,0,0,0,0
2020-04-26,AS,American Samoa,WPRO,0,0,0,0
2020-04-27,AS,American Samoa,WPRO,0,0,0,0
2020-04-28,AS,American Samoa,WPRO,0,0,0,0
2020-04-29,AS,American Samoa,WPRO,0,0,0,0
2020-04-30,AS,American Samoa,WPRO,0,0,0,0
2020-05-01,AS,American Samoa,WPRO,0,0,0,0
2020-05-02,AS,American Samoa,WPRO,0,0,0,0
2020-05-03,AS,American Samoa,WPRO,0,0,0,0
2020-05-04,AS,American Samoa,WPRO,0,0,0,0
2020-05-05,AS,American Samoa,WPRO,0,0,0,0
2020-05-06,AS,American Samoa,WPRO,0,0,0,0
2020-05-07,AS,American Samoa,WPRO,0,0,0,0
2020-05-08,AS,American Samoa,WPRO,0,0,0,0
2020-05-09,AS,American Samoa,WPRO,0,0,0,0
2020-05-10,AS,American Samoa,WPRO,0,0,0,0
2020-05-11,AS,American Samoa,WPRO,0,0,0,0
2020-05-12,AS,American Samoa,WPRO,0,0,0,0
2020-05-13,AS,American Samoa,WPRO,0,0,0,0
2020-05-14,AS,American Samoa,WPRO,0,0,0,0
2020-05-15,AS,American Samoa,WPRO,0,0,0,0
2020-05-16,AS,American Samoa,WPRO,0,0,0,0
2020-05-17,AS,American Samoa,WPRO,0,0,0,0
2020-05-18,AS,American Samoa,WPRO,0,0,0,0
2020-05-19,AS,American Samoa,WPRO,0,0,0,0
2020-05-20,AS,American Samoa,WPRO,0,0,0,0
2020-05-21,AS,American Samoa,WPRO,0,0,0,0
2020-05-22,AS,American Samoa,WPRO,0,0,0,0
2020-05-23,AS,American Samoa,WPRO,0,0,0,0
2020-05-24,AS,American Samoa,WPRO,0,0,0,0
2020-05-25,AS,American Samoa,WPRO,0,0,0,0
2020-05-26,AS,American Samoa,WPRO,0,0,0,0
2020-05-27,AS,American Samoa,WPRO,0,0,0,0
2020-05-28,AS,American Samoa,WPRO,0,0,0,0
2020-05-29,AS,American Samoa,WPRO,0,0,0,0
2020-05-30,AS,American Samoa,WPRO,0,0,0,0
2020-05-31,AS,American Samoa,WPRO,0,0,0,0
2020-06-01,AS,American Samoa,WPRO,0,0,0,0
2020-06-02,AS,American Samoa,WPRO,0,0,0,0
2020-06-03,AS,American Samoa,WPRO,0,0,0,0
2020-06-04,AS,American Samoa,WPRO,0,0,0,0
2020-06-05,AS,American Samoa,WPRO,0,0,0,0
2020-06-06,AS,American Samoa,WPRO,0,0,0,0
2020-06-07,AS,American Samoa,WPRO,0,0,0,0
2020-06-08,AS,American Samoa,WPRO,0,0,0,0
2020-03-29,AD,Andorra,EURO,20,341,2,6
2020-03-30,AD,Andorra,EURO,29,370,2,8
2020-03-31,AD,Andorra,EURO,6,376,4,12
2020-04-01,AD,Andorra,EURO,20,396,1,13
2020-04-02,AD,Andorra,EURO,0,396,0,13
2020-04-03,AD,Andorra,EURO,33,429,2,15
2020-04-04,AD,Andorra,EURO,13,442,1,16
2020-04-05,AD,Andorra,EURO,24,466,1,17
2020-04-06,AD,Andorra,EURO,57,523,0,17
2020-04-07,AD,Andorra,EURO,17,540,4,21
2020-04-08,AD,Andorra,EURO,11,551,1,22
2020-04-09,AD,Andorra,EURO,15,566,2,24
2020-04-10,AD,Andorra,EURO,23,589,2,26
2020-04-11,AD,Andorra,EURO,13,602,0,26
2020-04-12,AD,Andorra,EURO,20,622,2,28
2020-04-13,AD,Andorra,EURO,17,639,1,29
2020-04-14,AD,Andorra,EURO,12,651,0,29
2020-04-15,AD,Andorra,EURO,8,659,2,31
2020-04-16,AD,Andorra,EURO,14,673,2,33
2020-04-17,AD,Andorra,EURO,21,694,1,34
2020-04-18,AD,Andorra,EURO,9,703,1,35
2020-04-19,AD,Andorra,EURO,1,704,0,35
2020-04-20,AD,Andorra,EURO,13,717,1,36
2020-04-21,AD,Andorra,EURO,1,718,0,36
2020-04-22,AD,Andorra,EURO,5,723,1,37
2020-04-23,AD,Andorra,EURO,1,724,0,37
2020-04-24,AD,Andorra,EURO,2,726,1,38
2020-04-25,AD,Andorra,EURO,7,733,2,40
2020-04-26,AD,Andorra,EURO,5,738,0,40
2020-04-27,AD,Andorra,EURO,2,740,0,40
2020-04-28,AD,Andorra,EURO,1,741,1,41
2020-04-29,AD,Andorra,EURO,1,742,1,42
2020-04-30,AD,Andorra,EURO,2,744,0,42
2020-05-01,AD,Andorra,EURO,2,746,0,42
2020-05-02,AD,Andorra,EURO,0,746,1,43
2020-05-03,AD,Andorra,EURO,1,747,1,44
2020-05-04,AD,Andorra,EURO,2,749,1,45
2020-05-05,AD,Andorra,EURO,2,751,0,45
2020-05-06,AD,Andorra,EURO,0,751,1,46
2020-05-07,AD,Andorra,EURO,1,752,1,47
2020-05-08,AD,Andorra,EURO,0,752,0,47
2020-05-09,AD,Andorra,EURO,2,754,0,47
2020-05-10,AD,Andorra,EURO,0,754,1,48
2020-05-11,AD,Andorra,EURO,2,756,0,48
2020-05-12,AD,Andorra,EURO,0,756,0,48
2020-05-13,AD,Andorra,EURO,3,759,0,48
2020-05-14,AD,Andorra,EURO,2,761,1,49
2020-05-15,AD,Andorra,EURO,0,761,0,49
2020-05-16,AD,Andorra,EURO,0,761,0,49
2020-05-17,AD,Andorra,EURO,0,761,2,51
2020-05-18,AD,Andorra,EURO,0,761,0,51
2020-05-19,AD,Andorra,EURO,0,761,0,51
2020-05-20,AD,Andorra,EURO,0,761,0,51
2020-05-21,AD,Andorra,EURO,1,762,0,51
2020-05-22,AD,Andorra,EURO,0,762,0,51
2020-05-23,AD,Andorra,EURO,0,762,0,51
2020-05-24,AD,Andorra,EURO,1,763,0,51
2020-05-25,AD,Andorra,EURO,0,763,0,51
2020-05-26,AD,Andorra,EURO,0,763,0,51
2020-05-27,AD,Andorra,EURO,0,763,0,51
2020-05-28,AD,Andorra,EURO,0,763,0,51
2020-05-29,AD,Andorra,EURO,1,764,0,51
2020-05-30,AD,Andorra,EURO,0,764,0,51
2020-05-31,AD,Andorra,EURO,0,764,0,51
2020-06-01,AD,Andorra,EURO,0,764,0,51
2020-06-02,AD,Andorra,EURO,1,765,0,51
2020-06-03,AD,Andorra,EURO,79,844,0,51
2020-06-04,AD,Andorra,EURO,7,851,0,51
2020-06-05,AD,Andorra,EURO,1,852,0,51
2020-06-06,AD,Andorra,EURO,0,852,0,51
2020-06-07,AD,Andorra,EURO,0,852,0,51
2020-06-08,AD,Andorra,EURO,0,852,0,51
2020-03-29,AO,Angola,AFRO,0,1,0,3
2020-03-30,AO,Angola,AFRO,0,1,0,3
2020-03-31,AO,Angola,AFRO,3,4,0,3
2020-04-01,AO,Angola,AFRO,0,4,0,3
2020-04-02,AO,Angola,AFRO,1,5,0,3
2020-04-03,AO,Angola,AFRO,3,8,0,3
2020-04-04,AO,Angola,AFRO,2,10,0,3
2020-04-05,AO,Angola,AFRO,0,10,0,3
2020-04-06,AO,Angola,AFRO,4,14,0,3
2020-04-07,AO,Angola,AFRO,2,16,0,3
2020-04-08,AO,Angola,AFRO,3,19,0,3
2020-04-09,AO,Angola,AFRO,0,19,0,3
2020-04-10,AO,Angola,AFRO,0,19,0,3
2020-04-11,AO,Angola,AFRO,0,19,0,3
2020-04-12,AO,Angola,AFRO,0,19,0,3
2020-04-13,AO,Angola,AFRO,0,19,0,3
2020-04-14,AO,Angola,AFRO,0,19,0,3
2020-04-15,AO,Angola,AFRO,0,19,0,3
2020-04-16,AO,Angola,AFRO,0,19,0,3
2020-04-17,AO,Angola,AFRO,0,19,0,3
2020-04-18,AO,Angola,AFRO,0,19,0,3
2020-04-19,AO,Angola,AFRO,5,24,0,3
2020-04-20,AO,Angola,AFRO,0,24,0,3
2020-04-21,AO,Angola,AFRO,0,24,0,3
2020-04-22,AO,Angola,AFRO,0,24,0,3
2020-04-23,AO,Angola,AFRO,1,25,0,3
2020-04-24,AO,Angola,AFRO,0,25,0,3
2020-04-25,AO,Angola,AFRO,0,25,0,3
2020-04-26,AO,Angola,AFRO,0,25,0,3
2020-04-27,AO,Angola,AFRO,1,26,0,3
2020-04-28,AO,Angola,AFRO,1,27,0,3
2020-04-29,AO,Angola,AFRO,0,27,0,3
2020-04-30,AO,Angola,AFRO,0,27,0,3
2020-05-01,AO,Angola,AFRO,0,27,0,3
2020-05-02,AO,Angola,AFRO,2,29,0,3
2020-05-03,AO,Angola,AFRO,6,35,0,3
2020-05-04,AO,Angola,AFRO,0,35,0,3
2020-05-05,AO,Angola,AFRO,0,35,0,3
2020-05-06,AO,Angola,AFRO,1,36,0,3
2020-05-07,AO,Angola,AFRO,0,36,0,3
2020-05-08,AO,Angola,AFRO,0,36,0,3
2020-05-09,AO,Angola,AFRO,7,43,0,3
2020-05-10,AO,Angola,AFRO,0,43,0,3
2020-05-11,AO,Angola,AFRO,2,45,0,3
2020-05-12,AO,Angola,AFRO,0,45,0,3
2020-05-13,AO,Angola,AFRO,0,45,0,3
2020-05-14,AO,Angola,AFRO,0,45,0,3
2020-05-15,AO,Angola,AFRO,3,48,0,3
2020-05-16,AO,Angola,AFRO,0,48,0,3
2020-05-17,AO,Angola,AFRO,0,48,0,3
2020-05-18,AO,Angola,AFRO,0,48,0,3
2020-05-19,AO,Angola,AFRO,2,50,0,3
2020-05-20,AO,Angola,AFRO,2,52,0,3
2020-05-21,AO,Angola,AFRO,6,58,0,3
2020-05-22,AO,Angola,AFRO,2,60,0,3
2020-05-23,AO,Angola,AFRO,0,60,0,3
2020-05-24,AO,Angola,AFRO,1,61,0,3
2020-05-25,AO,Angola,AFRO,9,70,1,4
2020-05-26,AO,Angola,AFRO,0,70,0,4
2020-05-27,AO,Angola,AFRO,1,71,0,4
2020-05-28,AO,Angola,AFRO,0,71,0,4
2020-05-29,AO,Angola,AFRO,3,74,0,4
2020-05-30,AO,Angola,AFRO,7,81,0,4
2020-05-31,AO,Angola,AFRO,3,84,0,4
2020-06-01,AO,Angola,AFRO,2,86,0,4
2020-06-02,AO,Angola,AFRO,0,86,0,4
2020-06-03,AO,Angola,AFRO,0,86,0,4
2020-06-04,AO,Angola,AFRO,0,86,0,4
2020-06-05,AO,Angola,AFRO,0,86,0,4
2020-06-06,AO,Angola,AFRO,0,86,0,4
2020-06-07,AO,Angola,AFRO,2,88,0,4
2020-06-08,AO,Angola,AFRO,3,91,0,4
2020-03-29,AI,Anguilla,AMRO,0,2,0,0
2020-03-30,AI,Anguilla,AMRO,0,2,0,0
2020-03-31,AI,Anguilla,AMRO,0,2,0,0
2020-04-01,AI,Anguilla,AMRO,0,2,0,0
2020-04-02,AI,Anguilla,AMRO,0,2,0,0
2020-04-03,AI,Anguilla,AMRO,0,2,0,0
2020-04-04,AI,Anguilla,AMRO,1,3,0,0
2020-04-05,AI,Anguilla,AMRO,0,3,0,0
2020-04-06,AI,Anguilla,AMRO,0,3,0,0
2020-04-07,AI,Anguilla,AMRO,0,3,0,0
2020-04-08,AI,Anguilla,AMRO,0,3,0,0
2020-04-09,AI,Anguilla,AMRO,0,3,0,0
2020-04-10,AI,Anguilla,AMRO,0,3,0,0
2020-04-11,AI,Anguilla,AMRO,0,3,0,0
2020-04-12,AI,Anguilla,AMRO,0,3,0,0
2020-04-13,AI,Anguilla,AMRO,0,3,0,0
2020-04-14,AI,Anguilla,AMRO,0,3,0,0
2020-04-15,AI,Anguilla,AMRO,0,3,0,0
2020-04-16,AI,Anguilla,AMRO,0,3,0,0
2020-04-17,AI,Anguilla,AMRO,0,3,0,0
2020-04-18,AI,Anguilla,AMRO,0,3,0,0
2020-04-19,AI,Anguilla,AMRO,0,3,0,0
2020-04-20,AI,Anguilla,AMRO,0,3,0,0
2020-04-21,AI,Anguilla,AMRO,0,3,0,0
2020-04-22,AI,Anguilla,AMRO,0,3,0,0
2020-04-23,AI,Anguilla,AMRO,0,3,0,0
2020-04-24,AI,Anguilla,AMRO,0,3,0,0
2020-04-25,AI,Anguilla,AMRO,0,3,0,0
2020-04-26,AI,Anguilla,AMRO,0,3,0,0
2020-04-27,AI,Anguilla,AMRO,0,3,0,0
2020-04-28,AI,Anguilla,AMRO,0,3,0,0
2020-04-29,AI,Anguilla,AMRO,0,3,0,0
2020-04-30,AI,Anguilla,AMRO,0,3,0,0
2020-05-01,AI,Anguilla,AMRO,0,3,0,0
2020-05-02,AI,Anguilla,AMRO,0,3,0,0
2020-05-03,AI,Anguilla,AMRO,0,3,0,0
2020-05-04,AI,Anguilla,AMRO,0,3,0,0
2020-05-05,AI,Anguilla,AMRO,0,3,0,0
2020-05-06,AI,Anguilla,AMRO,0,3,0,0
2020-05-07,AI,Anguilla,AMRO,0,3,0,0
2020-05-08,AI,Anguilla,AMRO,0,3,0,0
2020-05-09,AI,Anguilla,AMRO,0,3,0,0
2020-05-10,AI,Anguilla,AMRO,0,3,0,0
2020-05-11,AI,Anguilla,AMRO,0,3,0,0
2020-05-12,AI,Anguilla,AMRO,0,3,0,0
2020-05-13,AI,Anguilla,AMRO,0,3,0,0
2020-05-14,AI,Anguilla,AMRO,0,3,0,0
2020-05-15,AI,Anguilla,AMRO,0,3,0,0
2020-05-16,AI,Anguilla,AMRO,0,3,0,0
2020-05-17,AI,Anguilla,AMRO,0,3,0,0
2020-05-18,AI,Anguilla,AMRO,0,3,0,0
2020-05-19,AI,Anguilla,AMRO,0,3,0,0
2020-05-20,AI,Anguilla,AMRO,0,3,0,0
2020-05-21,AI,Anguilla,AMRO,0,3,0,0
2020-05-22,AI,Anguilla,AMRO,0,3,0,0
2020-05-23,AI,Anguilla,AMRO,0,3,0,0
2020-05-24,AI,Anguilla,AMRO,0,3,0,0
2020-05-25,AI,Anguilla,AMRO,0,3,0,0
2020-05-26,AI,Anguilla,AMRO,0,3,0,0
2020-05-27,AI,Anguilla,AMRO,0,3,0,0
2020-05-28,AI,Anguilla,AMRO,0,3,0,0
2020-05-29,AI,Anguilla,AMRO,0,3,0,0
2020-05-30,AI,Anguilla,AMRO,0,3,0,0
2020-05-31,AI,Anguilla,AMRO,0,3,0,0
2020-06-01,AI,Anguilla,AMRO,0,3,0,0
2020-06-02,AI,Anguilla,AMRO,0,3,0,0
2020-06-03,AI,Anguilla,AMRO,0,3,0,0
2020-06-04,AI,Anguilla,AMRO,0,3,0,0
2020-06-05,AI,Anguilla,AMRO,0,3,0,0
2020-06-06,AI,Anguilla,AMRO,0,3,0,0
2020-06-07,AI,Anguilla,AMRO,0,3,0,0
2020-06-08,AI,Anguilla,AMRO,0,3,0,0
2020-03-29,AG,Antigua and Barbuda,AMRO,0,7,0,0
2020-03-30,AG,Antigua and Barbuda,AMRO,0,7,0,0
2020-03-31,AG,Antigua and Barbuda,AMRO,0,7,0,0
2020-04-01,AG,Antigua and Barbuda,AMRO,0,7,0,0
2020-04-02,AG,Antigua and Barbuda,AMRO,0,7,0,0
2020-04-03,AG,Antigua and Barbuda,AMRO,0,7,0,0
2020-04-04,AG,Antigua and Barbuda,AMRO,0,7,0,0
2020-04-05,AG,Antigua and Barbuda,AMRO,0,7,0,0
2020-04-06,AG,Antigua and Barbuda,AMRO,0,7,0,0
2020-04-07,AG,Antigua and Barbuda,AMRO,8,15,0,0
2020-04-08,AG,Antigua and Barbuda,AMRO,0,15,0,0
2020-04-09,AG,Antigua and Barbuda,AMRO,4,19,2,2
2020-04-10,AG,Antigua and Barbuda,AMRO,0,19,0,2
2020-04-11,AG,Antigua and Barbuda,AMRO,0,19,0,2
2020-04-12,AG,Antigua and Barbuda,AMRO,2,21,0,2
2020-04-13,AG,Antigua and Barbuda,AMRO,0,21,0,2
2020-04-14,AG,Antigua and Barbuda,AMRO,2,23,0,2
2020-04-15,AG,Antigua and Barbuda,AMRO,0,23,0,2
2020-04-16,AG,Antigua and Barbuda,AMRO,0,23,0,2
2020-04-17,AG,Antigua and Barbuda,AMRO,0,23,0,2
2020-04-18,AG,Antigua and Barbuda,AMRO,0,23,0,2
2020-04-19,AG,Antigua and Barbuda,AMRO,0,23,0,2
2020-04-20,AG,Antigua and Barbuda,AMRO,0,23,1,3
2020-04-21,AG,Antigua and Barbuda,AMRO,0,23,0,3
2020-04-22,AG,Antigua and Barbuda,AMRO,0,23,0,3
2020-04-23,AG,Antigua and Barbuda,AMRO,1,24,0,3
2020-04-24,AG,Antigua and Barbuda,AMRO,0,24,0,3
2020-04-25,AG,Antigua and Barbuda,AMRO,0,24,0,3
2020-04-26,AG,Antigua and Barbuda,AMRO,0,24,0,3
2020-04-27,AG,Antigua and Barbuda,AMRO,0,24,0,3
2020-04-28,AG,Antigua and Barbuda,AMRO,0,24,0,3
2020-04-29,AG,Antigua and Barbuda,AMRO,0,24,0,3
2020-04-30,AG,Antigua and Barbuda,AMRO,0,24,0,3
2020-05-01,AG,Antigua and Barbuda,AMRO,0,24,0,3
2020-05-02,AG,Antigua and Barbuda,AMRO,0,24,0,3
2020-05-03,AG,Antigua and Barbuda,AMRO,0,24,0,3
2020-05-04,AG,Antigua and Barbuda,AMRO,1,25,0,3
2020-05-05,AG,Antigua and Barbuda,AMRO,0,25,0,3
2020-05-06,AG,Antigua and Barbuda,AMRO,0,25,0,3
2020-05-07,AG,Antigua and Barbuda,AMRO,0,25,0,3
2020-05-08,AG,Antigua and Barbuda,AMRO,0,25,0,3
2020-05-09,AG,Antigua and Barbuda,AMRO,0,25,0,3
2020-05-10,AG,Antigua and Barbuda,AMRO,0,25,0,3
2020-05-11,AG,Antigua and Barbuda,AMRO,0,25,0,3
2020-05-12,AG,Antigua and Barbuda,AMRO,0,25,0,3
2020-05-13,AG,Antigua and Barbuda,AMRO,0,25,0,3
2020-05-14,AG,Antigua and Barbuda,AMRO,0,25,0,3
2020-05-15,AG,Antigua and Barbuda,AMRO,0,25,0,3
2020-05-16,AG,Antigua and Barbuda,AMRO,0,25,0,3
2020-05-17,AG,Antigua and Barbuda,AMRO,0,25,0,3
2020-05-18,AG,Antigua and Barbuda,AMRO,0,25,0,3
2020-05-19,AG,Antigua and Barbuda,AMRO,0,25,0,3
2020-05-20,AG,Antigua and Barbuda,AMRO,0,25,0,3
2020-05-21,AG,Antigua and Barbuda,AMRO,0,25,0,3
2020-05-22,AG,Antigua and Barbuda,AMRO,0,25,0,3
2020-05-23,AG,Antigua and Barbuda,AMRO,0,25,0,3
2020-05-24,AG,Antigua and Barbuda,AMRO,0,25,0,3
2020-05-25,AG,Antigua and Barbuda,AMRO,0,25,0,3
2020-05-26,AG,Antigua and Barbuda,AMRO,0,25,0,3
2020-05-27,AG,Antigua and Barbuda,AMRO,0,25,0,3
2020-05-28,AG,Antigua and Barbuda,AMRO,0,25,0,3
2020-05-29,AG,Antigua and Barbuda,AMRO,0,25,0,3
2020-05-30,AG,Antigua and Barbuda,AMRO,0,25,0,3
2020-05-31,AG,Antigua and Barbuda,AMRO,0,25,0,3
2020-06-01,AG,Antigua and Barbuda,AMRO,0,25,0,3
2020-06-02,AG,Antigua and Barbuda,AMRO,0,25,0,3
2020-06-03,AG,Antigua and Barbuda,AMRO,0,25,0,3
2020-06-04,AG,Antigua and Barbuda,AMRO,0,25,0,3
2020-06-05,AG,Antigua and Barbuda,AMRO,0,25,0,3
2020-06-06,AG,Antigua and Barbuda,AMRO,0,25,0,3
2020-06-07,AG,Antigua and Barbuda,AMRO,0,25,0,3
2020-06-08,AG,Antigua and Barbuda,AMRO,0,25,0,3
2020-03-29,AR,Argentina,AMRO,94,1282,4,70
2020-03-30,AR,Argentina,AMRO,129,1411,11,81
2020-03-31,AR,Argentina,AMRO,105,1516,10,91
2020-04-01,AR,Argentina,AMRO,114,1630,10,101
2020-04-02,AR,Argentina,AMRO,147,1777,9,110
2020-04-03,AR,Argentina,AMRO,120,1897,7,117
2020-04-04,AR,Argentina,AMRO,104,2001,6,123
2020-04-05,AR,Argentina,AMRO,72,2073,8,131
2020-04-06,AR,Argentina,AMRO,148,2221,20,151
2020-04-07,AR,Argentina,AMRO,120,2341,5,156
2020-04-08,AR,Argentina,AMRO,115,2456,12,168
2020-04-09,AR,Argentina,AMRO,143,2599,6,174
2020-04-10,AR,Argentina,AMRO,100,2699,5,179
2020-04-11,AR,Argentina,AMRO,156,2855,18,197
2020-04-12,AR,Argentina,AMRO,135,2990,8,205
2020-04-13,AR,Argentina,AMRO,186,3176,12,217
2020-04-14,AR,Argentina,AMRO,139,3315,11,228
2020-04-15,AR,Argentina,AMRO,164,3479,8,236
2020-04-16,AR,Argentina,AMRO,157,3636,6,242
2020-04-17,AR,Argentina,AMRO,170,3806,12,254
2020-04-18,AR,Argentina,AMRO,134,3940,16,270
2020-04-19,AR,Argentina,AMRO,126,4066,9,279
2020-04-20,AR,Argentina,AMRO,199,4265,15,294
2020-04-21,AR,Argentina,AMRO,228,4493,29,323
2020-04-22,AR,Argentina,AMRO,185,4678,17,340
2020-04-23,AR,Argentina,AMRO,294,4972,29,369
2020-04-24,AR,Argentina,AMRO,223,5195,24,393
2020-04-25,AR,Argentina,AMRO,160,5355,8,401
2020-04-26,AR,Argentina,AMRO,109,5464,10,411
2020-04-27,AR,Argentina,AMRO,220,5684,22,433
2020-04-28,AR,Argentina,AMRO,200,5884,21,454
2020-04-29,AR,Argentina,AMRO,199,6083,17,471
2020-04-30,AR,Argentina,AMRO,225,6308,17,488
2020-05-01,AR,Argentina,AMRO,155,6463,17,505
2020-05-02,AR,Argentina,AMRO,166,6629,12,517
2020-05-03,AR,Argentina,AMRO,124,6753,9,526
2020-05-04,AR,Argentina,AMRO,196,6949,21,547
2020-05-05,AR,Argentina,AMRO,229,7178,21,568
2020-05-06,AR,Argentina,AMRO,298,7476,15,583
2020-05-07,AR,Argentina,AMRO,334,7810,24,607
2020-05-08,AR,Argentina,AMRO,295,8105,15,622
2020-05-09,AR,Argentina,AMRO,274,8379,12,634
2020-05-10,AR,Argentina,AMRO,271,8650,12,646
2020-05-11,AR,Argentina,AMRO,359,9009,16,662
2020-05-12,AR,Argentina,AMRO,398,9407,25,687
2020-05-13,AR,Argentina,AMRO,367,9774,19,706
2020-05-14,AR,Argentina,AMRO,466,10240,23,729
2020-05-15,AR,Argentina,AMRO,457,10697,18,747
2020-05-16,AR,Argentina,AMRO,394,11091,17,764
2020-05-17,AR,Argentina,AMRO,469,11560,26,790
2020-05-18,AR,Argentina,AMRO,660,12220,40,830
2020-05-19,AR,Argentina,AMRO,611,12831,33,863
2020-05-20,AR,Argentina,AMRO,728,13559,26,889
2020-05-21,AR,Argentina,AMRO,824,14383,42,931
2020-05-22,AR,Argentina,AMRO,853,15236,34,965
2020-05-23,AR,Argentina,AMRO,763,15999,22,987
2020-05-24,AR,Argentina,AMRO,622,16621,22,1009
2020-05-25,AR,Argentina,AMRO,640,17261,24,1033
2020-05-26,AR,Argentina,AMRO,797,18058,34,1067
2020-05-27,AR,Argentina,AMRO,904,18962,43,1110
2020-05-28,AR,Argentina,AMRO,940,19902,51,1161
2020-05-29,AR,Argentina,AMRO,1017,20919,69,1230
2020-05-30,AR,Argentina,AMRO,841,21760,41,1271
2020-05-31,AR,Argentina,AMRO,646,22406,35,1306
2020-06-01,AR,Argentina,AMRO,998,23404,43,1349
2020-06-02,AR,Argentina,AMRO,1043,24447,48,1397
2020-06-03,AR,Argentina,AMRO,1054,25501,55,1452
2020-06-04,AR,Argentina,AMRO,1113,26614,48,1500
2020-06-05,AR,Argentina,AMRO,1208,27822,64,1564
2020-06-06,AR,Argentina,AMRO,1024,28846,52,1616
2020-06-07,AR,Argentina,AMRO,857,29703,48,1664
2020-06-08,AR,Argentina,AMRO,1408,31111,69,1733
2020-03-29,AM,Armenia,EURO,52,424,0,1
2020-03-30,AM,Armenia,EURO,58,482,2,3
2020-03-31,AM,Armenia,EURO,50,532,0,3
2020-04-01,AM,Armenia,EURO,39,571,0,3
2020-04-02,AM,Armenia,EURO,92,663,1,4
2020-04-03,AM,Armenia,EURO,73,736,3,7
2020-04-04,AM,Armenia,EURO,34,770,0,7
2020-04-05,AM,Armenia,EURO,52,822,0,7
2020-04-06,AM,Armenia,EURO,11,833,1,8
2020-04-07,AM,Armenia,EURO,20,853,0,8
2020-04-08,AM,Armenia,EURO,28,881,1,9
2020-04-09,AM,Armenia,EURO,40,921,1,10
2020-04-10,AM,Armenia,EURO,16,937,1,11
2020-04-11,AM,Armenia,EURO,30,967,2,13
2020-04-12,AM,Armenia,EURO,46,1013,0,13
2020-04-13,AM,Armenia,EURO,26,1039,1,14
2020-04-14,AM,Armenia,EURO,28,1067,2,16
2020-04-15,AM,Armenia,EURO,44,1111,1,17
2020-04-16,AM,Armenia,EURO,48,1159,1,18
2020-04-17,AM,Armenia,EURO,42,1201,1,19
2020-04-18,AM,Armenia,EURO,47,1248,1,20
2020-04-19,AM,Armenia,EURO,43,1291,0,20
2020-04-20,AM,Armenia,EURO,48,1339,2,22
2020-04-21,AM,Armenia,EURO,62,1401,2,24
2020-04-22,AM,Armenia,EURO,72,1473,0,24
2020-04-23,AM,Armenia,EURO,50,1523,0,24
2020-04-24,AM,Armenia,EURO,73,1596,3,27
2020-04-25,AM,Armenia,EURO,81,1677,1,28
2020-04-26,AM,Armenia,EURO,69,1746,0,28
2020-04-27,AM,Armenia,EURO,62,1808,1,29
2020-04-28,AM,Armenia,EURO,59,1867,1,30
2020-04-29,AM,Armenia,EURO,65,1932,0,30
2020-04-30,AM,Armenia,EURO,134,2066,2,32
2020-05-01,AM,Armenia,EURO,82,2148,1,33
2020-05-02,AM,Armenia,EURO,125,2273,0,33
2020-05-03,AM,Armenia,EURO,113,2386,2,35
2020-05-04,AM,Armenia,EURO,121,2507,4,39
2020-05-05,AM,Armenia,EURO,112,2619,1,40
2020-05-06,AM,Armenia,EURO,163,2782,0,40
2020-05-07,AM,Armenia,EURO,102,2884,2,42
2020-05-08,AM,Armenia,EURO,145,3029,1,43
2020-05-09,AM,Armenia,EURO,146,3175,1,44
2020-05-10,AM,Armenia,EURO,138,3313,1,45
2020-05-11,AM,Armenia,EURO,79,3392,1,46
2020-05-12,AM,Armenia,EURO,146,3538,1,47
2020-05-13,AM,Armenia,EURO,180,3718,1,48
2020-05-14,AM,Armenia,EURO,142,3860,1,49
2020-05-15,AM,Armenia,EURO,184,4044,3,52
2020-05-16,AM,Armenia,EURO,239,4283,3,55
2020-05-17,AM,Armenia,EURO,189,4472,5,60
2020-05-18,AM,Armenia,EURO,351,4823,1,61
2020-05-19,AM,Armenia,EURO,218,5041,3,64
2020-05-20,AM,Armenia,EURO,230,5271,3,67
2020-05-21,AM,Armenia,EURO,335,5606,3,70
2020-05-22,AM,Armenia,EURO,322,5928,4,74
2020-05-23,AM,Armenia,EURO,374,6302,3,77
2020-05-24,AM,Armenia,EURO,359,6661,4,81
2020-05-25,AM,Armenia,EURO,452,7113,6,87
2020-05-26,AM,Armenia,EURO,289,7402,4,91
2020-05-27,AM,Armenia,EURO,372,7774,7,98
2020-05-28,AM,Armenia,EURO,442,8216,15,113
2020-05-29,AM,Armenia,EURO,460,8676,7,120
2020-05-30,AM,Armenia,EURO,251,8927,7,127
2020-05-31,AM,Armenia,EURO,355,9282,4,131
2020-06-01,AM,Armenia,EURO,210,9492,8,139
2020-06-02,AM,Armenia,EURO,517,10009,19,158
2020-06-03,AM,Armenia,EURO,515,10524,12,170
2020-06-04,AM,Armenia,EURO,697,11221,6,176
2020-06-05,AM,Armenia,EURO,596,11817,7,183
2020-06-06,AM,Armenia,EURO,547,12364,7,190
2020-06-07,AM,Armenia,EURO,766,13130,10,200
2020-06-08,AM,Armenia,EURO,195,13325,11,211
2020-03-29,AW,Aruba,AMRO,18,46,0,0
2020-03-30,AW,Aruba,AMRO,0,46,0,0
2020-03-31,AW,Aruba,AMRO,4,50,0,0
2020-04-01,AW,Aruba,AMRO,5,55,0,0
2020-04-02,AW,Aruba,AMRO,0,55,0,0
2020-04-03,AW,Aruba,AMRO,5,60,0,0
2020-04-04,AW,Aruba,AMRO,2,62,0,0
2020-04-05,AW,Aruba,AMRO,2,64,0,0
2020-04-06,AW,Aruba,AMRO,0,64,0,0
2020-04-07,AW,Aruba,AMRO,0,64,0,0
2020-04-08,AW,Aruba,AMRO,7,71,0,0
2020-04-09,AW,Aruba,AMRO,3,74,0,0
2020-04-10,AW,Aruba,AMRO,8,82,0,0
2020-04-11,AW,Aruba,AMRO,4,86,0,0
2020-04-12,AW,Aruba,AMRO,6,92,0,0
2020-04-13,AW,Aruba,AMRO,0,92,0,0
2020-04-14,AW,Aruba,AMRO,0,92,0,0
2020-04-15,AW,Aruba,AMRO,0,92,0,0
2020-04-16,AW,Aruba,AMRO,1,93,1,1
2020-04-17,AW,Aruba,AMRO,2,95,1,2
2020-04-18,AW,Aruba,AMRO,1,96,0,2
2020-04-19,AW,Aruba,AMRO,0,96,0,2
2020-04-20,AW,Aruba,AMRO,1,97,0,2
2020-04-21,AW,Aruba,AMRO,0,97,0,2
2020-04-22,AW,Aruba,AMRO,0,97,0,2
2020-04-23,AW,Aruba,AMRO,3,100,0,2
2020-04-24,AW,Aruba,AMRO,0,100,0,2
2020-04-25,AW,Aruba,AMRO,0,100,0,2
2020-04-26,AW,Aruba,AMRO,0,100,0,2
2020-04-27,AW,Aruba,AMRO,0,100,0,2
2020-04-28,AW,Aruba,AMRO,0,100,0,2
2020-04-29,AW,Aruba,AMRO,0,100,0,2
2020-04-30,AW,Aruba,AMRO,0,100,0,2
2020-05-01,AW,Aruba,AMRO,0,100,0,2
2020-05-02,AW,Aruba,AMRO,0,100,0,2
2020-05-03,AW,Aruba,AMRO,0,100,0,2
2020-05-04,AW,Aruba,AMRO,0,100,0,2
2020-05-05,AW,Aruba,AMRO,0,100,0,2
2020-05-06,AW,Aruba,AMRO,1,101,0,2
2020-05-07,AW,Aruba,AMRO,0,101,0,2
2020-05-08,AW,Aruba,AMRO,0,101,0,2
2020-05-09,AW,Aruba,AMRO,0,101,1,3
2020-05-10,AW,Aruba,AMRO,0,101,0,3
2020-05-11,AW,Aruba,AMRO,0,101,0,3
2020-05-12,AW,Aruba,AMRO,0,101,0,3
2020-05-13,AW,Aruba,AMRO,0,101,0,3
2020-05-14,AW,Aruba,AMRO,0,101,0,3
2020-05-15,AW,Aruba,AMRO,0,101,0,3
2020-05-16,AW,Aruba,AMRO,0,101,0,3
2020-05-17,AW,Aruba,AMRO,0,101,0,3
2020-05-18,AW,Aruba,AMRO,0,101,0,3
2020-05-19,AW,Aruba,AMRO,0,101,0,3
2020-05-20,AW,Aruba,AMRO,0,101,0,3
2020-05-21,AW,Aruba,AMRO,0,101,0,3
2020-05-22,AW,Aruba,AMRO,0,101,0,3
2020-05-23,AW,Aruba,AMRO,0,101,0,3
2020-05-24,AW,Aruba,AMRO,0,101,0,3
2020-05-25,AW,Aruba,AMRO,0,101,0,3
2020-05-26,AW,Aruba,AMRO,0,101,0,3
2020-05-27,AW,Aruba,AMRO,0,101,0,3
2020-05-28,AW,Aruba,AMRO,0,101,0,3
2020-05-29,AW,Aruba,AMRO,0,101,0,3
2020-05-30,AW,Aruba,AMRO,0,101,0,3
2020-05-31,AW,Aruba,AMRO,0,101,0,3
2020-06-01,AW,Aruba,AMRO,0,101,0,3
2020-06-02,AW,Aruba,AMRO,0,101,0,3
2020-06-03,AW,Aruba,AMRO,0,101,0,3
2020-06-04,AW,Aruba,AMRO,0,101,0,3
2020-06-05,AW,Aruba,AMRO,0,101,0,3
2020-06-06,AW,Aruba,AMRO,0,101,0,3
2020-06-07,AW,Aruba,AMRO,0,101,0,3
2020-06-08,AW,Aruba,AMRO,0,101,0,3
2020-03-29,AU,Australia,WPRO,431,3809,0,16
2020-03-30,AU,Australia,WPRO,284,4093,3,19
2020-03-31,AU,Australia,WPRO,266,4359,2,21
2020-04-01,AU,Australia,WPRO,348,4707,1,22
2020-04-02,AU,Australia,WPRO,269,4976,2,24
2020-04-03,AU,Australia,WPRO,248,5224,4,28
2020-04-04,AU,Australia,WPRO,230,5454,5,33
2020-04-05,AU,Australia,WPRO,181,5635,3,36
2020-04-06,AU,Australia,WPRO,109,5744,5,41
2020-04-07,AU,Australia,WPRO,100,5844,8,49
2020-04-08,AU,Australia,WPRO,112,5956,2,51
2020-04-09,AU,Australia,WPRO,96,6052,2,53
2020-04-10,AU,Australia,WPRO,100,6152,2,55
2020-04-11,AU,Australia,WPRO,86,6238,3,58
2020-04-12,AU,Australia,WPRO,51,6289,3,61
2020-04-13,AU,Australia,WPRO,33,6322,2,63
2020-04-14,AU,Australia,WPRO,44,6366,0,63
2020-04-15,AU,Australia,WPRO,50,6416,1,64
2020-04-16,AU,Australia,WPRO,42,6458,2,66
2020-04-17,AU,Australia,WPRO,10,6468,1,67
2020-04-18,AU,Australia,WPRO,65,6533,5,72
2020-04-19,AU,Australia,WPRO,53,6586,1,73
2020-04-20,AU,Australia,WPRO,26,6612,1,74
2020-04-21,AU,Australia,WPRO,13,6625,1,75
2020-04-22,AU,Australia,WPRO,22,6647,2,77
2020-04-23,AU,Australia,WPRO,7,6654,1,78
2020-04-24,AU,Australia,WPRO,13,6667,2,80
2020-04-25,AU,Australia,WPRO,20,6687,3,83
2020-04-26,AU,Australia,WPRO,16,6703,2,85
2020-04-27,AU,Australia,WPRO,10,6713,1,86
2020-04-28,AU,Australia,WPRO,12,6725,3,89
2020-04-29,AU,Australia,WPRO,13,6738,5,94
2020-04-30,AU,Australia,WPRO,8,6746,1,95
2020-05-01,AU,Australia,WPRO,16,6762,3,98
2020-05-02,AU,Australia,WPRO,5,6767,0,98
2020-05-03,AU,Australia,WPRO,16,6783,1,99
2020-05-04,AU,Australia,WPRO,18,6801,0,99
2020-05-05,AU,Australia,WPRO,24,6825,1,100
2020-05-06,AU,Australia,WPRO,24,6849,1,101
2020-05-07,AU,Australia,WPRO,26,6875,0,101
2020-05-08,AU,Australia,WPRO,21,6896,0,101
2020-05-09,AU,Australia,WPRO,18,6914,0,101
2020-05-10,AU,Australia,WPRO,15,6929,0,101
2020-05-11,AU,Australia,WPRO,12,6941,0,101
2020-05-12,AU,Australia,WPRO,7,6948,1,102
2020-05-13,AU,Australia,WPRO,16,6964,1,103
2020-05-14,AU,Australia,WPRO,11,6975,0,103
2020-05-15,AU,Australia,WPRO,14,6989,0,103
2020-05-16,AU,Australia,WPRO,30,7019,0,103
2020-05-17,AU,Australia,WPRO,17,7036,0,103
2020-05-18,AU,Australia,WPRO,9,7045,1,104
2020-05-19,AU,Australia,WPRO,15,7060,0,104
2020-05-20,AU,Australia,WPRO,8,7068,1,105
2020-05-21,AU,Australia,WPRO,11,7079,0,105
2020-05-22,AU,Australia,WPRO,2,7081,1,106
2020-05-23,AU,Australia,WPRO,14,7095,1,107
2020-05-24,AU,Australia,WPRO,11,7106,0,107
2020-05-25,AU,Australia,WPRO,3,7109,0,107
2020-05-26,AU,Australia,WPRO,9,7118,0,107
2020-05-27,AU,Australia,WPRO,15,7133,0,107
2020-05-28,AU,Australia,WPRO,6,7139,0,107
2020-05-29,AU,Australia,WPRO,11,7150,0,107
2020-05-30,AU,Australia,WPRO,23,7173,0,107
2020-05-31,AU,Australia,WPRO,12,7185,0,107
2020-06-01,AU,Australia,WPRO,10,7195,0,107
2020-06-02,AU,Australia,WPRO,9,7204,0,107
2020-06-03,AU,Australia,WPRO,17,7221,0,107
2020-06-04,AU,Australia,WPRO,8,7229,0,107
2020-06-05,AU,Australia,WPRO,11,7240,0,107
2020-06-06,AU,Australia,WPRO,11,7251,0,107
2020-06-07,AU,Australia,WPRO,4,7255,0,107
2020-06-08,AU,Australia,WPRO,5,7260,0,107
2020-03-29,AT,Austria,EURO,784,4946,13,66
2020-03-30,AT,Austria,EURO,610,5556,12,78
2020-03-31,AT,Austria,EURO,544,6100,13,91
2020-04-01,AT,Austria,EURO,664,6764,18,109
2020-04-02,AT,Austria,EURO,547,7311,15,124
2020-04-03,AT,Austria,EURO,546,7857,11,135
2020-04-04,AT,Austria,EURO,433,8290,18,153
2020-04-05,AT,Austria,EURO,409,8699,16,169
2020-04-06,AT,Austria,EURO,248,8947,18,187
2020-04-07,AT,Austria,EURO,183,9130,20,207
2020-04-08,AT,Austria,EURO,303,9433,28,235
2020-04-09,AT,Austria,EURO,288,9721,26,261
2020-04-10,AT,Austria,EURO,287,10008,16,277
2020-04-11,AT,Austria,EURO,276,10284,22,299
2020-04-12,AT,Austria,EURO,357,10641,21,320
2020-04-13,AT,Austria,EURO,203,10844,17,337
2020-04-14,AT,Austria,EURO,111,10955,11,348
2020-04-15,AT,Austria,EURO,87,11042,21,369
2020-04-16,AT,Austria,EURO,149,11191,12,381
2020-04-17,AT,Austria,EURO,128,11319,16,397
2020-04-18,AT,Austria,EURO,112,11431,20,417
2020-04-19,AT,Austria,EURO,99,11530,14,431
2020-04-20,AT,Austria,EURO,59,11589,17,448
2020-04-21,AT,Austria,EURO,47,11636,17,465
2020-04-22,AT,Austria,EURO,65,11701,9,474
2020-04-23,AT,Austria,EURO,70,11771,17,491
2020-04-24,AT,Austria,EURO,70,11841,12,503
2020-04-25,AT,Austria,EURO,60,11901,7,510
2020-04-26,AT,Austria,EURO,79,11980,6,516
2020-04-27,AT,Austria,EURO,62,12042,13,529
2020-04-28,AT,Austria,EURO,36,12078,9,538
2020-04-29,AT,Austria,EURO,68,12146,6,544
2020-04-30,AT,Austria,EURO,49,12195,14,558
2020-05-01,AT,Austria,EURO,60,12255,7,565
2020-05-02,AT,Austria,EURO,54,12309,7,572
2020-05-03,AT,Austria,EURO,37,12346,4,576
2020-05-04,AT,Austria,EURO,28,12374,3,579
2020-05-05,AT,Austria,EURO,12,12386,8,587
2020-05-06,AT,Austria,EURO,30,12416,4,591
2020-05-07,AT,Austria,EURO,54,12470,3,594
2020-05-08,AT,Austria,EURO,46,12516,7,601
2020-05-09,AT,Austria,EURO,40,12556,3,604
2020-05-10,AT,Austria,EURO,49,12605,5,609
2020-05-11,AT,Austria,EURO,30,12635,7,616
2020-05-12,AT,Austria,EURO,15,12650,3,619
2020-05-13,AT,Austria,EURO,65,12715,3,622
2020-05-14,AT,Austria,EURO,38,12753,1,623
2020-05-15,AT,Austria,EURO,52,12805,3,626
2020-05-16,AT,Austria,EURO,54,12859,3,629
2020-05-17,AT,Austria,EURO,75,12934,0,629
2020-05-18,AT,Austria,EURO,15,12949,1,630
2020-05-19,AT,Austria,EURO,26,12975,2,632
2020-05-20,AT,Austria,EURO,58,13033,3,635
2020-05-21,AT,Austria,EURO,61,13094,1,636
2020-05-22,AT,Austria,EURO,30,13124,3,639
2020-05-23,AT,Austria,EURO,31,13155,3,642
2020-05-24,AT,Austria,EURO,28,13183,4,646
2020-05-25,AT,Austria,EURO,24,13207,1,647
2020-05-26,AT,Austria,EURO,31,13238,1,648
2020-05-27,AT,Austria,EURO,25,13263,2,650
2020-05-28,AT,Austria,EURO,22,13285,4,654
2020-05-29,AT,Austria,EURO,50,13335,1,655
2020-05-30,AT,Austria,EURO,19,13354,1,656
2020-05-31,AT,Austria,EURO,42,13396,2,658
2020-06-01,AT,Austria,EURO,32,13428,0,658
2020-06-02,AT,Austria,EURO,5,13433,4,662
2020-06-03,AT,Austria,EURO,19,13452,1,663
2020-06-04,AT,Austria,EURO,16,13468,3,666
2020-06-05,AT,Austria,EURO,53,13521,3,669
2020-06-06,AT,Austria,EURO,17,13538,3,672
2020-06-07,AT,Austria,EURO,66,13604,2,674
2020-06-08,AT,Austria,EURO,31,13635,1,675
2020-03-29,AZ,Azerbaijan,EURO,25,147,0,3
2020-03-30,AZ,Azerbaijan,EURO,17,164,1,4
2020-03-31,AZ,Azerbaijan,EURO,26,190,0,4
2020-04-01,AZ,Azerbaijan,EURO,83,273,0,4
2020-04-02,AZ,Azerbaijan,EURO,25,298,1,5
2020-04-03,AZ,Azerbaijan,EURO,61,359,0,5
2020-04-04,AZ,Azerbaijan,EURO,41,400,0,5
2020-04-05,AZ,Azerbaijan,EURO,43,443,0,5
2020-04-06,AZ,Azerbaijan,EURO,69,512,0,5
2020-04-07,AZ,Azerbaijan,EURO,72,584,0,5
2020-04-08,AZ,Azerbaijan,EURO,57,641,2,7
2020-04-09,AZ,Azerbaijan,EURO,76,717,1,8
2020-04-10,AZ,Azerbaijan,EURO,105,822,0,8
2020-04-11,AZ,Azerbaijan,EURO,104,926,1,9
2020-04-12,AZ,Azerbaijan,EURO,65,991,1,10
2020-04-13,AZ,Azerbaijan,EURO,67,1058,1,11
2020-04-14,AZ,Azerbaijan,EURO,40,1098,0,11
2020-04-15,AZ,Azerbaijan,EURO,50,1148,1,12
2020-04-16,AZ,Azerbaijan,EURO,49,1197,1,13
2020-04-17,AZ,Azerbaijan,EURO,56,1253,0,13
2020-04-18,AZ,Azerbaijan,EURO,30,1283,2,15
2020-04-19,AZ,Azerbaijan,EURO,57,1340,0,15
2020-04-20,AZ,Azerbaijan,EURO,33,1373,3,18
2020-04-21,AZ,Azerbaijan,EURO,25,1398,1,19
2020-04-22,AZ,Azerbaijan,EURO,38,1436,0,19
2020-04-23,AZ,Azerbaijan,EURO,44,1480,1,20
2020-04-24,AZ,Azerbaijan,EURO,38,1518,0,20
2020-04-25,AZ,Azerbaijan,EURO,30,1548,0,20
2020-04-26,AZ,Azerbaijan,EURO,44,1592,1,21
2020-04-27,AZ,Azerbaijan,EURO,25,1617,0,21
2020-04-28,AZ,Azerbaijan,EURO,28,1645,0,21
2020-04-29,AZ,Azerbaijan,EURO,33,1678,1,22
2020-04-30,AZ,Azerbaijan,EURO,39,1717,0,22
2020-05-01,AZ,Azerbaijan,EURO,49,1766,1,23
2020-05-02,AZ,Azerbaijan,EURO,38,1804,1,24
2020-05-03,AZ,Azerbaijan,EURO,50,1854,1,25
2020-05-04,AZ,Azerbaijan,EURO,40,1894,0,25
2020-05-05,AZ,Azerbaijan,EURO,38,1932,0,25
2020-05-06,AZ,Azerbaijan,EURO,52,1984,1,26
2020-05-07,AZ,Azerbaijan,EURO,76,2060,0,26
2020-05-08,AZ,Azerbaijan,EURO,67,2127,2,28
2020-05-09,AZ,Azerbaijan,EURO,77,2204,0,28
2020-05-10,AZ,Azerbaijan,EURO,75,2279,0,28
2020-05-11,AZ,Azerbaijan,EURO,143,2422,3,31
2020-05-12,AZ,Azerbaijan,EURO,97,2519,1,32
2020-05-13,AZ,Azerbaijan,EURO,70,2589,0,32
2020-05-14,AZ,Azerbaijan,EURO,104,2693,1,33
2020-05-15,AZ,Azerbaijan,EURO,65,2758,2,35
2020-05-16,AZ,Azerbaijan,EURO,121,2879,0,35
2020-05-17,AZ,Azerbaijan,EURO,101,2980,1,36
2020-05-18,AZ,Azerbaijan,EURO,158,3138,0,36
2020-05-19,AZ,Azerbaijan,EURO,136,3274,3,39
2020-05-20,AZ,Azerbaijan,EURO,113,3387,1,40
2020-05-21,AZ,Azerbaijan,EURO,131,3518,1,41
2020-05-22,AZ,Azerbaijan,EURO,113,3631,2,43
2020-05-23,AZ,Azerbaijan,EURO,118,3749,1,44
2020-05-24,AZ,Azerbaijan,EURO,106,3855,2,46
2020-05-25,AZ,Azerbaijan,EURO,127,3982,3,49
2020-05-26,AZ,Azerbaijan,EURO,140,4122,0,49
2020-05-27,AZ,Azerbaijan,EURO,149,4271,2,51
2020-05-28,AZ,Azerbaijan,EURO,132,4403,1,52
2020-05-29,AZ,Azerbaijan,EURO,165,4568,2,54
2020-05-30,AZ,Azerbaijan,EURO,191,4759,2,56
2020-05-31,AZ,Azerbaijan,EURO,230,4989,2,58
2020-06-01,AZ,Azerbaijan,EURO,257,5246,3,61
2020-06-02,AZ,Azerbaijan,EURO,248,5494,2,63
2020-06-03,AZ,Azerbaijan,EURO,168,5662,5,68
2020-06-04,AZ,Azerbaijan,EURO,273,5935,3,71
2020-06-05,AZ,Azerbaijan,EURO,325,6260,5,76
2020-06-06,AZ,Azerbaijan,EURO,262,6522,2,78
2020-06-07,AZ,Azerbaijan,EURO,338,6860,4,82
2020-06-08,AZ,Azerbaijan,EURO,379,7239,2,84
2020-03-29,BS,Bahamas,AMRO,0,9,0,0
2020-03-30,BS,Bahamas,AMRO,1,10,0,0
2020-03-31,BS,Bahamas,AMRO,4,14,0,0
2020-04-01,BS,Bahamas,AMRO,0,14,0,0
2020-04-02,BS,Bahamas,AMRO,1,15,0,0
2020-04-03,BS,Bahamas,AMRO,6,21,1,1
2020-04-04,BS,Bahamas,AMRO,3,24,2,3
2020-04-05,BS,Bahamas,AMRO,0,24,0,3
2020-04-06,BS,Bahamas,AMRO,4,28,1,4
2020-04-07,BS,Bahamas,AMRO,1,29,1,5
2020-04-08,BS,Bahamas,AMRO,4,33,0,5
2020-04-09,BS,Bahamas,AMRO,3,36,1,6
2020-04-10,BS,Bahamas,AMRO,4,40,1,7
2020-04-11,BS,Bahamas,AMRO,1,41,1,8
2020-04-12,BS,Bahamas,AMRO,1,42,0,8
2020-04-13,BS,Bahamas,AMRO,0,42,0,8
2020-04-14,BS,Bahamas,AMRO,5,47,0,8
2020-04-15,BS,Bahamas,AMRO,2,49,0,8
2020-04-16,BS,Bahamas,AMRO,0,49,0,8
2020-04-17,BS,Bahamas,AMRO,4,53,0,8
2020-04-18,BS,Bahamas,AMRO,1,54,1,9
2020-04-19,BS,Bahamas,AMRO,0,54,0,9
2020-04-20,BS,Bahamas,AMRO,4,58,0,9
2020-04-21,BS,Bahamas,AMRO,2,60,0,9
2020-04-22,BS,Bahamas,AMRO,4,64,0,9
2020-04-23,BS,Bahamas,AMRO,1,65,0,9
2020-04-24,BS,Bahamas,AMRO,5,70,0,9
2020-04-25,BS,Bahamas,AMRO,2,72,2,11
2020-04-26,BS,Bahamas,AMRO,0,72,0,11
2020-04-27,BS,Bahamas,AMRO,6,78,0,11
2020-04-28,BS,Bahamas,AMRO,2,80,0,11
2020-04-29,BS,Bahamas,AMRO,0,80,0,11
2020-04-30,BS,Bahamas,AMRO,0,80,0,11
2020-05-01,BS,Bahamas,AMRO,0,80,0,11
2020-05-02,BS,Bahamas,AMRO,1,81,0,11
2020-05-03,BS,Bahamas,AMRO,1,82,0,11
2020-05-04,BS,Bahamas,AMRO,0,82,0,11
2020-05-05,BS,Bahamas,AMRO,1,83,0,11
2020-05-06,BS,Bahamas,AMRO,1,84,0,11
2020-05-07,BS,Bahamas,AMRO,5,89,0,11
2020-05-08,BS,Bahamas,AMRO,3,92,0,11
2020-05-09,BS,Bahamas,AMRO,0,92,0,11
2020-05-10,BS,Bahamas,AMRO,0,92,0,11
2020-05-11,BS,Bahamas,AMRO,0,92,0,11
2020-05-12,BS,Bahamas,AMRO,0,92,0,11
2020-05-13,BS,Bahamas,AMRO,1,93,0,11
2020-05-14,BS,Bahamas,AMRO,0,93,0,11
2020-05-15,BS,Bahamas,AMRO,1,94,0,11
2020-05-16,BS,Bahamas,AMRO,2,96,0,11
2020-05-17,BS,Bahamas,AMRO,0,96,0,11
2020-05-18,BS,Bahamas,AMRO,0,96,0,11
2020-05-19,BS,Bahamas,AMRO,0,96,0,11
2020-05-20,BS,Bahamas,AMRO,0,96,0,11
2020-05-21,BS,Bahamas,AMRO,0,96,0,11
2020-05-22,BS,Bahamas,AMRO,1,97,0,11
2020-05-23,BS,Bahamas,AMRO,0,97,0,11
2020-05-24,BS,Bahamas,AMRO,0,97,0,11
2020-05-25,BS,Bahamas,AMRO,3,100,0,11
2020-05-26,BS,Bahamas,AMRO,0,100,0,11
2020-05-27,BS,Bahamas,AMRO,0,100,0,11
2020-05-28,BS,Bahamas,AMRO,0,100,0,11
2020-05-29,BS,Bahamas,AMRO,0,100,0,11
2020-05-30,BS,Bahamas,AMRO,1,101,0,11
2020-05-31,BS,Bahamas,AMRO,0,101,0,11
2020-06-01,BS,Bahamas,AMRO,0,101,0,11
2020-06-02,BS,Bahamas,AMRO,1,102,0,11
2020-06-03,BS,Bahamas,AMRO,0,102,0,11
2020-06-04,BS,Bahamas,AMRO,0,102,0,11
2020-06-05,BS,Bahamas,AMRO,0,102,0,11
2020-06-06,BS,Bahamas,AMRO,0,102,0,11
2020-06-07,BS,Bahamas,AMRO,1,103,0,11
2020-06-08,BS,Bahamas,AMRO,0,103,0,11
2020-03-29,BH,Bahrain,EMRO,10,476,0,4
2020-03-30,BH,Bahrain,EMRO,24,500,0,4
2020-03-31,BH,Bahrain,EMRO,15,515,0,4
2020-04-01,BH,Bahrain,EMRO,52,567,0,4
2020-04-02,BH,Bahrain,EMRO,2,569,0,4
2020-04-03,BH,Bahrain,EMRO,74,643,0,4
2020-04-04,BH,Bahrain,EMRO,30,673,0,4
2020-04-05,BH,Bahrain,EMRO,15,688,0,4
2020-04-06,BH,Bahrain,EMRO,12,700,0,4
2020-04-07,BH,Bahrain,EMRO,56,756,0,4
2020-04-08,BH,Bahrain,EMRO,55,811,1,5
2020-04-09,BH,Bahrain,EMRO,12,823,0,5
2020-04-10,BH,Bahrain,EMRO,64,887,0,5
2020-04-11,BH,Bahrain,EMRO,38,925,1,6
2020-04-12,BH,Bahrain,EMRO,115,1040,0,6
2020-04-13,BH,Bahrain,EMRO,96,1136,0,6
2020-04-14,BH,Bahrain,EMRO,225,1361,0,6
2020-04-15,BH,Bahrain,EMRO,167,1528,1,7
2020-04-16,BH,Bahrain,EMRO,145,1673,0,7
2020-04-17,BH,Bahrain,EMRO,27,1700,0,7
2020-04-18,BH,Bahrain,EMRO,44,1744,0,7
2020-04-19,BH,Bahrain,EMRO,29,1773,0,7
2020-04-20,BH,Bahrain,EMRO,108,1881,0,7
2020-04-21,BH,Bahrain,EMRO,26,1907,0,7
2020-04-22,BH,Bahrain,EMRO,66,1973,0,7
2020-04-23,BH,Bahrain,EMRO,54,2027,0,7
2020-04-24,BH,Bahrain,EMRO,190,2217,1,8
2020-04-25,BH,Bahrain,EMRO,301,2518,0,8
2020-04-26,BH,Bahrain,EMRO,71,2589,0,8
2020-04-27,BH,Bahrain,EMRO,58,2647,0,8
2020-04-28,BH,Bahrain,EMRO,76,2723,0,8
2020-04-29,BH,Bahrain,EMRO,88,2811,0,8
2020-04-30,BH,Bahrain,EMRO,110,2921,0,8
2020-05-01,BH,Bahrain,EMRO,119,3040,0,8
2020-05-02,BH,Bahrain,EMRO,130,3170,0,8
2020-05-03,BH,Bahrain,EMRO,114,3284,0,8
2020-05-04,BH,Bahrain,EMRO,99,3383,0,8
2020-05-05,BH,Bahrain,EMRO,150,3533,0,8
2020-05-06,BH,Bahrain,EMRO,187,3720,0,8
2020-05-07,BH,Bahrain,EMRO,214,3934,0,8
2020-05-08,BH,Bahrain,EMRO,265,4199,0,8
2020-05-09,BH,Bahrain,EMRO,245,4444,0,8
2020-05-10,BH,Bahrain,EMRO,330,4774,0,8
2020-05-11,BH,Bahrain,EMRO,167,4941,0,8
2020-05-12,BH,Bahrain,EMRO,295,5236,0,8
2020-05-13,BH,Bahrain,EMRO,295,5531,1,9
2020-05-14,BH,Bahrain,EMRO,285,5816,1,10
2020-05-15,BH,Bahrain,EMRO,382,6198,0,10
2020-05-16,BH,Bahrain,EMRO,384,6582,0,10
2020-05-17,BH,Bahrain,EMRO,165,6747,2,12
2020-05-18,BH,Bahrain,EMRO,183,6930,0,12
2020-05-19,BH,Bahrain,EMRO,254,7184,0,12
2020-05-20,BH,Bahrain,EMRO,348,7532,0,12
2020-05-21,BH,Bahrain,EMRO,356,7888,0,12
2020-05-22,BH,Bahrain,EMRO,286,8174,0,12
2020-05-23,BH,Bahrain,EMRO,240,8414,0,12
2020-05-24,BH,Bahrain,EMRO,388,8802,1,13
2020-05-25,BH,Bahrain,EMRO,336,9138,0,13
2020-05-26,BH,Bahrain,EMRO,33,9171,1,14
2020-05-27,BH,Bahrain,EMRO,195,9366,0,14
2020-05-28,BH,Bahrain,EMRO,326,9692,1,15
2020-05-29,BH,Bahrain,EMRO,360,10052,0,15
2020-05-30,BH,Bahrain,EMRO,397,10449,0,15
2020-05-31,BH,Bahrain,EMRO,344,10793,2,17
2020-06-01,BH,Bahrain,EMRO,605,11398,2,19
2020-06-02,BH,Bahrain,EMRO,473,11871,0,19
2020-06-03,BH,Bahrain,EMRO,440,12311,0,19
2020-06-04,BH,Bahrain,EMRO,504,12815,1,20
2020-06-05,BH,Bahrain,EMRO,481,13296,1,21
2020-06-06,BH,Bahrain,EMRO,539,13835,1,22
2020-06-07,BH,Bahrain,EMRO,548,14383,2,24
2020-06-08,BH,Bahrain,EMRO,379,14762,2,26
2020-03-29,BD,Bangladesh,SEARO,0,48,0,5
2020-03-30,BD,Bangladesh,SEARO,1,49,0,5
2020-03-31,BD,Bangladesh,SEARO,2,51,0,5
2020-04-01,BD,Bangladesh,SEARO,3,54,1,6
2020-04-02,BD,Bangladesh,SEARO,2,56,0,6
2020-04-03,BD,Bangladesh,SEARO,5,61,0,6
2020-04-04,BD,Bangladesh,SEARO,9,70,2,8
2020-04-05,BD,Bangladesh,SEARO,18,88,0,8
2020-04-06,BD,Bangladesh,SEARO,35,123,4,12
2020-04-07,BD,Bangladesh,SEARO,41,164,5,17
2020-04-08,BD,Bangladesh,SEARO,54,218,3,20
2020-04-09,BD,Bangladesh,SEARO,112,330,1,21
2020-04-10,BD,Bangladesh,SEARO,94,424,6,27
2020-04-11,BD,Bangladesh,SEARO,58,482,3,30
2020-04-12,BD,Bangladesh,SEARO,139,621,4,34
2020-04-13,BD,Bangladesh,SEARO,182,803,5,39
2020-04-14,BD,Bangladesh,SEARO,209,1012,7,46
2020-04-15,BD,Bangladesh,SEARO,219,1231,4,50
2020-04-16,BD,Bangladesh,SEARO,341,1572,10,60
2020-04-17,BD,Bangladesh,SEARO,266,1838,15,75
2020-04-18,BD,Bangladesh,SEARO,306,2144,9,84
2020-04-19,BD,Bangladesh,SEARO,312,2456,7,91
2020-04-20,BD,Bangladesh,SEARO,492,2948,10,101
2020-04-21,BD,Bangladesh,SEARO,434,3382,9,110
2020-04-22,BD,Bangladesh,SEARO,390,3772,10,120
2020-04-23,BD,Bangladesh,SEARO,414,4186,7,127
2020-04-24,BD,Bangladesh,SEARO,503,4689,4,131
2020-04-25,BD,Bangladesh,SEARO,309,4998,9,140
2020-04-26,BD,Bangladesh,SEARO,418,5416,5,145
2020-04-27,BD,Bangladesh,SEARO,497,5913,7,152
2020-04-28,BD,Bangladesh,SEARO,549,6462,3,155
2020-04-29,BD,Bangladesh,SEARO,641,7103,8,163
2020-04-30,BD,Bangladesh,SEARO,564,7667,5,168
2020-05-01,BD,Bangladesh,SEARO,571,8238,2,170
2020-05-02,BD,Bangladesh,SEARO,552,8790,5,175
2020-05-03,BD,Bangladesh,SEARO,665,9455,2,177
2020-05-04,BD,Bangladesh,SEARO,688,10143,5,182
2020-05-05,BD,Bangladesh,SEARO,786,10929,1,183
2020-05-06,BD,Bangladesh,SEARO,790,11719,3,186
2020-05-07,BD,Bangladesh,SEARO,706,12425,13,199
2020-05-08,BD,Bangladesh,SEARO,709,13134,7,206
2020-05-09,BD,Bangladesh,SEARO,636,13770,8,214
2020-05-10,BD,Bangladesh,SEARO,887,14657,14,228
2020-05-11,BD,Bangladesh,SEARO,1034,15691,11,239
2020-05-12,BD,Bangladesh,SEARO,969,16660,11,250
2020-05-13,BD,Bangladesh,SEARO,1162,17822,19,269
2020-05-14,BD,Bangladesh,SEARO,1041,18863,14,283
2020-05-15,BD,Bangladesh,SEARO,1202,20065,15,298
2020-05-16,BD,Bangladesh,SEARO,930,20995,16,314
2020-05-17,BD,Bangladesh,SEARO,1273,22268,14,328
2020-05-18,BD,Bangladesh,SEARO,1602,23870,21,349
2020-05-19,BD,Bangladesh,SEARO,1251,25121,21,370
2020-05-20,BD,Bangladesh,SEARO,1617,26738,16,386
2020-05-21,BD,Bangladesh,SEARO,1773,28511,22,408
2020-05-22,BD,Bangladesh,SEARO,1694,30205,24,432
2020-05-23,BD,Bangladesh,SEARO,1873,32078,20,452
2020-05-24,BD,Bangladesh,SEARO,1532,33610,28,480
2020-05-25,BD,Bangladesh,SEARO,1975,35585,21,501
2020-05-26,BD,Bangladesh,SEARO,1166,36751,21,522
2020-05-27,BD,Bangladesh,SEARO,1541,38292,22,544
2020-05-28,BD,Bangladesh,SEARO,2029,40321,15,559
2020-05-29,BD,Bangladesh,SEARO,2523,42844,23,582
2020-05-30,BD,Bangladesh,SEARO,1764,44608,28,610
2020-05-31,BD,Bangladesh,SEARO,2545,47153,40,650
2020-06-01,BD,Bangladesh,SEARO,2381,49534,22,672
2020-06-02,BD,Bangladesh,SEARO,2911,52445,37,709
2020-06-03,BD,Bangladesh,SEARO,2695,55140,37,746
2020-06-04,BD,Bangladesh,SEARO,2423,57563,35,781
2020-06-05,BD,Bangladesh,SEARO,2828,60391,30,811
2020-06-06,BD,Bangladesh,SEARO,2635,63026,35,846
2020-06-07,BD,Bangladesh,SEARO,2743,65769,42,888
2020-06-08,BD,Bangladesh,SEARO,2735,68504,42,930
2020-03-29,BB,Barbados,AMRO,0,24,0,0
2020-03-30,BB,Barbados,AMRO,2,26,0,0
2020-03-31,BB,Barbados,AMRO,7,33,0,0
2020-04-01,BB,Barbados,AMRO,0,33,0,0
2020-04-02,BB,Barbados,AMRO,0,33,0,0
2020-04-03,BB,Barbados,AMRO,12,45,0,0
2020-04-04,BB,Barbados,AMRO,0,45,0,0
2020-04-05,BB,Barbados,AMRO,6,51,0,0
2020-04-06,BB,Barbados,AMRO,0,51,0,0
2020-04-07,BB,Barbados,AMRO,5,56,1,1
2020-04-08,BB,Barbados,AMRO,4,60,1,2
2020-04-09,BB,Barbados,AMRO,3,63,1,3
2020-04-10,BB,Barbados,AMRO,0,63,0,3
2020-04-11,BB,Barbados,AMRO,3,66,1,4
2020-04-12,BB,Barbados,AMRO,1,67,0,4
2020-04-13,BB,Barbados,AMRO,1,68,0,4
2020-04-14,BB,Barbados,AMRO,3,71,0,4
2020-04-15,BB,Barbados,AMRO,1,72,0,4
2020-04-16,BB,Barbados,AMRO,1,73,1,5
2020-04-17,BB,Barbados,AMRO,2,75,0,5
2020-04-18,BB,Barbados,AMRO,0,75,0,5
2020-04-19,BB,Barbados,AMRO,0,75,0,5
2020-04-20,BB,Barbados,AMRO,0,75,0,5
2020-04-21,BB,Barbados,AMRO,0,75,0,5
2020-04-22,BB,Barbados,AMRO,0,75,0,5
2020-04-23,BB,Barbados,AMRO,0,75,0,5
2020-04-24,BB,Barbados,AMRO,1,76,1,6
2020-04-25,BB,Barbados,AMRO,0,76,0,6
2020-04-26,BB,Barbados,AMRO,1,77,0,6
2020-04-27,BB,Barbados,AMRO,2,79,0,6
2020-04-28,BB,Barbados,AMRO,0,79,0,6
2020-04-29,BB,Barbados,AMRO,1,80,0,6
2020-04-30,BB,Barbados,AMRO,0,80,0,6
2020-05-01,BB,Barbados,AMRO,0,80,1,7
2020-05-02,BB,Barbados,AMRO,1,81,0,7
2020-05-03,BB,Barbados,AMRO,0,81,0,7
2020-05-04,BB,Barbados,AMRO,0,81,0,7
2020-05-05,BB,Barbados,AMRO,1,82,0,7
2020-05-06,BB,Barbados,AMRO,0,82,0,7
2020-05-07,BB,Barbados,AMRO,0,82,0,7
2020-05-08,BB,Barbados,AMRO,0,82,0,7
2020-05-09,BB,Barbados,AMRO,0,82,0,7
2020-05-10,BB,Barbados,AMRO,0,82,0,7
2020-05-11,BB,Barbados,AMRO,2,84,0,7
2020-05-12,BB,Barbados,AMRO,0,84,0,7
2020-05-13,BB,Barbados,AMRO,0,84,0,7
2020-05-14,BB,Barbados,AMRO,1,85,0,7
2020-05-15,BB,Barbados,AMRO,0,85,0,7
2020-05-16,BB,Barbados,AMRO,0,85,0,7
2020-05-17,BB,Barbados,AMRO,0,85,0,7
2020-05-18,BB,Barbados,AMRO,1,86,0,7
2020-05-19,BB,Barbados,AMRO,2,88,0,7
2020-05-20,BB,Barbados,AMRO,0,88,0,7
2020-05-21,BB,Barbados,AMRO,2,90,0,7
2020-05-22,BB,Barbados,AMRO,0,90,0,7
2020-05-23,BB,Barbados,AMRO,0,90,0,7
2020-05-24,BB,Barbados,AMRO,0,90,0,7
2020-05-25,BB,Barbados,AMRO,2,92,0,7
2020-05-26,BB,Barbados,AMRO,0,92,0,7
2020-05-27,BB,Barbados,AMRO,0,92,0,7
2020-05-28,BB,Barbados,AMRO,0,92,0,7
2020-05-29,BB,Barbados,AMRO,0,92,0,7
2020-05-30,BB,Barbados,AMRO,0,92,0,7
2020-05-31,BB,Barbados,AMRO,0,92,0,7
2020-06-01,BB,Barbados,AMRO,0,92,0,7
2020-06-02,BB,Barbados,AMRO,0,92,0,7
2020-06-03,BB,Barbados,AMRO,0,92,0,7
2020-06-04,BB,Barbados,AMRO,0,92,0,7
2020-06-05,BB,Barbados,AMRO,0,92,0,7
2020-06-06,BB,Barbados,AMRO,0,92,0,7
2020-06-07,BB,Barbados,AMRO,0,92,0,7
2020-06-08,BB,Barbados,AMRO,0,92,0,7
2020-03-29,BY,Belarus,EURO,0,94,0,0
2020-03-30,BY,Belarus,EURO,0,94,0,0
2020-03-31,BY,Belarus,EURO,58,152,0,0
2020-04-01,BY,Belarus,EURO,40,192,2,2
2020-04-02,BY,Belarus,EURO,0,192,0,2
2020-04-03,BY,Belarus,EURO,62,254,2,4
2020-04-04,BY,Belarus,EURO,0,254,0,4
2020-04-05,BY,Belarus,EURO,186,440,0,4
2020-04-06,BY,Belarus,EURO,122,562,4,8
2020-04-07,BY,Belarus,EURO,138,700,5,13
2020-04-08,BY,Belarus,EURO,161,861,0,13
2020-04-09,BY,Belarus,EURO,205,1066,0,13
2020-04-10,BY,Belarus,EURO,0,1066,0,13
2020-04-11,BY,Belarus,EURO,915,1981,6,19
2020-04-12,BY,Belarus,EURO,245,2226,4,23
2020-04-13,BY,Belarus,EURO,352,2578,3,26
2020-04-14,BY,Belarus,EURO,341,2919,3,29
2020-04-15,BY,Belarus,EURO,362,3281,4,33
2020-04-16,BY,Belarus,EURO,447,3728,3,36
2020-04-17,BY,Belarus,EURO,476,4204,4,40
2020-04-18,BY,Belarus,EURO,575,4779,3,43
2020-04-19,BY,Belarus,EURO,510,5289,2,45
2020-04-20,BY,Belarus,EURO,518,5807,2,47
2020-04-21,BY,Belarus,EURO,457,6264,4,51
2020-04-22,BY,Belarus,EURO,459,6723,4,55
2020-04-23,BY,Belarus,EURO,558,7281,5,60
2020-04-24,BY,Belarus,EURO,741,8022,0,60
2020-04-25,BY,Belarus,EURO,751,8773,3,63
2020-04-26,BY,Belarus,EURO,817,9590,4,67
2020-04-27,BY,Belarus,EURO,873,10463,5,72
2020-04-28,BY,Belarus,EURO,1745,12208,7,79
2020-04-29,BY,Belarus,EURO,0,12208,0,79
2020-04-30,BY,Belarus,EURO,973,13181,5,84
2020-05-01,BY,Belarus,EURO,846,14027,5,89
2020-05-02,BY,Belarus,EURO,890,14917,4,93
2020-05-03,BY,Belarus,EURO,911,15828,4,97
2020-05-04,BY,Belarus,EURO,1661,17489,6,103
2020-05-05,BY,Belarus,EURO,0,17489,0,103
2020-05-06,BY,Belarus,EURO,1766,19255,9,112
2020-05-07,BY,Belarus,EURO,0,19255,0,112
2020-05-08,BY,Belarus,EURO,913,20168,4,116
2020-05-09,BY,Belarus,EURO,933,21101,5,121
2020-05-10,BY,Belarus,EURO,1872,22973,10,131
2020-05-11,BY,Belarus,EURO,933,23906,4,135
2020-05-12,BY,Belarus,EURO,0,23906,0,135
2020-05-13,BY,Belarus,EURO,1934,25840,14,149
2020-05-14,BY,Belarus,EURO,0,25840,0,149
2020-05-15,BY,Belarus,EURO,932,26772,2,151
2020-05-16,BY,Belarus,EURO,958,27730,5,156
2020-05-17,BY,Belarus,EURO,951,28681,4,160
2020-05-18,BY,Belarus,EURO,969,29650,5,165
2020-05-19,BY,Belarus,EURO,922,30572,6,171
2020-05-20,BY,Belarus,EURO,936,31508,4,175
2020-05-21,BY,Belarus,EURO,1863,33371,10,185
2020-05-22,BY,Belarus,EURO,932,34303,5,190
2020-05-23,BY,Belarus,EURO,0,34303,0,190
2020-05-24,BY,Belarus,EURO,941,35244,4,194
2020-05-25,BY,Belarus,EURO,954,36198,5,199
2020-05-26,BY,Belarus,EURO,946,37144,5,204
2020-05-27,BY,Belarus,EURO,915,38059,4,208
2020-05-28,BY,Belarus,EURO,897,38956,6,214
2020-05-29,BY,Belarus,EURO,902,39858,5,219
2020-05-30,BY,Belarus,EURO,906,40764,5,224
2020-05-31,BY,Belarus,EURO,894,41658,5,229
2020-06-01,BY,Belarus,EURO,898,42556,6,235
2020-06-02,BY,Belarus,EURO,847,43403,5,240
2020-06-03,BY,Belarus,EURO,852,44255,3,243
2020-06-04,BY,Belarus,EURO,861,45116,5,248
2020-06-05,BY,Belarus,EURO,865,45981,5,253
2020-06-06,BY,Belarus,EURO,887,46868,6,259
2020-06-07,BY,Belarus,EURO,0,46868,0,259
2020-06-08,BY,Belarus,EURO,1762,48630,10,269
2020-03-29,BE,Belgium,EURO,1518,12031,136,751
2020-03-30,BE,Belgium,EURO,844,12875,143,894
2020-03-31,BE,Belgium,EURO,683,13558,145,1039
2020-04-01,BE,Belgium,EURO,1738,15296,171,1210
2020-04-02,BE,Belgium,EURO,1681,16977,201,1411
2020-04-03,BE,Belgium,EURO,1516,18493,241,1652
2020-04-04,BE,Belgium,EURO,1478,19971,214,1866
2020-04-05,BE,Belgium,EURO,1694,21665,242,2108
2020-04-06,BE,Belgium,EURO,922,22587,269,2377
2020-04-07,BE,Belgium,EURO,665,23252,246,2623
2020-04-08,BE,Belgium,EURO,1934,25186,255,2878
2020-04-09,BE,Belgium,EURO,1515,26701,276,3154
2020-04-10,BE,Belgium,EURO,1598,28299,324,3478
2020-04-11,BE,Belgium,EURO,2239,30538,270,3748
2020-04-12,BE,Belgium,EURO,2336,32874,304,4052
2020-04-13,BE,Belgium,EURO,1029,33903,288,4340
2020-04-14,BE,Belgium,EURO,524,34427,268,4608
2020-04-15,BE,Belgium,EURO,537,34964,275,4883
2020-04-16,BE,Belgium,EURO,1560,36524,259,5142
2020-04-17,BE,Belgium,EURO,1633,38157,280,5422
2020-04-18,BE,Belgium,EURO,1674,39831,245,5667
2020-04-19,BE,Belgium,EURO,1394,41225,205,5872
2020-04-20,BE,Belgium,EURO,722,41947,210,6082
2020-04-21,BE,Belgium,EURO,443,42390,186,6268
2020-04-22,BE,Belgium,EURO,1276,43666,208,6476
2020-04-23,BE,Belgium,EURO,1270,44936,192,6668
2020-04-24,BE,Belgium,EURO,777,45713,181,6849
2020-04-25,BE,Belgium,EURO,976,46689,156,7005
2020-04-26,BE,Belgium,EURO,811,47500,156,7161
2020-04-27,BE,Belgium,EURO,388,47888,142,7303
2020-04-28,BE,Belgium,EURO,205,48093,152,7455
2020-04-29,BE,Belgium,EURO,755,48848,132,7587
2020-04-30,BE,Belgium,EURO,569,49417,113,7700
2020-05-01,BE,Belgium,EURO,522,49939,107,7807
2020-05-02,BE,Belgium,EURO,586,50525,91,7898
2020-05-03,BE,Belgium,EURO,237,50762,94,7992
2020-05-04,BE,Belgium,EURO,286,51048,79,8071
2020-05-05,BE,Belgium,EURO,140,51188,91,8162
2020-05-06,BE,Belgium,EURO,670,51858,93,8255
2020-05-07,BE,Belgium,EURO,546,52404,84,8339
2020-05-08,BE,Belgium,EURO,552,52956,77,8416
2020-05-09,BE,Belgium,EURO,442,53398,68,8484
2020-05-10,BE,Belgium,EURO,483,53881,80,8564
2020-05-11,BE,Belgium,EURO,240,54121,76,8640
2020-05-12,BE,Belgium,EURO,118,54239,72,8712
2020-05-13,BE,Belgium,EURO,476,54715,66,8778
2020-05-14,BE,Belgium,EURO,395,55110,47,8825
2020-05-15,BE,Belgium,EURO,321,55431,60,8885
2020-05-16,BE,Belgium,EURO,305,55736,46,8931
2020-05-17,BE,Belgium,EURO,346,56082,47,8978
2020-05-18,BE,Belgium,EURO,147,56229,29,9007
2020-05-19,BE,Belgium,EURO,81,56310,32,9039
2020-05-20,BE,Belgium,EURO,317,56627,39,9078
2020-05-21,BE,Belgium,EURO,292,56919,36,9114
2020-05-22,BE,Belgium,EURO,385,57304,31,9145
2020-05-23,BE,Belgium,EURO,70,57374,38,9183
2020-05-24,BE,Belgium,EURO,248,57622,42,9225
2020-05-25,BE,Belgium,EURO,123,57745,28,9253
2020-05-26,BE,Belgium,EURO,75,57820,32,9285
2020-05-27,BE,Belgium,EURO,314,58134,26,9311
2020-05-28,BE,Belgium,EURO,202,58336,26,9337
2020-05-29,BE,Belgium,EURO,182,58518,25,9362
2020-05-30,BE,Belgium,EURO,171,58689,28,9390
2020-05-31,BE,Belgium,EURO,165,58854,16,9406
2020-06-01,BE,Belgium,EURO,61,58915,25,9431
2020-06-02,BE,Belgium,EURO,49,58964,22,9453
2020-06-03,BE,Belgium,EURO,59,59023,21,9474
2020-06-04,BE,Belgium,EURO,181,59204,24,9498
2020-06-05,BE,Belgium,EURO,159,59363,19,9517
2020-06-06,BE,Belgium,EURO,172,59535,17,9534
2020-06-07,BE,Belgium,EURO,154,59689,13,9547
2020-06-08,BE,Belgium,EURO,69,59758,11,9558
2020-03-29,BZ,Belize,AMRO,0,2,0,0
2020-03-30,BZ,Belize,AMRO,0,2,0,0
2020-03-31,BZ,Belize,AMRO,1,3,0,0
2020-04-01,BZ,Belize,AMRO,0,3,0,0
2020-04-02,BZ,Belize,AMRO,0,3,0,0
2020-04-03,BZ,Belize,AMRO,0,3,0,0
2020-04-04,BZ,Belize,AMRO,0,3,0,0
2020-04-05,BZ,Belize,AMRO,1,4,0,0
2020-04-06,BZ,Belize,AMRO,1,5,0,0
2020-04-07,BZ,Belize,AMRO,2,7,1,1
2020-04-08,BZ,Belize,AMRO,0,7,0,1
2020-04-09,BZ,Belize,AMRO,1,8,0,1
2020-04-10,BZ,Belize,AMRO,1,9,0,1
2020-04-11,BZ,Belize,AMRO,1,10,0,1
2020-04-12,BZ,Belize,AMRO,0,10,1,2
2020-04-13,BZ,Belize,AMRO,3,13,0,2
2020-04-14,BZ,Belize,AMRO,1,14,0,2
2020-04-15,BZ,Belize,AMRO,4,18,0,2
2020-04-16,BZ,Belize,AMRO,0,18,0,2
2020-04-17,BZ,Belize,AMRO,0,18,0,2
2020-04-18,BZ,Belize,AMRO,0,18,0,2
2020-04-19,BZ,Belize,AMRO,0,18,0,2
2020-04-20,BZ,Belize,AMRO,0,18,0,2
2020-04-21,BZ,Belize,AMRO,0,18,0,2
2020-04-22,BZ,Belize,AMRO,0,18,0,2
2020-04-23,BZ,Belize,AMRO,0,18,0,2
2020-04-24,BZ,Belize,AMRO,0,18,0,2
2020-04-25,BZ,Belize,AMRO,0,18,0,2
2020-04-26,BZ,Belize,AMRO,0,18,0,2
2020-04-27,BZ,Belize,AMRO,0,18,0,2
2020-04-28,BZ,Belize,AMRO,0,18,0,2
2020-04-29,BZ,Belize,AMRO,0,18,0,2
2020-04-30,BZ,Belize,AMRO,0,18,0,2
2020-05-01,BZ,Belize,AMRO,0,18,0,2
2020-05-02,BZ,Belize,AMRO,0,18,0,2
2020-05-03,BZ,Belize,AMRO,0,18,0,2
2020-05-04,BZ,Belize,AMRO,0,18,0,2
2020-05-05,BZ,Belize,AMRO,0,18,0,2
2020-05-06,BZ,Belize,AMRO,0,18,0,2
2020-05-07,BZ,Belize,AMRO,0,18,0,2
2020-05-08,BZ,Belize,AMRO,0,18,0,2
2020-05-09,BZ,Belize,AMRO,0,18,0,2
2020-05-10,BZ,Belize,AMRO,0,18,0,2
2020-05-11,BZ,Belize,AMRO,0,18,0,2
2020-05-12,BZ,Belize,AMRO,0,18,0,2
2020-05-13,BZ,Belize,AMRO,0,18,0,2
2020-05-14,BZ,Belize,AMRO,0,18,0,2
2020-05-15,BZ,Belize,AMRO,0,18,0,2
2020-05-16,BZ,Belize,AMRO,0,18,0,2
2020-05-17,BZ,Belize,AMRO,0,18,0,2
2020-05-18,BZ,Belize,AMRO,0,18,0,2
2020-05-19,BZ,Belize,AMRO,0,18,0,2
2020-05-20,BZ,Belize,AMRO,0,18,0,2
2020-05-21,BZ,Belize,AMRO,0,18,0,2
2020-05-22,BZ,Belize,AMRO,0,18,0,2
2020-05-23,BZ,Belize,AMRO,0,18,0,2
2020-05-24,BZ,Belize,AMRO,0,18,0,2
2020-05-25,BZ,Belize,AMRO,0,18,0,2
2020-05-26,BZ,Belize,AMRO,0,18,0,2
2020-05-27,BZ,Belize,AMRO,0,18,0,2
2020-05-28,BZ,Belize,AMRO,0,18,0,2
2020-05-29,BZ,Belize,AMRO,0,18,0,2
2020-05-30,BZ,Belize,AMRO,0,18,0,2
2020-05-31,BZ,Belize,AMRO,0,18,0,2
2020-06-01,BZ,Belize,AMRO,0,18,0,2
2020-06-02,BZ,Belize,AMRO,0,18,0,2
2020-06-03,BZ,Belize,AMRO,0,18,0,2
2020-06-04,BZ,Belize,AMRO,0,18,0,2
2020-06-05,BZ,Belize,AMRO,0,18,0,2
2020-06-06,BZ,Belize,AMRO,0,18,0,2
2020-06-07,BZ,Belize,AMRO,1,19,0,2
2020-06-08,BZ,Belize,AMRO,0,19,0,2
2020-03-29,BJ,Benin,AFRO,0,3,0,2
2020-03-30,BJ,Benin,AFRO,0,3,0,2
2020-03-31,BJ,Benin,AFRO,0,3,0,2
2020-04-01,BJ,Benin,AFRO,3,6,0,2
2020-04-02,BJ,Benin,AFRO,7,13,0,2
2020-04-03,BJ,Benin,AFRO,0,13,0,2
2020-04-04,BJ,Benin,AFRO,0,13,0,2
2020-04-05,BJ,Benin,AFRO,0,13,0,2
2020-04-06,BJ,Benin,AFRO,9,22,0,2
2020-04-07,BJ,Benin,AFRO,1,23,0,2
2020-04-08,BJ,Benin,AFRO,3,26,0,2
2020-04-09,BJ,Benin,AFRO,4,30,0,2
2020-04-10,BJ,Benin,AFRO,0,30,0,2
2020-04-11,BJ,Benin,AFRO,0,30,0,2
2020-04-12,BJ,Benin,AFRO,5,35,0,2
2020-04-13,BJ,Benin,AFRO,0,35,0,2
2020-04-14,BJ,Benin,AFRO,0,35,0,2
2020-04-15,BJ,Benin,AFRO,0,35,0,2
2020-04-16,BJ,Benin,AFRO,2,37,0,2
2020-04-17,BJ,Benin,AFRO,0,37,0,2
2020-04-18,BJ,Benin,AFRO,17,54,0,2
2020-04-19,BJ,Benin,AFRO,0,54,0,2
2020-04-20,BJ,Benin,AFRO,0,54,0,2
2020-04-21,BJ,Benin,AFRO,0,54,0,2
2020-04-22,BJ,Benin,AFRO,0,54,0,2
2020-04-23,BJ,Benin,AFRO,3,57,0,2
2020-04-24,BJ,Benin,AFRO,1,58,0,2
2020-04-25,BJ,Benin,AFRO,1,59,0,2
2020-04-26,BJ,Benin,AFRO,1,60,0,2
2020-04-27,BJ,Benin,AFRO,8,68,0,2
2020-04-28,BJ,Benin,AFRO,1,69,0,2
2020-04-29,BJ,Benin,AFRO,10,79,0,2
2020-04-30,BJ,Benin,AFRO,5,84,0,2
2020-05-01,BJ,Benin,AFRO,0,84,0,2
2020-05-02,BJ,Benin,AFRO,6,90,0,2
2020-05-03,BJ,Benin,AFRO,0,90,0,2
2020-05-04,BJ,Benin,AFRO,6,96,0,2
2020-05-05,BJ,Benin,AFRO,1,97,0,2
2020-05-06,BJ,Benin,AFRO,0,97,0,2
2020-05-07,BJ,Benin,AFRO,0,97,0,2
2020-05-08,BJ,Benin,AFRO,0,97,0,2
2020-05-09,BJ,Benin,AFRO,0,97,0,2
2020-05-10,BJ,Benin,AFRO,14,111,0,2
2020-05-11,BJ,Benin,AFRO,0,111,0,2
2020-05-12,BJ,Benin,AFRO,0,111,0,2
2020-05-13,BJ,Benin,AFRO,8,119,0,2
2020-05-14,BJ,Benin,AFRO,0,119,0,2
2020-05-15,BJ,Benin,AFRO,12,131,0,2
2020-05-16,BJ,Benin,AFRO,0,131,0,2
2020-05-17,BJ,Benin,AFRO,0,131,0,2
2020-05-18,BJ,Benin,AFRO,0,131,0,2
2020-05-19,BJ,Benin,AFRO,1,132,0,2
2020-05-20,BJ,Benin,AFRO,0,132,0,2
2020-05-21,BJ,Benin,AFRO,5,137,1,3
2020-05-22,BJ,Benin,AFRO,0,137,0,3
2020-05-23,BJ,Benin,AFRO,0,137,0,3
2020-05-24,BJ,Benin,AFRO,0,137,0,3
2020-05-25,BJ,Benin,AFRO,65,202,0,3
2020-05-26,BJ,Benin,AFRO,6,208,0,3
2020-05-27,BJ,Benin,AFRO,8,216,0,3
2020-05-28,BJ,Benin,AFRO,0,216,0,3
2020-05-29,BJ,Benin,AFRO,8,224,0,3
2020-05-30,BJ,Benin,AFRO,8,232,0,3
2020-05-31,BJ,Benin,AFRO,7,239,0,3
2020-06-01,BJ,Benin,AFRO,4,243,0,3
2020-06-02,BJ,Benin,AFRO,1,244,0,3
2020-06-03,BJ,Benin,AFRO,0,244,0,3
2020-06-04,BJ,Benin,AFRO,17,261,0,3
2020-06-05,BJ,Benin,AFRO,0,261,1,4
2020-06-06,BJ,Benin,AFRO,0,261,0,4
2020-06-07,BJ,Benin,AFRO,7,268,0,4
2020-06-08,BJ,Benin,AFRO,37,305,0,4
2020-03-29,BM,Bermuda,AMRO,2,17,0,0
2020-03-30,BM,Bermuda,AMRO,5,22,0,0
2020-03-31,BM,Bermuda,AMRO,0,22,0,0
2020-04-01,BM,Bermuda,AMRO,5,27,0,0
2020-04-02,BM,Bermuda,AMRO,5,32,0,0
2020-04-03,BM,Bermuda,AMRO,0,32,0,0
2020-04-04,BM,Bermuda,AMRO,3,35,0,0
2020-04-05,BM,Bermuda,AMRO,0,35,0,0
2020-04-06,BM,Bermuda,AMRO,2,37,0,0
2020-04-07,BM,Bermuda,AMRO,0,37,0,0
2020-04-08,BM,Bermuda,AMRO,2,39,2,2
2020-04-09,BM,Bermuda,AMRO,0,39,0,2
2020-04-10,BM,Bermuda,AMRO,0,39,1,3
2020-04-11,BM,Bermuda,AMRO,9,48,1,4
2020-04-12,BM,Bermuda,AMRO,0,48,0,4
2020-04-13,BM,Bermuda,AMRO,2,50,0,4
2020-04-14,BM,Bermuda,AMRO,7,57,0,4
2020-04-15,BM,Bermuda,AMRO,0,57,1,5
2020-04-16,BM,Bermuda,AMRO,0,57,0,5
2020-04-17,BM,Bermuda,AMRO,24,81,0,5
2020-04-18,BM,Bermuda,AMRO,2,83,0,5
2020-04-19,BM,Bermuda,AMRO,0,83,0,5
2020-04-20,BM,Bermuda,AMRO,3,86,0,5
2020-04-21,BM,Bermuda,AMRO,0,86,0,5
2020-04-22,BM,Bermuda,AMRO,0,86,0,5
2020-04-23,BM,Bermuda,AMRO,12,98,0,5
2020-04-24,BM,Bermuda,AMRO,1,99,0,5
2020-04-25,BM,Bermuda,AMRO,0,99,0,5
2020-04-26,BM,Bermuda,AMRO,0,99,0,5
2020-04-27,BM,Bermuda,AMRO,10,109,0,5
2020-04-28,BM,Bermuda,AMRO,0,109,1,6
2020-04-29,BM,Bermuda,AMRO,1,110,0,6
2020-04-30,BM,Bermuda,AMRO,1,111,0,6
2020-05-01,BM,Bermuda,AMRO,0,111,0,6
2020-05-02,BM,Bermuda,AMRO,3,114,0,6
2020-05-03,BM,Bermuda,AMRO,0,114,0,6
2020-05-04,BM,Bermuda,AMRO,1,115,1,7
2020-05-05,BM,Bermuda,AMRO,0,115,0,7
2020-05-06,BM,Bermuda,AMRO,0,115,0,7
2020-05-07,BM,Bermuda,AMRO,0,115,0,7
2020-05-08,BM,Bermuda,AMRO,3,118,0,7
2020-05-09,BM,Bermuda,AMRO,0,118,0,7
2020-05-10,BM,Bermuda,AMRO,0,118,0,7
2020-05-11,BM,Bermuda,AMRO,0,118,0,7
2020-05-12,BM,Bermuda,AMRO,0,118,0,7
2020-05-13,BM,Bermuda,AMRO,1,119,1,8
2020-05-14,BM,Bermuda,AMRO,2,121,0,8
2020-05-15,BM,Bermuda,AMRO,0,121,0,8
2020-05-16,BM,Bermuda,AMRO,1,122,1,9
2020-05-17,BM,Bermuda,AMRO,1,123,0,9
2020-05-18,BM,Bermuda,AMRO,0,123,0,9
2020-05-19,BM,Bermuda,AMRO,0,123,0,9
2020-05-20,BM,Bermuda,AMRO,2,125,0,9
2020-05-21,BM,Bermuda,AMRO,0,125,0,9
2020-05-22,BM,Bermuda,AMRO,0,125,0,9
2020-05-23,BM,Bermuda,AMRO,0,125,0,9
2020-05-24,BM,Bermuda,AMRO,3,128,0,9
2020-05-25,BM,Bermuda,AMRO,5,133,0,9
2020-05-26,BM,Bermuda,AMRO,0,133,0,9
2020-05-27,BM,Bermuda,AMRO,0,133,0,9
2020-05-28,BM,Bermuda,AMRO,6,139,0,9
2020-05-29,BM,Bermuda,AMRO,0,139,0,9
2020-05-30,BM,Bermuda,AMRO,1,140,0,9
2020-05-31,BM,Bermuda,AMRO,0,140,0,9
2020-06-01,BM,Bermuda,AMRO,0,140,0,9
2020-06-02,BM,Bermuda,AMRO,0,140,0,9
2020-06-03,BM,Bermuda,AMRO,1,141,0,9
2020-06-04,BM,Bermuda,AMRO,0,141,0,9
2020-06-05,BM,Bermuda,AMRO,0,141,0,9
2020-06-06,BM,Bermuda,AMRO,0,141,0,9
2020-06-07,BM,Bermuda,AMRO,0,141,0,9
2020-06-08,BM,Bermuda,AMRO,0,141,0,9
2020-03-29,BT,Bhutan,SEARO,0,3,0,0
2020-03-30,BT,Bhutan,SEARO,1,4,0,0
2020-03-31,BT,Bhutan,SEARO,0,4,0,0
2020-04-01,BT,Bhutan,SEARO,0,4,0,0
2020-04-02,BT,Bhutan,SEARO,1,5,0,0
2020-04-03,BT,Bhutan,SEARO,0,5,0,0
2020-04-04,BT,Bhutan,SEARO,0,5,0,0
2020-04-05,BT,Bhutan,SEARO,0,5,0,0
2020-04-06,BT,Bhutan,SEARO,0,5,0,0
2020-04-07,BT,Bhutan,SEARO,0,5,0,0
2020-04-08,BT,Bhutan,SEARO,0,5,0,0
2020-04-09,BT,Bhutan,SEARO,0,5,0,0
2020-04-10,BT,Bhutan,SEARO,0,5,0,0
2020-04-11,BT,Bhutan,SEARO,0,5,0,0
2020-04-12,BT,Bhutan,SEARO,0,5,0,0
2020-04-13,BT,Bhutan,SEARO,0,5,0,0
2020-04-14,BT,Bhutan,SEARO,0,5,0,0
2020-04-15,BT,Bhutan,SEARO,0,5,0,0
2020-04-16,BT,Bhutan,SEARO,0,5,0,0
2020-04-17,BT,Bhutan,SEARO,0,5,0,0
2020-04-18,BT,Bhutan,SEARO,0,5,0,0
2020-04-19,BT,Bhutan,SEARO,0,5,0,0
2020-04-20,BT,Bhutan,SEARO,0,5,0,0
2020-04-21,BT,Bhutan,SEARO,1,6,0,0
2020-04-22,BT,Bhutan,SEARO,0,6,0,0
2020-04-23,BT,Bhutan,SEARO,1,7,0,0
2020-04-24,BT,Bhutan,SEARO,0,7,0,0
2020-04-25,BT,Bhutan,SEARO,0,7,0,0
2020-04-26,BT,Bhutan,SEARO,0,7,0,0
2020-04-27,BT,Bhutan,SEARO,0,7,0,0
2020-04-28,BT,Bhutan,SEARO,0,7,0,0
2020-04-29,BT,Bhutan,SEARO,0,7,0,0
2020-04-30,BT,Bhutan,SEARO,0,7,0,0
2020-05-01,BT,Bhutan,SEARO,0,7,0,0
2020-05-02,BT,Bhutan,SEARO,0,7,0,0
2020-05-03,BT,Bhutan,SEARO,0,7,0,0
2020-05-04,BT,Bhutan,SEARO,0,7,0,0
2020-05-05,BT,Bhutan,SEARO,0,7,0,0
2020-05-06,BT,Bhutan,SEARO,0,7,0,0
2020-05-07,BT,Bhutan,SEARO,0,7,0,0
2020-05-08,BT,Bhutan,SEARO,0,7,0,0
2020-05-09,BT,Bhutan,SEARO,0,7,0,0
2020-05-10,BT,Bhutan,SEARO,0,7,0,0
2020-05-11,BT,Bhutan,SEARO,2,9,0,0
2020-05-12,BT,Bhutan,SEARO,2,11,0,0
2020-05-13,BT,Bhutan,SEARO,4,15,0,0
2020-05-14,BT,Bhutan,SEARO,5,20,0,0
2020-05-15,BT,Bhutan,SEARO,1,21,0,0
2020-05-16,BT,Bhutan,SEARO,0,21,0,0
2020-05-17,BT,Bhutan,SEARO,0,21,0,0
2020-05-18,BT,Bhutan,SEARO,0,21,0,0
2020-05-19,BT,Bhutan,SEARO,0,21,0,0
2020-05-20,BT,Bhutan,SEARO,0,21,0,0
2020-05-21,BT,Bhutan,SEARO,3,24,0,0
2020-05-22,BT,Bhutan,SEARO,0,24,0,0
2020-05-23,BT,Bhutan,SEARO,3,27,0,0
2020-05-24,BT,Bhutan,SEARO,0,27,0,0
2020-05-25,BT,Bhutan,SEARO,0,27,0,0
2020-05-26,BT,Bhutan,SEARO,0,27,0,0
2020-05-27,BT,Bhutan,SEARO,1,28,0,0
2020-05-28,BT,Bhutan,SEARO,3,31,0,0
2020-05-29,BT,Bhutan,SEARO,2,33,0,0
2020-05-30,BT,Bhutan,SEARO,10,43,0,0
2020-05-31,BT,Bhutan,SEARO,0,43,0,0
2020-06-01,BT,Bhutan,SEARO,4,47,0,0
2020-06-02,BT,Bhutan,SEARO,0,47,0,0
2020-06-03,BT,Bhutan,SEARO,0,47,0,0
2020-06-04,BT,Bhutan,SEARO,1,48,0,0
2020-06-05,BT,Bhutan,SEARO,0,48,0,0
2020-06-06,BT,Bhutan,SEARO,0,48,0,0
2020-06-07,BT,Bhutan,SEARO,11,59,0,0
2020-06-08,BT,Bhutan,SEARO,0,59,0,0
2020-03-29,BO,Bolivia (Plurinational State of),AMRO,29,90,0,0
2020-03-30,BO,Bolivia (Plurinational State of),AMRO,0,90,0,0
2020-03-31,BO,Bolivia (Plurinational State of),AMRO,7,97,5,5
2020-04-01,BO,Bolivia (Plurinational State of),AMRO,10,107,1,6
2020-04-02,BO,Bolivia (Plurinational State of),AMRO,8,115,1,7
2020-04-03,BO,Bolivia (Plurinational State of),AMRO,8,123,1,8
2020-04-04,BO,Bolivia (Plurinational State of),AMRO,9,132,1,9
2020-04-05,BO,Bolivia (Plurinational State of),AMRO,7,139,1,10
2020-04-06,BO,Bolivia (Plurinational State of),AMRO,18,157,0,10
2020-04-07,BO,Bolivia (Plurinational State of),AMRO,26,183,1,11
2020-04-08,BO,Bolivia (Plurinational State of),AMRO,11,194,3,14
2020-04-09,BO,Bolivia (Plurinational State of),AMRO,16,210,1,15
2020-04-10,BO,Bolivia (Plurinational State of),AMRO,54,264,3,18
2020-04-11,BO,Bolivia (Plurinational State of),AMRO,4,268,1,19
2020-04-12,BO,Bolivia (Plurinational State of),AMRO,7,275,1,20
2020-04-13,BO,Bolivia (Plurinational State of),AMRO,25,300,4,24
2020-04-14,BO,Bolivia (Plurinational State of),AMRO,30,330,3,27
2020-04-15,BO,Bolivia (Plurinational State of),AMRO,24,354,1,28
2020-04-16,BO,Bolivia (Plurinational State of),AMRO,43,397,0,28
2020-04-17,BO,Bolivia (Plurinational State of),AMRO,44,441,1,29
2020-04-18,BO,Bolivia (Plurinational State of),AMRO,24,465,2,31
2020-04-19,BO,Bolivia (Plurinational State of),AMRO,28,493,0,31
2020-04-20,BO,Bolivia (Plurinational State of),AMRO,27,520,1,32
2020-04-21,BO,Bolivia (Plurinational State of),AMRO,44,564,1,33
2020-04-22,BO,Bolivia (Plurinational State of),AMRO,34,598,1,34
2020-04-23,BO,Bolivia (Plurinational State of),AMRO,11,609,3,37
2020-04-24,BO,Bolivia (Plurinational State of),AMRO,63,672,3,40
2020-04-25,BO,Bolivia (Plurinational State of),AMRO,31,703,3,43
2020-04-26,BO,Bolivia (Plurinational State of),AMRO,104,807,1,44
2020-04-27,BO,Bolivia (Plurinational State of),AMRO,59,866,2,46
2020-04-28,BO,Bolivia (Plurinational State of),AMRO,84,950,4,50
2020-04-29,BO,Bolivia (Plurinational State of),AMRO,64,1014,3,53
2020-04-30,BO,Bolivia (Plurinational State of),AMRO,39,1053,2,55
2020-05-01,BO,Bolivia (Plurinational State of),AMRO,57,1110,4,59
2020-05-02,BO,Bolivia (Plurinational State of),AMRO,57,1167,3,62
2020-05-03,BO,Bolivia (Plurinational State of),AMRO,62,1229,4,66
2020-05-04,BO,Bolivia (Plurinational State of),AMRO,241,1470,5,71
2020-05-05,BO,Bolivia (Plurinational State of),AMRO,124,1594,5,76
2020-05-06,BO,Bolivia (Plurinational State of),AMRO,87,1681,6,82
2020-05-07,BO,Bolivia (Plurinational State of),AMRO,121,1802,4,86
2020-05-08,BO,Bolivia (Plurinational State of),AMRO,84,1886,5,91
2020-05-09,BO,Bolivia (Plurinational State of),AMRO,195,2081,11,102
2020-05-10,BO,Bolivia (Plurinational State of),AMRO,185,2266,4,106
2020-05-11,BO,Bolivia (Plurinational State of),AMRO,171,2437,8,114
2020-05-12,BO,Bolivia (Plurinational State of),AMRO,119,2556,4,118
2020-05-13,BO,Bolivia (Plurinational State of),AMRO,275,2831,4,122
2020-05-14,BO,Bolivia (Plurinational State of),AMRO,133,2964,6,128
2020-05-15,BO,Bolivia (Plurinational State of),AMRO,184,3148,14,142
2020-05-16,BO,Bolivia (Plurinational State of),AMRO,224,3372,10,152
2020-05-17,BO,Bolivia (Plurinational State of),AMRO,205,3577,12,164
2020-05-18,BO,Bolivia (Plurinational State of),AMRO,249,3826,1,165
2020-05-19,BO,Bolivia (Plurinational State of),AMRO,262,4088,4,169
2020-05-20,BO,Bolivia (Plurinational State of),AMRO,175,4263,5,174
2020-05-21,BO,Bolivia (Plurinational State of),AMRO,218,4481,15,189
2020-05-22,BO,Bolivia (Plurinational State of),AMRO,438,4919,10,199
2020-05-23,BO,Bolivia (Plurinational State of),AMRO,268,5187,16,215
2020-05-24,BO,Bolivia (Plurinational State of),AMRO,392,5579,15,230
2020-05-25,BO,Bolivia (Plurinational State of),AMRO,336,5915,10,240
2020-05-26,BO,Bolivia (Plurinational State of),AMRO,348,6263,10,250
2020-05-27,BO,Bolivia (Plurinational State of),AMRO,397,6660,11,261
2020-05-28,BO,Bolivia (Plurinational State of),AMRO,476,7136,13,274
2020-05-29,BO,Bolivia (Plurinational State of),AMRO,632,7768,6,280
2020-05-30,BO,Bolivia (Plurinational State of),AMRO,619,8387,13,293
2020-05-31,BO,Bolivia (Plurinational State of),AMRO,344,8731,7,300
2020-06-01,BO,Bolivia (Plurinational State of),AMRO,861,9592,10,310
2020-06-02,BO,Bolivia (Plurinational State of),AMRO,390,9982,3,313
2020-06-03,BO,Bolivia (Plurinational State of),AMRO,549,10531,30,343
2020-06-04,BO,Bolivia (Plurinational State of),AMRO,460,10991,33,376
2020-06-05,BO,Bolivia (Plurinational State of),AMRO,647,11638,24,400
2020-06-06,BO,Bolivia (Plurinational State of),AMRO,607,12245,15,415
2020-06-07,BO,Bolivia (Plurinational State of),AMRO,483,12728,12,427
2020-06-08,BO,Bolivia (Plurinational State of),AMRO,630,13358,27,454
2020-03-29,XA,Bonaire,AMRO,0,0,0,0
2020-03-30,XA,Bonaire,AMRO,0,0,0,0
2020-03-31,XA,Bonaire,AMRO,0,0,0,0
2020-04-01,XA,Bonaire,AMRO,0,0,0,0
2020-04-02,XA,Bonaire,AMRO,0,0,0,0
2020-04-03,XA,Bonaire,AMRO,0,0,0,0
2020-04-04,XA,Bonaire,AMRO,0,0,0,0
2020-04-05,XA,Bonaire,AMRO,0,0,0,0
2020-04-06,XA,Bonaire,AMRO,0,0,0,0
2020-04-07,XA,Bonaire,AMRO,0,0,0,0
2020-04-08,XA,Bonaire,AMRO,0,0,0,0
2020-04-09,XA,Bonaire,AMRO,0,0,0,0
2020-04-10,XA,Bonaire,AMRO,0,0,0,0
2020-04-11,XA,Bonaire,AMRO,0,0,0,0
2020-04-12,XA,Bonaire,AMRO,0,0,0,0
2020-04-13,XA,Bonaire,AMRO,0,0,0,0
2020-04-14,XA,Bonaire,AMRO,0,0,0,0
2020-04-15,XA,Bonaire,AMRO,0,0,0,0
2020-04-16,XA,Bonaire,AMRO,1,1,0,0
2020-04-17,XA,Bonaire,AMRO,0,1,0,0
2020-04-18,XA,Bonaire,AMRO,0,1,0,0
2020-04-19,XA,Bonaire,AMRO,0,1,0,0
2020-04-20,XA,Bonaire,AMRO,0,1,0,0
2020-04-21,XA,Bonaire,AMRO,0,1,0,0
2020-04-22,XA,Bonaire,AMRO,0,1,0,0
2020-04-23,XA,Bonaire,AMRO,0,1,0,0
2020-04-24,XA,Bonaire,AMRO,0,1,0,0
2020-04-25,XA,Bonaire,AMRO,0,1,0,0
2020-04-26,XA,Bonaire,AMRO,0,1,0,0
2020-04-27,XA,Bonaire,AMRO,0,1,0,0
2020-04-28,XA,Bonaire,AMRO,0,1,0,0
2020-04-29,XA,Bonaire,AMRO,1,2,0,0
2020-04-30,XA,Bonaire,AMRO,0,2,0,0
2020-05-01,XA,Bonaire,AMRO,0,2,0,0
2020-05-02,XA,Bonaire,AMRO,0,2,0,0
2020-05-03,XA,Bonaire,AMRO,0,2,0,0
2020-05-04,XA,Bonaire,AMRO,0,2,0,0
2020-05-05,XA,Bonaire,AMRO,0,2,0,0
2020-05-06,XA,Bonaire,AMRO,0,2,0,0
2020-05-07,XA,Bonaire,AMRO,0,2,0,0
2020-05-08,XA,Bonaire,AMRO,0,2,0,0
2020-05-09,XA,Bonaire,AMRO,0,2,0,0
2020-05-10,XA,Bonaire,AMRO,0,2,0,0
2020-05-11,XA,Bonaire,AMRO,0,2,0,0
2020-05-12,XA,Bonaire,AMRO,0,2,0,0
2020-05-13,XA,Bonaire,AMRO,0,2,0,0
2020-05-14,XA,Bonaire,AMRO,0,2,0,0
2020-05-15,XA,Bonaire,AMRO,0,2,0,0
2020-05-16,XA,Bonaire,AMRO,0,2,0,0
2020-05-17,XA,Bonaire,AMRO,0,2,0,0
2020-05-18,XA,Bonaire,AMRO,0,2,0,0
2020-05-19,XA,Bonaire,AMRO,0,2,0,0
2020-05-20,XA,Bonaire,AMRO,0,2,0,0
2020-05-21,XA,Bonaire,AMRO,0,2,0,0
2020-05-22,XA,Bonaire,AMRO,0,2,0,0
2020-05-23,XA,Bonaire,AMRO,0,2,0,0
2020-05-24,XA,Bonaire,AMRO,0,2,0,0
2020-05-25,XA,Bonaire,AMRO,0,2,0,0
2020-05-26,XA,Bonaire,AMRO,0,2,0,0
2020-05-27,XA,Bonaire,AMRO,0,2,0,0
2020-05-28,XA,Bonaire,AMRO,0,2,0,0
2020-05-29,XA,Bonaire,AMRO,0,2,0,0
2020-05-30,XA,Bonaire,AMRO,0,2,0,0
2020-05-31,XA,Bonaire,AMRO,0,2,0,0
2020-06-01,XA,Bonaire,AMRO,0,2,0,0
2020-06-02,XA,Bonaire,AMRO,0,2,0,0
2020-06-03,XA,Bonaire,AMRO,0,2,0,0
2020-06-04,XA,Bonaire,AMRO,0,2,0,0
2020-06-05,XA,Bonaire,AMRO,0,2,0,0
2020-06-06,XA,Bonaire,AMRO,0,2,0,0
2020-06-07,XA,Bonaire,AMRO,0,2,0,0
2020-06-08,XA,Bonaire,AMRO,0,2,0,0
2020-03-29,BA,Bosnia and Herzegovina,EURO,56,318,0,6
2020-03-30,BA,Bosnia and Herzegovina,EURO,34,352,3,9
2020-03-31,BA,Bosnia and Herzegovina,EURO,54,406,3,12
2020-04-01,BA,Bosnia and Herzegovina,EURO,51,457,1,13
2020-04-02,BA,Bosnia and Herzegovina,EURO,0,457,0,13
2020-04-03,BA,Bosnia and Herzegovina,EURO,56,513,2,15
2020-04-04,BA,Bosnia and Herzegovina,EURO,54,567,3,18
2020-04-05,BA,Bosnia and Herzegovina,EURO,52,619,3,21
2020-04-06,BA,Bosnia and Herzegovina,EURO,29,648,0,21
2020-04-07,BA,Bosnia and Herzegovina,EURO,46,694,8,29
2020-04-08,BA,Bosnia and Herzegovina,EURO,84,778,1,30
2020-04-09,BA,Bosnia and Herzegovina,EURO,25,803,4,34
2020-04-10,BA,Bosnia and Herzegovina,EURO,54,857,1,35
2020-04-11,BA,Bosnia and Herzegovina,EURO,42,899,1,36
2020-04-12,BA,Bosnia and Herzegovina,EURO,36,935,1,37
2020-04-13,BA,Bosnia and Herzegovina,EURO,65,1000,1,38
2020-04-14,BA,Bosnia and Herzegovina,EURO,30,1030,1,39
2020-04-15,BA,Bosnia and Herzegovina,EURO,53,1083,1,40
2020-04-16,BA,Bosnia and Herzegovina,EURO,27,1110,1,41
2020-04-17,BA,Bosnia and Herzegovina,EURO,57,1167,2,43
2020-04-18,BA,Bosnia and Herzegovina,EURO,32,1199,3,46
2020-04-19,BA,Bosnia and Herzegovina,EURO,69,1268,1,47
2020-04-20,BA,Bosnia and Herzegovina,EURO,17,1285,1,48
2020-04-21,BA,Bosnia and Herzegovina,EURO,24,1309,1,49
2020-04-22,BA,Bosnia and Herzegovina,EURO,33,1342,2,51
2020-04-23,BA,Bosnia and Herzegovina,EURO,26,1368,2,53
2020-04-24,BA,Bosnia and Herzegovina,EURO,45,1413,1,54
2020-04-25,BA,Bosnia and Herzegovina,EURO,8,1421,1,55
2020-04-26,BA,Bosnia and Herzegovina,EURO,65,1486,2,57
2020-04-27,BA,Bosnia and Herzegovina,EURO,30,1516,2,59
2020-04-28,BA,Bosnia and Herzegovina,EURO,49,1565,1,60
2020-04-29,BA,Bosnia and Herzegovina,EURO,20,1585,3,63
2020-04-30,BA,Bosnia and Herzegovina,EURO,92,1677,2,65
2020-05-01,BA,Bosnia and Herzegovina,EURO,80,1757,4,69
2020-05-02,BA,Bosnia and Herzegovina,EURO,24,1781,1,70
2020-05-03,BA,Bosnia and Herzegovina,EURO,58,1839,2,72
2020-05-04,BA,Bosnia and Herzegovina,EURO,18,1857,5,77
2020-05-05,BA,Bosnia and Herzegovina,EURO,69,1926,1,78
2020-05-06,BA,Bosnia and Herzegovina,EURO,20,1946,1,79
2020-05-07,BA,Bosnia and Herzegovina,EURO,41,1987,7,86
2020-05-08,BA,Bosnia and Herzegovina,EURO,40,2027,4,90
2020-05-09,BA,Bosnia and Herzegovina,EURO,43,2070,8,98
2020-05-10,BA,Bosnia and Herzegovina,EURO,20,2090,4,102
2020-05-11,BA,Bosnia and Herzegovina,EURO,27,2117,5,107
2020-05-12,BA,Bosnia and Herzegovina,EURO,24,2141,6,113
2020-05-13,BA,Bosnia and Herzegovina,EURO,17,2158,4,117
2020-05-14,BA,Bosnia and Herzegovina,EURO,23,2181,3,120
2020-05-15,BA,Bosnia and Herzegovina,EURO,37,2218,2,122
2020-05-16,BA,Bosnia and Herzegovina,EURO,18,2236,6,128
2020-05-17,BA,Bosnia and Herzegovina,EURO,31,2267,1,129
2020-05-18,BA,Bosnia and Herzegovina,EURO,23,2290,4,133
2020-05-19,BA,Bosnia and Herzegovina,EURO,14,2304,0,133
2020-05-20,BA,Bosnia and Herzegovina,EURO,17,2321,1,134
2020-05-21,BA,Bosnia and Herzegovina,EURO,17,2338,2,136
2020-05-22,BA,Bosnia and Herzegovina,EURO,12,2350,4,140
2020-05-23,BA,Bosnia and Herzegovina,EURO,22,2372,1,141
2020-05-24,BA,Bosnia and Herzegovina,EURO,19,2391,0,141
2020-05-25,BA,Bosnia and Herzegovina,EURO,10,2401,3,144
2020-05-26,BA,Bosnia and Herzegovina,EURO,5,2406,2,146
2020-05-27,BA,Bosnia and Herzegovina,EURO,10,2416,3,149
2020-05-28,BA,Bosnia and Herzegovina,EURO,19,2435,2,151
2020-05-29,BA,Bosnia and Herzegovina,EURO,27,2462,2,153
2020-05-30,BA,Bosnia and Herzegovina,EURO,23,2485,0,153
2020-05-31,BA,Bosnia and Herzegovina,EURO,9,2494,0,153
2020-06-01,BA,Bosnia and Herzegovina,EURO,16,2510,0,153
2020-06-02,BA,Bosnia and Herzegovina,EURO,14,2524,1,154
2020-06-03,BA,Bosnia and Herzegovina,EURO,11,2535,3,157
2020-06-04,BA,Bosnia and Herzegovina,EURO,16,2551,0,157
2020-06-05,BA,Bosnia and Herzegovina,EURO,43,2594,2,159
2020-06-06,BA,Bosnia and Herzegovina,EURO,12,2606,0,159
2020-06-07,BA,Bosnia and Herzegovina,EURO,40,2646,0,159
2020-06-08,BA,Bosnia and Herzegovina,EURO,28,2674,1,160
2020-03-29,BW,Botswana,AFRO,0,3,0,1
2020-03-30,BW,Botswana,AFRO,0,3,0,1
2020-03-31,BW,Botswana,AFRO,0,3,0,1
2020-04-01,BW,Botswana,AFRO,1,4,0,1
2020-04-02,BW,Botswana,AFRO,0,4,0,1
2020-04-03,BW,Botswana,AFRO,0,4,0,1
2020-04-04,BW,Botswana,AFRO,0,4,0,1
2020-04-05,BW,Botswana,AFRO,0,4,0,1
2020-04-06,BW,Botswana,AFRO,2,6,0,1
2020-04-07,BW,Botswana,AFRO,0,6,0,1
2020-04-08,BW,Botswana,AFRO,0,6,0,1
2020-04-09,BW,Botswana,AFRO,0,6,0,1
2020-04-10,BW,Botswana,AFRO,7,13,0,1
2020-04-11,BW,Botswana,AFRO,0,13,0,1
2020-04-12,BW,Botswana,AFRO,0,13,0,1
2020-04-13,BW,Botswana,AFRO,0,13,0,1
2020-04-14,BW,Botswana,AFRO,0,13,0,1
2020-04-15,BW,Botswana,AFRO,0,13,0,1
2020-04-16,BW,Botswana,AFRO,0,13,0,1
2020-04-17,BW,Botswana,AFRO,2,15,0,1
2020-04-18,BW,Botswana,AFRO,0,15,0,1
2020-04-19,BW,Botswana,AFRO,0,15,0,1
2020-04-20,BW,Botswana,AFRO,5,20,0,1
2020-04-21,BW,Botswana,AFRO,0,20,0,1
2020-04-22,BW,Botswana,AFRO,0,20,0,1
2020-04-23,BW,Botswana,AFRO,2,22,0,1
2020-04-24,BW,Botswana,AFRO,0,22,0,1
2020-04-25,BW,Botswana,AFRO,0,22,0,1
2020-04-26,BW,Botswana,AFRO,0,22,0,1
2020-04-27,BW,Botswana,AFRO,0,22,0,1
2020-04-28,BW,Botswana,AFRO,0,22,0,1
2020-04-29,BW,Botswana,AFRO,1,23,0,1
2020-04-30,BW,Botswana,AFRO,0,23,0,1
2020-05-01,BW,Botswana,AFRO,0,23,0,1
2020-05-02,BW,Botswana,AFRO,0,23,0,1
2020-05-03,BW,Botswana,AFRO,0,23,0,1
2020-05-04,BW,Botswana,AFRO,0,23,0,1
2020-05-05,BW,Botswana,AFRO,0,23,0,1
2020-05-06,BW,Botswana,AFRO,0,23,0,1
2020-05-07,BW,Botswana,AFRO,0,23,0,1
2020-05-08,BW,Botswana,AFRO,0,23,0,1
2020-05-09,BW,Botswana,AFRO,0,23,0,1
2020-05-10,BW,Botswana,AFRO,0,23,0,1
2020-05-11,BW,Botswana,AFRO,0,23,0,1
2020-05-12,BW,Botswana,AFRO,1,24,0,1
2020-05-13,BW,Botswana,AFRO,0,24,0,1
2020-05-14,BW,Botswana,AFRO,0,24,0,1
2020-05-15,BW,Botswana,AFRO,0,24,0,1
2020-05-16,BW,Botswana,AFRO,0,24,0,1
2020-05-17,BW,Botswana,AFRO,1,25,0,1
2020-05-18,BW,Botswana,AFRO,0,25,0,1
2020-05-19,BW,Botswana,AFRO,0,25,0,1
2020-05-20,BW,Botswana,AFRO,0,25,0,1
2020-05-21,BW,Botswana,AFRO,4,29,0,1
2020-05-22,BW,Botswana,AFRO,0,29,0,1
2020-05-23,BW,Botswana,AFRO,1,30,0,1
2020-05-24,BW,Botswana,AFRO,2,32,0,1
2020-05-25,BW,Botswana,AFRO,3,35,0,1
2020-05-26,BW,Botswana,AFRO,0,35,0,1
2020-05-27,BW,Botswana,AFRO,0,35,0,1
2020-05-28,BW,Botswana,AFRO,0,35,0,1
2020-05-29,BW,Botswana,AFRO,0,35,0,1
2020-05-30,BW,Botswana,AFRO,0,35,0,1
2020-05-31,BW,Botswana,AFRO,0,35,0,1
2020-06-01,BW,Botswana,AFRO,3,38,0,1
2020-06-02,BW,Botswana,AFRO,0,38,0,1
2020-06-03,BW,Botswana,AFRO,2,40,0,1
2020-06-04,BW,Botswana,AFRO,0,40,0,1
2020-06-05,BW,Botswana,AFRO,0,40,0,1
2020-06-06,BW,Botswana,AFRO,0,40,0,1
2020-06-07,BW,Botswana,AFRO,0,40,0,1
2020-06-08,BW,Botswana,AFRO,0,40,0,1
2020-03-29,BR,Brazil,AMRO,502,3417,15,92
2020-03-30,BR,Brazil,AMRO,486,3903,22,114
2020-03-31,BR,Brazil,AMRO,353,4256,22,136
2020-04-01,BR,Brazil,AMRO,323,4579,23,159
2020-04-02,BR,Brazil,AMRO,1138,5717,42,201
2020-04-03,BR,Brazil,AMRO,1119,6836,40,241
2020-04-04,BR,Brazil,AMRO,1074,7910,58,299
2020-04-05,BR,Brazil,AMRO,1146,9056,60,359
2020-04-06,BR,Brazil,AMRO,1222,10278,73,432
2020-04-07,BR,Brazil,AMRO,852,11130,54,486
2020-04-08,BR,Brazil,AMRO,926,12056,67,553
2020-04-09,BR,Brazil,AMRO,1661,13717,114,667
2020-04-10,BR,Brazil,AMRO,2210,15927,133,800
2020-04-11,BR,Brazil,AMRO,1930,17857,141,941
2020-04-12,BR,Brazil,AMRO,1781,19638,115,1056
2020-04-13,BR,Brazil,AMRO,1089,20727,68,1124
2020-04-14,BR,Brazil,AMRO,1442,22169,99,1223
2020-04-15,BR,Brazil,AMRO,1261,23430,105,1328
2020-04-16,BR,Brazil,AMRO,1832,25262,204,1532
2020-04-17,BR,Brazil,AMRO,3058,28320,204,1736
2020-04-18,BR,Brazil,AMRO,2105,30425,188,1924
2020-04-19,BR,Brazil,AMRO,3257,33682,217,2141
2020-04-20,BR,Brazil,AMRO,2917,36599,206,2347
2020-04-21,BR,Brazil,AMRO,2055,38654,115,2462
2020-04-22,BR,Brazil,AMRO,1927,40581,113,2575
2020-04-23,BR,Brazil,AMRO,2498,43079,166,2741
2020-04-24,BR,Brazil,AMRO,2678,45757,165,2906
2020-04-25,BR,Brazil,AMRO,3735,49492,407,3313
2020-04-26,BR,Brazil,AMRO,3503,52995,357,3670
2020-04-27,BR,Brazil,AMRO,5514,58509,346,4016
2020-04-28,BR,Brazil,AMRO,3379,61888,189,4205
2020-04-29,BR,Brazil,AMRO,4613,66501,338,4543
2020-04-30,BR,Brazil,AMRO,5385,71886,474,5017
2020-05-01,BR,Brazil,AMRO,6276,78162,449,5466
2020-05-02,BR,Brazil,AMRO,7218,85380,435,5901
2020-05-03,BR,Brazil,AMRO,6209,91589,428,6329
2020-05-04,BR,Brazil,AMRO,4970,96559,421,6750
2020-05-05,BR,Brazil,AMRO,4588,101147,275,7025
2020-05-06,BR,Brazil,AMRO,6633,107780,296,7321
2020-05-07,BR,Brazil,AMRO,6935,114715,600,7921
2020-05-08,BR,Brazil,AMRO,10503,125218,615,8536
2020-05-09,BR,Brazil,AMRO,9888,135106,610,9146
2020-05-10,BR,Brazil,AMRO,10222,145328,751,9897
2020-05-11,BR,Brazil,AMRO,10611,155939,730,10627
2020-05-12,BR,Brazil,AMRO,6760,162699,496,11123
2020-05-13,BR,Brazil,AMRO,5632,168331,396,11519
2020-05-14,BR,Brazil,AMRO,9258,177589,881,12400
2020-05-15,BR,Brazil,AMRO,11385,188974,749,13149
2020-05-16,BR,Brazil,AMRO,13944,202918,844,13993
2020-05-17,BR,Brazil,AMRO,15305,218223,824,14817
2020-05-18,BR,Brazil,AMRO,14919,233142,816,15633
2020-05-19,BR,Brazil,AMRO,7938,241080,485,16118
2020-05-20,BR,Brazil,AMRO,13140,254220,674,16792
2020-05-21,BR,Brazil,AMRO,17408,271628,1179,17971
2020-05-22,BR,Brazil,AMRO,19951,291579,888,18859
2020-05-23,BR,Brazil,AMRO,18508,310087,1188,20047
2020-05-24,BR,Brazil,AMRO,20803,330890,1001,21048
2020-05-25,BR,Brazil,AMRO,16508,347398,965,22013
2020-05-26,BR,Brazil,AMRO,15813,363211,653,22666
2020-05-27,BR,Brazil,AMRO,11687,374898,807,23473
2020-05-28,BR,Brazil,AMRO,16324,391222,1039,24512
2020-05-29,BR,Brazil,AMRO,20599,411821,1086,25598
2020-05-30,BR,Brazil,AMRO,26417,438238,1156,26754
2020-05-31,BR,Brazil,AMRO,26928,465166,1124,27878
2020-06-01,BR,Brazil,AMRO,33274,498440,956,28834
2020-06-02,BR,Brazil,AMRO,16409,514849,480,29314
2020-06-03,BR,Brazil,AMRO,11598,526447,623,29937
2020-06-04,BR,Brazil,AMRO,28936,555383,1262,31199
2020-06-05,BR,Brazil,AMRO,28633,584016,1349,32548
2020-06-06,BR,Brazil,AMRO,30925,614941,1473,34021
2020-06-07,BR,Brazil,AMRO,30830,645771,1005,35026
2020-06-08,BR,Brazil,AMRO,27075,672846,904,35930
2020-03-29,VG,British Virgin Islands,AMRO,0,2,0,0
2020-03-30,VG,British Virgin Islands,AMRO,0,2,0,0
2020-03-31,VG,British Virgin Islands,AMRO,0,2,0,0
2020-04-01,VG,British Virgin Islands,AMRO,1,3,0,0
2020-04-02,VG,British Virgin Islands,AMRO,0,3,0,0
2020-04-03,VG,British Virgin Islands,AMRO,0,3,0,0
2020-04-04,VG,British Virgin Islands,AMRO,0,3,0,0
2020-04-05,VG,British Virgin Islands,AMRO,0,3,0,0
2020-04-06,VG,British Virgin Islands,AMRO,0,3,0,0
2020-04-07,VG,British Virgin Islands,AMRO,0,3,0,0
2020-04-08,VG,British Virgin Islands,AMRO,0,3,0,0
2020-04-09,VG,British Virgin Islands,AMRO,0,3,0,0
2020-04-10,VG,British Virgin Islands,AMRO,0,3,0,0
2020-04-11,VG,British Virgin Islands,AMRO,0,3,0,0
2020-04-12,VG,British Virgin Islands,AMRO,0,3,0,0
2020-04-13,VG,British Virgin Islands,AMRO,0,3,0,0
2020-04-14,VG,British Virgin Islands,AMRO,0,3,0,0
2020-04-15,VG,British Virgin Islands,AMRO,0,3,0,0
2020-04-16,VG,British Virgin Islands,AMRO,0,3,0,0
2020-04-17,VG,British Virgin Islands,AMRO,0,3,0,0
2020-04-18,VG,British Virgin Islands,AMRO,0,3,0,0
2020-04-19,VG,British Virgin Islands,AMRO,0,3,0,0
2020-04-20,VG,British Virgin Islands,AMRO,1,4,1,1
2020-04-21,VG,British Virgin Islands,AMRO,0,4,0,1
2020-04-22,VG,British Virgin Islands,AMRO,0,4,0,1
2020-04-23,VG,British Virgin Islands,AMRO,0,4,0,1
2020-04-24,VG,British Virgin Islands,AMRO,1,5,0,1
2020-04-25,VG,British Virgin Islands,AMRO,0,5,0,1
2020-04-26,VG,British Virgin Islands,AMRO,1,6,0,1
2020-04-27,VG,British Virgin Islands,AMRO,0,6,0,1
2020-04-28,VG,British Virgin Islands,AMRO,0,6,0,1
2020-04-29,VG,British Virgin Islands,AMRO,0,6,0,1
2020-04-30,VG,British Virgin Islands,AMRO,0,6,0,1
2020-05-01,VG,British Virgin Islands,AMRO,0,6,0,1
2020-05-02,VG,British Virgin Islands,AMRO,0,6,0,1
2020-05-03,VG,British Virgin Islands,AMRO,0,6,0,1
2020-05-04,VG,British Virgin Islands,AMRO,0,6,0,1
2020-05-05,VG,British Virgin Islands,AMRO,0,6,0,1
2020-05-06,VG,British Virgin Islands,AMRO,1,7,0,1
2020-05-07,VG,British Virgin Islands,AMRO,0,7,0,1
2020-05-08,VG,British Virgin Islands,AMRO,0,7,0,1
2020-05-09,VG,British Virgin Islands,AMRO,0,7,0,1
2020-05-10,VG,British Virgin Islands,AMRO,0,7,0,1
2020-05-11,VG,British Virgin Islands,AMRO,0,7,0,1
2020-05-12,VG,British Virgin Islands,AMRO,0,7,0,1
2020-05-13,VG,British Virgin Islands,AMRO,0,7,0,1
2020-05-14,VG,British Virgin Islands,AMRO,0,7,0,1
2020-05-15,VG,British Virgin Islands,AMRO,0,7,0,1
2020-05-16,VG,British Virgin Islands,AMRO,1,8,0,1
2020-05-17,VG,British Virgin Islands,AMRO,0,8,0,1
2020-05-18,VG,British Virgin Islands,AMRO,0,8,0,1
2020-05-19,VG,British Virgin Islands,AMRO,0,8,0,1
2020-05-20,VG,British Virgin Islands,AMRO,0,8,0,1
2020-05-21,VG,British Virgin Islands,AMRO,0,8,0,1
2020-05-22,VG,British Virgin Islands,AMRO,0,8,0,1
2020-05-23,VG,British Virgin Islands,AMRO,0,8,0,1
2020-05-24,VG,British Virgin Islands,AMRO,0,8,0,1
2020-05-25,VG,British Virgin Islands,AMRO,0,8,0,1
2020-05-26,VG,British Virgin Islands,AMRO,0,8,0,1
2020-05-27,VG,British Virgin Islands,AMRO,0,8,0,1
2020-05-28,VG,British Virgin Islands,AMRO,0,8,0,1
2020-05-29,VG,British Virgin Islands,AMRO,0,8,0,1
2020-05-30,VG,British Virgin Islands,AMRO,0,8,0,1
2020-05-31,VG,British Virgin Islands,AMRO,0,8,0,1
2020-06-01,VG,British Virgin Islands,AMRO,0,8,0,1
2020-06-02,VG,British Virgin Islands,AMRO,0,8,0,1
2020-06-03,VG,British Virgin Islands,AMRO,0,8,0,1
2020-06-04,VG,British Virgin Islands,AMRO,0,8,0,1
2020-06-05,VG,British Virgin Islands,AMRO,0,8,0,1
2020-06-06,VG,British Virgin Islands,AMRO,0,8,0,1
2020-06-07,VG,British Virgin Islands,AMRO,0,8,0,1
2020-06-08,VG,British Virgin Islands,AMRO,0,8,0,1
2020-03-29,BN,Brunei Darussalam,WPRO,5,120,1,1
2020-03-30,BN,Brunei Darussalam,WPRO,6,126,0,1
2020-03-31,BN,Brunei Darussalam,WPRO,1,127,0,1
2020-04-01,BN,Brunei Darussalam,WPRO,2,129,0,1
2020-04-02,BN,Brunei Darussalam,WPRO,2,131,0,1
2020-04-03,BN,Brunei Darussalam,WPRO,2,133,0,1
2020-04-04,BN,Brunei Darussalam,WPRO,1,134,0,1
2020-04-05,BN,Brunei Darussalam,WPRO,1,135,0,1
2020-04-06,BN,Brunei Darussalam,WPRO,0,135,0,1
2020-04-07,BN,Brunei Darussalam,WPRO,0,135,0,1
2020-04-08,BN,Brunei Darussalam,WPRO,0,135,0,1
2020-04-09,BN,Brunei Darussalam,WPRO,0,135,0,1
2020-04-10,BN,Brunei Darussalam,WPRO,0,135,0,1
2020-04-11,BN,Brunei Darussalam,WPRO,1,136,0,1
2020-04-12,BN,Brunei Darussalam,WPRO,0,136,0,1
2020-04-13,BN,Brunei Darussalam,WPRO,0,136,0,1
2020-04-14,BN,Brunei Darussalam,WPRO,0,136,0,1
2020-04-15,BN,Brunei Darussalam,WPRO,0,136,0,1
2020-04-16,BN,Brunei Darussalam,WPRO,0,136,0,1
2020-04-17,BN,Brunei Darussalam,WPRO,0,136,0,1
2020-04-18,BN,Brunei Darussalam,WPRO,0,136,0,1
2020-04-19,BN,Brunei Darussalam,WPRO,1,137,0,1
2020-04-20,BN,Brunei Darussalam,WPRO,1,138,0,1
2020-04-21,BN,Brunei Darussalam,WPRO,0,138,0,1
2020-04-22,BN,Brunei Darussalam,WPRO,0,138,0,1
2020-04-23,BN,Brunei Darussalam,WPRO,0,138,0,1
2020-04-24,BN,Brunei Darussalam,WPRO,0,138,0,1
2020-04-25,BN,Brunei Darussalam,WPRO,0,138,0,1
2020-04-26,BN,Brunei Darussalam,WPRO,0,138,0,1
2020-04-27,BN,Brunei Darussalam,WPRO,0,138,0,1
2020-04-28,BN,Brunei Darussalam,WPRO,0,138,0,1
2020-04-29,BN,Brunei Darussalam,WPRO,0,138,0,1
2020-04-30,BN,Brunei Darussalam,WPRO,0,138,0,1
2020-05-01,BN,Brunei Darussalam,WPRO,0,138,0,1
2020-05-02,BN,Brunei Darussalam,WPRO,0,138,0,1
2020-05-03,BN,Brunei Darussalam,WPRO,0,138,0,1
2020-05-04,BN,Brunei Darussalam,WPRO,0,138,0,1
2020-05-05,BN,Brunei Darussalam,WPRO,0,138,0,1
2020-05-06,BN,Brunei Darussalam,WPRO,0,138,0,1
2020-05-07,BN,Brunei Darussalam,WPRO,1,139,0,1
2020-05-08,BN,Brunei Darussalam,WPRO,2,141,0,1
2020-05-09,BN,Brunei Darussalam,WPRO,0,141,0,1
2020-05-10,BN,Brunei Darussalam,WPRO,0,141,0,1
2020-05-11,BN,Brunei Darussalam,WPRO,0,141,0,1
2020-05-12,BN,Brunei Darussalam,WPRO,0,141,0,1
2020-05-13,BN,Brunei Darussalam,WPRO,0,141,0,1
2020-05-14,BN,Brunei Darussalam,WPRO,0,141,0,1
2020-05-15,BN,Brunei Darussalam,WPRO,0,141,0,1
2020-05-16,BN,Brunei Darussalam,WPRO,0,141,0,1
2020-05-17,BN,Brunei Darussalam,WPRO,0,141,0,1
2020-05-18,BN,Brunei Darussalam,WPRO,0,141,0,1
2020-05-19,BN,Brunei Darussalam,WPRO,0,141,0,1
2020-05-20,BN,Brunei Darussalam,WPRO,0,141,0,1
2020-05-21,BN,Brunei Darussalam,WPRO,0,141,0,1
2020-05-22,BN,Brunei Darussalam,WPRO,0,141,0,1
2020-05-23,BN,Brunei Darussalam,WPRO,0,141,0,1
2020-05-24,BN,Brunei Darussalam,WPRO,0,141,0,1
2020-05-25,BN,Brunei Darussalam,WPRO,0,141,0,1
2020-05-26,BN,Brunei Darussalam,WPRO,0,141,0,1
2020-05-27,BN,Brunei Darussalam,WPRO,0,141,0,1
2020-05-28,BN,Brunei Darussalam,WPRO,0,141,1,2
2020-05-29,BN,Brunei Darussalam,WPRO,0,141,0,2
2020-05-30,BN,Brunei Darussalam,WPRO,0,141,0,2
2020-05-31,BN,Brunei Darussalam,WPRO,0,141,0,2
2020-06-01,BN,Brunei Darussalam,WPRO,0,141,0,2
2020-06-02,BN,Brunei Darussalam,WPRO,0,141,0,2
2020-06-03,BN,Brunei Darussalam,WPRO,0,141,0,2
2020-06-04,BN,Brunei Darussalam,WPRO,0,141,0,2
2020-06-05,BN,Brunei Darussalam,WPRO,0,141,0,2
2020-06-06,BN,Brunei Darussalam,WPRO,0,141,0,2
2020-06-07,BN,Brunei Darussalam,WPRO,0,141,0,2
2020-06-08,BN,Brunei Darussalam,WPRO,0,141,0,2
2020-03-29,BG,Bulgaria,EURO,38,331,4,7
2020-03-30,BG,Bulgaria,EURO,15,346,1,8
2020-03-31,BG,Bulgaria,EURO,13,359,0,8
2020-04-01,BG,Bulgaria,EURO,40,399,0,8
2020-04-02,BG,Bulgaria,EURO,23,422,2,10
2020-04-03,BG,Bulgaria,EURO,35,457,0,10
2020-04-04,BG,Bulgaria,EURO,28,485,4,14
2020-04-05,BG,Bulgaria,EURO,18,503,3,17
2020-04-06,BG,Bulgaria,EURO,28,531,3,20
2020-04-07,BG,Bulgaria,EURO,18,549,2,22
2020-04-08,BG,Bulgaria,EURO,28,577,1,23
2020-04-09,BG,Bulgaria,EURO,16,593,1,24
2020-04-10,BG,Bulgaria,EURO,31,624,0,24
2020-04-11,BG,Bulgaria,EURO,11,635,1,25
2020-04-12,BG,Bulgaria,EURO,26,661,3,28
2020-04-13,BG,Bulgaria,EURO,14,675,1,29
2020-04-14,BG,Bulgaria,EURO,10,685,3,32
2020-04-15,BG,Bulgaria,EURO,28,713,3,35
2020-04-16,BG,Bulgaria,EURO,34,747,1,36
2020-04-17,BG,Bulgaria,EURO,53,800,2,38
2020-04-18,BG,Bulgaria,EURO,46,846,3,41
2020-04-19,BG,Bulgaria,EURO,32,878,0,41
2020-04-20,BG,Bulgaria,EURO,37,915,2,43
2020-04-21,BG,Bulgaria,EURO,14,929,0,43
2020-04-22,BG,Bulgaria,EURO,46,975,2,45
2020-04-23,BG,Bulgaria,EURO,49,1024,4,49
2020-04-24,BG,Bulgaria,EURO,73,1097,3,52
2020-04-25,BG,Bulgaria,EURO,91,1188,2,54
2020-04-26,BG,Bulgaria,EURO,59,1247,1,55
2020-04-27,BG,Bulgaria,EURO,53,1300,1,56
2020-04-28,BG,Bulgaria,EURO,63,1363,2,58
2020-04-29,BG,Bulgaria,EURO,36,1399,0,58
2020-04-30,BG,Bulgaria,EURO,48,1447,6,64
2020-05-01,BG,Bulgaria,EURO,59,1506,2,66
2020-05-02,BG,Bulgaria,EURO,82,1588,3,69
2020-05-03,BG,Bulgaria,EURO,6,1594,3,72
2020-05-04,BG,Bulgaria,EURO,24,1618,1,73
2020-05-05,BG,Bulgaria,EURO,34,1652,5,78
2020-05-06,BG,Bulgaria,EURO,37,1689,0,78
2020-05-07,BG,Bulgaria,EURO,89,1778,6,84
2020-05-08,BG,Bulgaria,EURO,51,1829,0,84
2020-05-09,BG,Bulgaria,EURO,82,1911,4,88
2020-05-10,BG,Bulgaria,EURO,44,1955,2,90
2020-05-11,BG,Bulgaria,EURO,10,1965,1,91
2020-05-12,BG,Bulgaria,EURO,25,1990,2,93
2020-05-13,BG,Bulgaria,EURO,33,2023,2,95
2020-05-14,BG,Bulgaria,EURO,46,2069,1,96
2020-05-15,BG,Bulgaria,EURO,31,2100,3,99
2020-05-16,BG,Bulgaria,EURO,38,2138,3,102
2020-05-17,BG,Bulgaria,EURO,73,2211,6,108
2020-05-18,BG,Bulgaria,EURO,24,2235,2,110
2020-05-19,BG,Bulgaria,EURO,24,2259,2,112
2020-05-20,BG,Bulgaria,EURO,33,2292,4,116
2020-05-21,BG,Bulgaria,EURO,39,2331,4,120
2020-05-22,BG,Bulgaria,EURO,41,2372,5,125
2020-05-23,BG,Bulgaria,EURO,36,2408,5,130
2020-05-24,BG,Bulgaria,EURO,0,2408,0,130
2020-05-25,BG,Bulgaria,EURO,25,2433,4,134
2020-05-26,BG,Bulgaria,EURO,0,2433,0,134
2020-05-27,BG,Bulgaria,EURO,27,2460,3,137
2020-05-28,BG,Bulgaria,EURO,0,2460,0,137
2020-05-29,BG,Bulgaria,EURO,25,2485,3,140
2020-05-30,BG,Bulgaria,EURO,14,2499,3,143
2020-05-31,BG,Bulgaria,EURO,14,2513,4,147
2020-06-01,BG,Bulgaria,EURO,0,2513,0,147
2020-06-02,BG,Bulgaria,EURO,42,2555,4,151
2020-06-03,BG,Bulgaria,EURO,25,2580,5,156
2020-06-04,BG,Bulgaria,EURO,47,2627,3,159
2020-06-05,BG,Bulgaria,EURO,0,2627,0,159
2020-06-06,BG,Bulgaria,EURO,41,2668,1,160
2020-06-07,BG,Bulgaria,EURO,43,2711,0,160
2020-06-08,BG,Bulgaria,EURO,16,2727,0,160
2020-03-29,BF,Burkina Faso,AFRO,15,222,0,15
2020-03-30,BF,Burkina Faso,AFRO,24,246,0,15
2020-03-31,BF,Burkina Faso,AFRO,15,261,0,15
2020-04-01,BF,Burkina Faso,AFRO,0,261,2,17
2020-04-02,BF,Burkina Faso,AFRO,0,261,0,17
2020-04-03,BF,Burkina Faso,AFRO,0,261,0,17
2020-04-04,BF,Burkina Faso,AFRO,41,302,0,17
2020-04-05,BF,Burkina Faso,AFRO,62,364,0,17
2020-04-06,BF,Burkina Faso,AFRO,0,364,0,17
2020-04-07,BF,Burkina Faso,AFRO,0,364,1,18
2020-04-08,BF,Burkina Faso,AFRO,20,384,0,18
2020-04-09,BF,Burkina Faso,AFRO,0,384,0,18
2020-04-10,BF,Burkina Faso,AFRO,30,414,0,18
2020-04-11,BF,Burkina Faso,AFRO,70,484,0,18
2020-04-12,BF,Burkina Faso,AFRO,0,484,0,18
2020-04-13,BF,Burkina Faso,AFRO,31,515,10,28
2020-04-14,BF,Burkina Faso,AFRO,0,515,0,28
2020-04-15,BF,Burkina Faso,AFRO,13,528,0,28
2020-04-16,BF,Burkina Faso,AFRO,18,546,4,32
2020-04-17,BF,Burkina Faso,AFRO,1,547,0,32
2020-04-18,BF,Burkina Faso,AFRO,18,565,4,36
2020-04-19,BF,Burkina Faso,AFRO,11,576,0,36
2020-04-20,BF,Burkina Faso,AFRO,0,576,0,36
2020-04-21,BF,Burkina Faso,AFRO,5,581,2,38
2020-04-22,BF,Burkina Faso,AFRO,19,600,0,38
2020-04-23,BF,Burkina Faso,AFRO,0,600,0,38
2020-04-24,BF,Burkina Faso,AFRO,29,629,3,41
2020-04-25,BF,Burkina Faso,AFRO,0,629,0,41
2020-04-26,BF,Burkina Faso,AFRO,3,632,1,42
2020-04-27,BF,Burkina Faso,AFRO,0,632,0,42
2020-04-28,BF,Burkina Faso,AFRO,3,635,0,42
2020-04-29,BF,Burkina Faso,AFRO,6,641,1,43
2020-04-30,BF,Burkina Faso,AFRO,4,645,0,43
2020-05-01,BF,Burkina Faso,AFRO,4,649,1,44
2020-05-02,BF,Burkina Faso,AFRO,0,649,0,44
2020-05-03,BF,Burkina Faso,AFRO,3,652,1,45
2020-05-04,BF,Burkina Faso,AFRO,10,662,0,45
2020-05-05,BF,Burkina Faso,AFRO,10,672,1,46
2020-05-06,BF,Burkina Faso,AFRO,17,689,2,48
2020-05-07,BF,Burkina Faso,AFRO,40,729,0,48
2020-05-08,BF,Burkina Faso,AFRO,7,736,0,48
2020-05-09,BF,Burkina Faso,AFRO,8,744,0,48
2020-05-10,BF,Burkina Faso,AFRO,4,748,0,48
2020-05-11,BF,Burkina Faso,AFRO,3,751,1,49
2020-05-12,BF,Burkina Faso,AFRO,9,760,1,50
2020-05-13,BF,Burkina Faso,AFRO,6,766,1,51
2020-05-14,BF,Burkina Faso,AFRO,7,773,0,51
2020-05-15,BF,Burkina Faso,AFRO,0,773,0,51
2020-05-16,BF,Burkina Faso,AFRO,7,780,0,51
2020-05-17,BF,Burkina Faso,AFRO,2,782,0,51
2020-05-18,BF,Burkina Faso,AFRO,14,796,0,51
2020-05-19,BF,Burkina Faso,AFRO,13,809,0,51
2020-05-20,BF,Burkina Faso,AFRO,0,809,1,52
2020-05-21,BF,Burkina Faso,AFRO,0,809,0,52
2020-05-22,BF,Burkina Faso,AFRO,3,812,0,52
2020-05-23,BF,Burkina Faso,AFRO,3,815,0,52
2020-05-24,BF,Burkina Faso,AFRO,26,841,0,52
2020-05-25,BF,Burkina Faso,AFRO,4,845,1,53
2020-05-26,BF,Burkina Faso,AFRO,0,845,0,53
2020-05-27,BF,Burkina Faso,AFRO,0,845,0,53
2020-05-28,BF,Burkina Faso,AFRO,0,845,0,53
2020-05-29,BF,Burkina Faso,AFRO,2,847,0,53
2020-05-30,BF,Burkina Faso,AFRO,0,847,0,53
2020-05-31,BF,Burkina Faso,AFRO,8,855,0,53
2020-06-01,BF,Burkina Faso,AFRO,28,883,0,53
2020-06-02,BF,Burkina Faso,AFRO,0,883,0,53
2020-06-03,BF,Burkina Faso,AFRO,1,884,0,53
2020-06-04,BF,Burkina Faso,AFRO,0,884,0,53
2020-06-05,BF,Burkina Faso,AFRO,1,885,0,53
2020-06-06,BF,Burkina Faso,AFRO,3,888,0,53
2020-06-07,BF,Burkina Faso,AFRO,1,889,0,53
2020-06-08,BF,Burkina Faso,AFRO,0,889,0,53
2020-03-29,BI,Burundi,AFRO,0,2,0,1
2020-03-30,BI,Burundi,AFRO,0,2,0,1
2020-03-31,BI,Burundi,AFRO,0,2,0,1
2020-04-01,BI,Burundi,AFRO,0,2,0,1
2020-04-02,BI,Burundi,AFRO,0,2,0,1
2020-04-03,BI,Burundi,AFRO,1,3,0,1
2020-04-04,BI,Burundi,AFRO,0,3,0,1
2020-04-05,BI,Burundi,AFRO,0,3,0,1
2020-04-06,BI,Burundi,AFRO,0,3,0,1
2020-04-07,BI,Burundi,AFRO,0,3,0,1
2020-04-08,BI,Burundi,AFRO,0,3,0,1
2020-04-09,BI,Burundi,AFRO,0,3,0,1
2020-04-10,BI,Burundi,AFRO,0,3,0,1
2020-04-11,BI,Burundi,AFRO,0,3,0,1
2020-04-12,BI,Burundi,AFRO,2,5,0,1
2020-04-13,BI,Burundi,AFRO,0,5,0,1
2020-04-14,BI,Burundi,AFRO,0,5,0,1
2020-04-15,BI,Burundi,AFRO,0,5,0,1
2020-04-16,BI,Burundi,AFRO,0,5,0,1
2020-04-17,BI,Burundi,AFRO,0,5,0,1
2020-04-18,BI,Burundi,AFRO,0,5,0,1
2020-04-19,BI,Burundi,AFRO,0,5,0,1
2020-04-20,BI,Burundi,AFRO,6,11,0,1
2020-04-21,BI,Burundi,AFRO,0,11,0,1
2020-04-22,BI,Burundi,AFRO,0,11,0,1
2020-04-23,BI,Burundi,AFRO,0,11,0,1
2020-04-24,BI,Burundi,AFRO,0,11,0,1
2020-04-25,BI,Burundi,AFRO,1,12,0,1
2020-04-26,BI,Burundi,AFRO,3,15,0,1
2020-04-27,BI,Burundi,AFRO,0,15,0,1
2020-04-28,BI,Burundi,AFRO,0,15,0,1
2020-04-29,BI,Burundi,AFRO,0,15,0,1
2020-04-30,BI,Burundi,AFRO,0,15,0,1
2020-05-01,BI,Burundi,AFRO,0,15,0,1
2020-05-02,BI,Burundi,AFRO,4,19,0,1
2020-05-03,BI,Burundi,AFRO,0,19,0,1
2020-05-04,BI,Burundi,AFRO,0,19,0,1
2020-05-05,BI,Burundi,AFRO,0,19,0,1
2020-05-06,BI,Burundi,AFRO,0,19,0,1
2020-05-07,BI,Burundi,AFRO,0,19,0,1
2020-05-08,BI,Burundi,AFRO,0,19,0,1
2020-05-09,BI,Burundi,AFRO,8,27,0,1
2020-05-10,BI,Burundi,AFRO,0,27,0,1
2020-05-11,BI,Burundi,AFRO,0,27,0,1
2020-05-12,BI,Burundi,AFRO,0,27,0,1
2020-05-13,BI,Burundi,AFRO,0,27,0,1
2020-05-14,BI,Burundi,AFRO,0,27,0,1
2020-05-15,BI,Burundi,AFRO,0,27,0,1
2020-05-16,BI,Burundi,AFRO,15,42,0,1
2020-05-17,BI,Burundi,AFRO,0,42,0,1
2020-05-18,BI,Burundi,AFRO,0,42,0,1
2020-05-19,BI,Burundi,AFRO,0,42,0,1
2020-05-20,BI,Burundi,AFRO,0,42,0,1
2020-05-21,BI,Burundi,AFRO,0,42,0,1
2020-05-22,BI,Burundi,AFRO,0,42,0,1
2020-05-23,BI,Burundi,AFRO,0,42,0,1
2020-05-24,BI,Burundi,AFRO,0,42,0,1
2020-05-25,BI,Burundi,AFRO,0,42,0,1
2020-05-26,BI,Burundi,AFRO,0,42,0,1
2020-05-27,BI,Burundi,AFRO,0,42,0,1
2020-05-28,BI,Burundi,AFRO,0,42,0,1
2020-05-29,BI,Burundi,AFRO,0,42,0,1
2020-05-30,BI,Burundi,AFRO,0,42,0,1
2020-05-31,BI,Burundi,AFRO,21,63,0,1
2020-06-01,BI,Burundi,AFRO,0,63,0,1
2020-06-02,BI,Burundi,AFRO,0,63,0,1
2020-06-03,BI,Burundi,AFRO,0,63,0,1
2020-06-04,BI,Burundi,AFRO,0,63,0,1
2020-06-05,BI,Burundi,AFRO,20,83,0,1
2020-06-06,BI,Burundi,AFRO,0,83,0,1
2020-06-07,BI,Burundi,AFRO,0,83,0,1
2020-06-08,BI,Burundi,AFRO,0,83,0,1
2020-03-29,CV,Cabo Verde,AFRO,0,5,0,2
2020-03-30,CV,Cabo Verde,AFRO,0,5,0,2
2020-03-31,CV,Cabo Verde,AFRO,0,5,0,2
2020-04-01,CV,Cabo Verde,AFRO,0,5,0,2
2020-04-02,CV,Cabo Verde,AFRO,0,5,0,2
2020-04-03,CV,Cabo Verde,AFRO,0,5,0,2
2020-04-04,CV,Cabo Verde,AFRO,0,5,0,2
2020-04-05,CV,Cabo Verde,AFRO,0,5,0,2
2020-04-06,CV,Cabo Verde,AFRO,0,5,0,2
2020-04-07,CV,Cabo Verde,AFRO,2,7,0,2
2020-04-08,CV,Cabo Verde,AFRO,0,7,0,2
2020-04-09,CV,Cabo Verde,AFRO,0,7,0,2
2020-04-10,CV,Cabo Verde,AFRO,0,7,0,2
2020-04-11,CV,Cabo Verde,AFRO,0,7,0,2
2020-04-12,CV,Cabo Verde,AFRO,0,7,0,2
2020-04-13,CV,Cabo Verde,AFRO,3,10,0,2
2020-04-14,CV,Cabo Verde,AFRO,0,10,0,2
2020-04-15,CV,Cabo Verde,AFRO,0,10,0,2
2020-04-16,CV,Cabo Verde,AFRO,45,55,0,2
2020-04-17,CV,Cabo Verde,AFRO,0,55,0,2
2020-04-18,CV,Cabo Verde,AFRO,0,55,0,2
2020-04-19,CV,Cabo Verde,AFRO,0,55,0,2
2020-04-20,CV,Cabo Verde,AFRO,0,55,0,2
2020-04-21,CV,Cabo Verde,AFRO,12,67,0,2
2020-04-22,CV,Cabo Verde,AFRO,0,67,0,2
2020-04-23,CV,Cabo Verde,AFRO,0,67,0,2
2020-04-24,CV,Cabo Verde,AFRO,17,84,0,2
2020-04-25,CV,Cabo Verde,AFRO,6,90,0,2
2020-04-26,CV,Cabo Verde,AFRO,0,90,0,2
2020-04-27,CV,Cabo Verde,AFRO,16,106,0,2
2020-04-28,CV,Cabo Verde,AFRO,3,109,0,2
2020-04-29,CV,Cabo Verde,AFRO,4,113,0,2
2020-04-30,CV,Cabo Verde,AFRO,0,113,0,2
2020-05-01,CV,Cabo Verde,AFRO,8,121,0,2
2020-05-02,CV,Cabo Verde,AFRO,2,123,0,2
2020-05-03,CV,Cabo Verde,AFRO,29,152,0,2
2020-05-04,CV,Cabo Verde,AFRO,13,165,0,2
2020-05-05,CV,Cabo Verde,AFRO,10,175,0,2
2020-05-06,CV,Cabo Verde,AFRO,11,186,0,2
2020-05-07,CV,Cabo Verde,AFRO,5,191,0,2
2020-05-08,CV,Cabo Verde,AFRO,27,218,0,2
2020-05-09,CV,Cabo Verde,AFRO,13,231,0,2
2020-05-10,CV,Cabo Verde,AFRO,5,236,0,2
2020-05-11,CV,Cabo Verde,AFRO,10,246,0,2
2020-05-12,CV,Cabo Verde,AFRO,14,260,0,2
2020-05-13,CV,Cabo Verde,AFRO,10,270,0,2
2020-05-14,CV,Cabo Verde,AFRO,19,289,0,2
2020-05-15,CV,Cabo Verde,AFRO,26,315,0,2
2020-05-16,CV,Cabo Verde,AFRO,11,326,0,2
2020-05-17,CV,Cabo Verde,AFRO,2,328,1,3
2020-05-18,CV,Cabo Verde,AFRO,0,328,0,3
2020-05-19,CV,Cabo Verde,AFRO,0,328,0,3
2020-05-20,CV,Cabo Verde,AFRO,7,335,0,3
2020-05-21,CV,Cabo Verde,AFRO,14,349,0,3
2020-05-22,CV,Cabo Verde,AFRO,7,356,0,3
2020-05-23,CV,Cabo Verde,AFRO,6,362,0,3
2020-05-24,CV,Cabo Verde,AFRO,9,371,0,3
2020-05-25,CV,Cabo Verde,AFRO,9,380,0,3
2020-05-26,CV,Cabo Verde,AFRO,10,390,0,3
2020-05-27,CV,Cabo Verde,AFRO,0,390,1,4
2020-05-28,CV,Cabo Verde,AFRO,0,390,0,4
2020-05-29,CV,Cabo Verde,AFRO,0,390,0,4
2020-05-30,CV,Cabo Verde,AFRO,15,405,0,4
2020-05-31,CV,Cabo Verde,AFRO,16,421,0,4
2020-06-01,CV,Cabo Verde,AFRO,14,435,0,4
2020-06-02,CV,Cabo Verde,AFRO,23,458,0,4
2020-06-03,CV,Cabo Verde,AFRO,8,466,1,5
2020-06-04,CV,Cabo Verde,AFRO,11,477,0,5
2020-06-05,CV,Cabo Verde,AFRO,25,502,0,5
2020-06-06,CV,Cabo Verde,AFRO,34,536,0,5
2020-06-07,CV,Cabo Verde,AFRO,6,542,0,5
2020-06-08,CV,Cabo Verde,AFRO,12,554,0,5
2020-03-29,KH,Cambodia,WPRO,4,102,0,0
2020-03-30,KH,Cambodia,WPRO,1,103,0,0
2020-03-31,KH,Cambodia,WPRO,4,107,0,0
2020-04-01,KH,Cambodia,WPRO,2,109,0,0
2020-04-02,KH,Cambodia,WPRO,0,109,0,0
2020-04-03,KH,Cambodia,WPRO,1,110,0,0
2020-04-04,KH,Cambodia,WPRO,4,114,0,0
2020-04-05,KH,Cambodia,WPRO,0,114,0,0
2020-04-06,KH,Cambodia,WPRO,0,114,0,0
2020-04-07,KH,Cambodia,WPRO,1,115,0,0
2020-04-08,KH,Cambodia,WPRO,0,115,0,0
2020-04-09,KH,Cambodia,WPRO,2,117,0,0
2020-04-10,KH,Cambodia,WPRO,1,118,0,0
2020-04-11,KH,Cambodia,WPRO,2,120,0,0
2020-04-12,KH,Cambodia,WPRO,2,122,0,0
2020-04-13,KH,Cambodia,WPRO,0,122,0,0
2020-04-14,KH,Cambodia,WPRO,0,122,0,0
2020-04-15,KH,Cambodia,WPRO,0,122,0,0
2020-04-16,KH,Cambodia,WPRO,0,122,0,0
2020-04-17,KH,Cambodia,WPRO,0,122,0,0
2020-04-18,KH,Cambodia,WPRO,0,122,0,0
2020-04-19,KH,Cambodia,WPRO,0,122,0,0
2020-04-20,KH,Cambodia,WPRO,0,122,0,0
2020-04-21,KH,Cambodia,WPRO,0,122,0,0
2020-04-22,KH,Cambodia,WPRO,0,122,0,0
2020-04-23,KH,Cambodia,WPRO,0,122,0,0
2020-04-24,KH,Cambodia,WPRO,0,122,0,0
2020-04-25,KH,Cambodia,WPRO,0,122,0,0
2020-04-26,KH,Cambodia,WPRO,0,122,0,0
2020-04-27,KH,Cambodia,WPRO,0,122,0,0
2020-04-28,KH,Cambodia,WPRO,0,122,0,0
2020-04-29,KH,Cambodia,WPRO,0,122,0,0
2020-04-30,KH,Cambodia,WPRO,0,122,0,0
2020-05-01,KH,Cambodia,WPRO,0,122,0,0
2020-05-02,KH,Cambodia,WPRO,0,122,0,0
2020-05-03,KH,Cambodia,WPRO,0,122,0,0
2020-05-04,KH,Cambodia,WPRO,0,122,0,0
2020-05-05,KH,Cambodia,WPRO,0,122,0,0
2020-05-06,KH,Cambodia,WPRO,0,122,0,0
2020-05-07,KH,Cambodia,WPRO,0,122,0,0
2020-05-08,KH,Cambodia,WPRO,0,122,0,0
2020-05-09,KH,Cambodia,WPRO,0,122,0,0
2020-05-10,KH,Cambodia,WPRO,0,122,0,0
2020-05-11,KH,Cambodia,WPRO,0,122,0,0
2020-05-12,KH,Cambodia,WPRO,0,122,0,0
2020-05-13,KH,Cambodia,WPRO,0,122,0,0
2020-05-14,KH,Cambodia,WPRO,0,122,0,0
2020-05-15,KH,Cambodia,WPRO,0,122,0,0
2020-05-16,KH,Cambodia,WPRO,0,122,0,0
2020-05-17,KH,Cambodia,WPRO,0,122,0,0
2020-05-18,KH,Cambodia,WPRO,0,122,0,0
2020-05-19,KH,Cambodia,WPRO,0,122,0,0
2020-05-20,KH,Cambodia,WPRO,0,122,0,0
2020-05-21,KH,Cambodia,WPRO,0,122,0,0
2020-05-22,KH,Cambodia,WPRO,1,123,0,0
2020-05-23,KH,Cambodia,WPRO,1,124,0,0
2020-05-24,KH,Cambodia,WPRO,0,124,0,0
2020-05-25,KH,Cambodia,WPRO,0,124,0,0
2020-05-26,KH,Cambodia,WPRO,0,124,0,0
2020-05-27,KH,Cambodia,WPRO,0,124,0,0
2020-05-28,KH,Cambodia,WPRO,0,124,0,0
2020-05-29,KH,Cambodia,WPRO,0,124,0,0
2020-05-30,KH,Cambodia,WPRO,1,125,0,0
2020-05-31,KH,Cambodia,WPRO,0,125,0,0
2020-06-01,KH,Cambodia,WPRO,0,125,0,0
2020-06-02,KH,Cambodia,WPRO,0,125,0,0
2020-06-03,KH,Cambodia,WPRO,0,125,0,0
2020-06-04,KH,Cambodia,WPRO,0,125,0,0
2020-06-05,KH,Cambodia,WPRO,0,125,0,0
2020-06-06,KH,Cambodia,WPRO,0,125,0,0
2020-06-07,KH,Cambodia,WPRO,1,126,0,0
2020-06-08,KH,Cambodia,WPRO,0,126,0,0
2020-03-29,CM,Cameroon,AFRO,0,90,0,6
2020-03-30,CM,Cameroon,AFRO,0,90,0,6
2020-03-31,CM,Cameroon,AFRO,47,137,4,10
2020-04-01,CM,Cameroon,AFRO,0,137,0,10
2020-04-02,CM,Cameroon,AFRO,38,175,1,11
2020-04-03,CM,Cameroon,AFRO,131,306,0,11
2020-04-04,CM,Cameroon,AFRO,194,500,1,12
2020-04-05,CM,Cameroon,AFRO,55,555,1,13
2020-04-06,CM,Cameroon,AFRO,44,599,0,13
2020-04-07,CM,Cameroon,AFRO,16,615,0,13
2020-04-08,CM,Cameroon,AFRO,115,730,0,13
2020-04-09,CM,Cameroon,AFRO,0,730,0,13
2020-04-10,CM,Cameroon,AFRO,0,730,0,13
2020-04-11,CM,Cameroon,AFRO,92,822,2,15
2020-04-12,CM,Cameroon,AFRO,0,822,0,15
2020-04-13,CM,Cameroon,AFRO,0,822,0,15
2020-04-14,CM,Cameroon,AFRO,33,855,3,18
2020-04-15,CM,Cameroon,AFRO,0,855,0,18
2020-04-16,CM,Cameroon,AFRO,0,855,2,20
2020-04-17,CM,Cameroon,AFRO,160,1015,4,24
2020-04-18,CM,Cameroon,AFRO,0,1015,0,24
2020-04-19,CM,Cameroon,AFRO,1,1016,21,45
2020-04-20,CM,Cameroon,AFRO,0,1016,0,45
2020-04-21,CM,Cameroon,AFRO,147,1163,0,45
2020-04-22,CM,Cameroon,AFRO,0,1163,0,45
2020-04-23,CM,Cameroon,AFRO,238,1401,0,45
2020-04-24,CM,Cameroon,AFRO,0,1401,6,51
2020-04-25,CM,Cameroon,AFRO,2,1403,0,51
2020-04-26,CM,Cameroon,AFRO,218,1621,7,58
2020-04-27,CM,Cameroon,AFRO,0,1621,0,58
2020-04-28,CM,Cameroon,AFRO,0,1621,0,58
2020-04-29,CM,Cameroon,AFRO,184,1805,1,59
2020-04-30,CM,Cameroon,AFRO,3,1808,1,60
2020-05-01,CM,Cameroon,AFRO,261,2069,2,62
2020-05-02,CM,Cameroon,AFRO,0,2069,0,62
2020-05-03,CM,Cameroon,AFRO,8,2077,4,66
2020-05-04,CM,Cameroon,AFRO,0,2077,0,66
2020-05-05,CM,Cameroon,AFRO,188,2265,44,110
2020-05-06,CM,Cameroon,AFRO,0,2265,0,110
2020-05-07,CM,Cameroon,AFRO,0,2265,0,110
2020-05-08,CM,Cameroon,AFRO,0,2265,0,110
2020-05-09,CM,Cameroon,AFRO,70,2335,2,112
2020-05-10,CM,Cameroon,AFRO,0,2335,0,112
2020-05-11,CM,Cameroon,AFRO,244,2579,4,116
2020-05-12,CM,Cameroon,AFRO,110,2689,11,127
2020-05-13,CM,Cameroon,AFRO,111,2800,11,138
2020-05-14,CM,Cameroon,AFRO,154,2954,3,141
2020-05-15,CM,Cameroon,AFRO,93,3047,1,142
2020-05-16,CM,Cameroon,AFRO,0,3047,0,142
2020-05-17,CM,Cameroon,AFRO,0,3047,0,142
2020-05-18,CM,Cameroon,AFRO,482,3529,1,143
2020-05-19,CM,Cameroon,AFRO,0,3529,0,143
2020-05-20,CM,Cameroon,AFRO,0,3529,0,143
2020-05-21,CM,Cameroon,AFRO,204,3733,16,159
2020-05-22,CM,Cameroon,AFRO,555,4288,0,159
2020-05-23,CM,Cameroon,AFRO,112,4400,3,162
2020-05-24,CM,Cameroon,AFRO,0,4400,0,162
2020-05-25,CM,Cameroon,AFRO,490,4890,6,168
2020-05-26,CM,Cameroon,AFRO,0,4890,12,180
2020-05-27,CM,Cameroon,AFRO,546,5436,0,180
2020-05-28,CM,Cameroon,AFRO,0,5436,0,180
2020-05-29,CM,Cameroon,AFRO,0,5436,0,180
2020-05-30,CM,Cameroon,AFRO,223,5659,8,188
2020-05-31,CM,Cameroon,AFRO,245,5904,6,194
2020-06-01,CM,Cameroon,AFRO,0,5904,0,194
2020-06-02,CM,Cameroon,AFRO,660,6564,8,202
2020-06-03,CM,Cameroon,AFRO,188,6752,1,203
2020-06-04,CM,Cameroon,AFRO,37,6789,3,206
2020-06-05,CM,Cameroon,AFRO,603,7392,2,208
2020-06-06,CM,Cameroon,AFRO,0,7392,0,208
2020-06-07,CM,Cameroon,AFRO,566,7958,7,215
2020-06-08,CM,Cameroon,AFRO,102,8060,3,218
2020-03-29,CA,Canada,AMRO,657,4675,11,35
2020-03-30,CA,Canada,AMRO,711,5386,6,41
2020-03-31,CA,Canada,AMRO,869,6255,1,42
2020-04-01,CA,Canada,AMRO,1169,7424,14,56
2020-04-02,CA,Canada,AMRO,1112,8536,7,63
2020-04-03,CA,Canada,AMRO,1059,9595,9,72
2020-04-04,CA,Canada,AMRO,1673,11268,66,138
2020-04-05,CA,Canada,AMRO,1251,12519,49,187
2020-04-06,CA,Canada,AMRO,1363,13882,44,231
2020-04-07,CA,Canada,AMRO,1614,15496,49,280
2020-04-08,CA,Canada,AMRO,1157,16653,43,323
2020-04-09,CA,Canada,AMRO,1230,17883,56,379
2020-04-10,CA,Canada,AMRO,1391,19274,55,434
2020-04-11,CA,Canada,AMRO,1474,20748,74,508
2020-04-12,CA,Canada,AMRO,1385,22133,60,568
2020-04-13,CA,Canada,AMRO,1168,23301,84,652
2020-04-14,CA,Canada,AMRO,1064,24365,64,716
2020-04-15,CA,Canada,AMRO,1298,25663,63,779
2020-04-16,CA,Canada,AMRO,1383,27046,123,902
2020-04-17,CA,Canada,AMRO,1318,28364,107,1009
2020-04-18,CA,Canada,AMRO,1717,30081,182,1191
2020-04-19,CA,Canada,AMRO,1791,31872,115,1306
2020-04-20,CA,Canada,AMRO,1468,33340,158,1464
2020-04-21,CA,Canada,AMRO,1436,34776,113,1577
2020-04-22,CA,Canada,AMRO,2046,36822,110,1687
2020-04-23,CA,Canada,AMRO,1590,38412,144,1831
2020-04-24,CA,Canada,AMRO,1767,40179,140,1971
2020-04-25,CA,Canada,AMRO,1920,42099,172,2143
2020-04-26,CA,Canada,AMRO,1778,43877,156,2299
2020-04-27,CA,Canada,AMRO,1464,45341,162,2461
2020-04-28,CA,Canada,AMRO,1543,46884,94,2555
2020-04-29,CA,Canada,AMRO,1605,48489,146,2701
2020-04-30,CA,Canada,AMRO,1526,50015,152,2853
2020-05-01,CA,Canada,AMRO,1572,51587,137,2990
2020-05-02,CA,Canada,AMRO,1638,53225,186,3176
2020-05-03,CA,Canada,AMRO,1825,55050,206,3382
2020-05-04,CA,Canada,AMRO,1653,56703,174,3556
2020-05-05,CA,Canada,AMRO,2760,59463,115,3671
2020-05-06,CA,Canada,AMRO,1298,60761,172,3843
2020-05-07,CA,Canada,AMRO,1274,62035,188,4031
2020-05-08,CA,Canada,AMRO,1449,63484,189,4220
2020-05-09,CA,Canada,AMRO,1426,64910,175,4395
2020-05-10,CA,Canada,AMRO,1512,66422,161,4556
2020-05-11,CA,Canada,AMRO,1268,67690,123,4679
2020-05-12,CA,Canada,AMRO,1146,68836,178,4857
2020-05-13,CA,Canada,AMRO,1133,69969,122,4979
2020-05-14,CA,Canada,AMRO,1175,71144,176,5155
2020-05-15,CA,Canada,AMRO,1121,72265,133,5288
2020-05-16,CA,Canada,AMRO,1211,73476,168,5456
2020-05-17,CA,Canada,AMRO,1126,74602,90,5546
2020-05-18,CA,Canada,AMRO,1251,75853,117,5663
2020-05-19,CA,Canada,AMRO,1138,76991,103,5766
2020-05-20,CA,Canada,AMRO,1070,78061,60,5826
2020-05-21,CA,Canada,AMRO,1040,79101,69,5895
2020-05-22,CA,Canada,AMRO,1011,80112,118,6013
2020-05-23,CA,Canada,AMRO,1201,81313,122,6135
2020-05-24,CA,Canada,AMRO,1156,82469,97,6232
2020-05-25,CA,Canada,AMRO,1141,83610,103,6335
2020-05-26,CA,Canada,AMRO,1078,84688,69,6404
2020-05-27,CA,Canada,AMRO,1012,85700,121,6525
2020-05-28,CA,Canada,AMRO,936,86636,94,6619
2020-05-29,CA,Canada,AMRO,872,87508,126,6745
2020-05-30,CA,Canada,AMRO,993,88501,112,6857
2020-05-31,CA,Canada,AMRO,906,89407,102,6959
2020-06-01,CA,Canada,AMRO,772,90179,94,7053
2020-06-02,CA,Canada,AMRO,757,90936,222,7275
2020-06-03,CA,Canada,AMRO,758,91694,31,7306
2020-06-04,CA,Canada,AMRO,705,92399,69,7375
2020-06-05,CA,Canada,AMRO,675,93074,103,7478
2020-06-06,CA,Canada,AMRO,641,93715,139,7617
2020-06-07,CA,Canada,AMRO,609,94324,66,7683
2020-06-08,CA,Canada,AMRO,722,95046,67,7750
2020-03-29,KY,Cayman Islands,AMRO,0,8,0,1
2020-03-30,KY,Cayman Islands,AMRO,0,8,0,1
2020-03-31,KY,Cayman Islands,AMRO,4,12,0,1
2020-04-01,KY,Cayman Islands,AMRO,0,12,0,1
2020-04-02,KY,Cayman Islands,AMRO,2,14,0,1
2020-04-03,KY,Cayman Islands,AMRO,8,22,0,1
2020-04-04,KY,Cayman Islands,AMRO,6,28,0,1
2020-04-05,KY,Cayman Islands,AMRO,0,28,0,1
2020-04-06,KY,Cayman Islands,AMRO,7,35,0,1
2020-04-07,KY,Cayman Islands,AMRO,4,39,0,1
2020-04-08,KY,Cayman Islands,AMRO,0,39,0,1
2020-04-09,KY,Cayman Islands,AMRO,6,45,0,1
2020-04-10,KY,Cayman Islands,AMRO,0,45,0,1
2020-04-11,KY,Cayman Islands,AMRO,0,45,0,1
2020-04-12,KY,Cayman Islands,AMRO,0,45,0,1
2020-04-13,KY,Cayman Islands,AMRO,8,53,0,1
2020-04-14,KY,Cayman Islands,AMRO,0,53,0,1
2020-04-15,KY,Cayman Islands,AMRO,1,54,0,1
2020-04-16,KY,Cayman Islands,AMRO,0,54,0,1
2020-04-17,KY,Cayman Islands,AMRO,6,60,0,1
2020-04-18,KY,Cayman Islands,AMRO,1,61,0,1
2020-04-19,KY,Cayman Islands,AMRO,0,61,0,1
2020-04-20,KY,Cayman Islands,AMRO,0,61,0,1
2020-04-21,KY,Cayman Islands,AMRO,0,61,0,1
2020-04-22,KY,Cayman Islands,AMRO,5,66,0,1
2020-04-23,KY,Cayman Islands,AMRO,0,66,0,1
2020-04-24,KY,Cayman Islands,AMRO,0,66,0,1
2020-04-25,KY,Cayman Islands,AMRO,0,66,0,1
2020-04-26,KY,Cayman Islands,AMRO,4,70,0,1
2020-04-27,KY,Cayman Islands,AMRO,0,70,0,1
2020-04-28,KY,Cayman Islands,AMRO,0,70,0,1
2020-04-29,KY,Cayman Islands,AMRO,0,70,0,1
2020-04-30,KY,Cayman Islands,AMRO,3,73,0,1
2020-05-01,KY,Cayman Islands,AMRO,0,73,0,1
2020-05-02,KY,Cayman Islands,AMRO,0,73,0,1
2020-05-03,KY,Cayman Islands,AMRO,1,74,0,1
2020-05-04,KY,Cayman Islands,AMRO,0,74,0,1
2020-05-05,KY,Cayman Islands,AMRO,0,74,0,1
2020-05-06,KY,Cayman Islands,AMRO,1,75,0,1
2020-05-07,KY,Cayman Islands,AMRO,3,78,0,1
2020-05-08,KY,Cayman Islands,AMRO,0,78,0,1
2020-05-09,KY,Cayman Islands,AMRO,2,80,0,1
2020-05-10,KY,Cayman Islands,AMRO,1,81,0,1
2020-05-11,KY,Cayman Islands,AMRO,0,81,0,1
2020-05-12,KY,Cayman Islands,AMRO,0,81,0,1
2020-05-13,KY,Cayman Islands,AMRO,3,84,0,1
2020-05-14,KY,Cayman Islands,AMRO,1,85,0,1
2020-05-15,KY,Cayman Islands,AMRO,1,86,0,1
2020-05-16,KY,Cayman Islands,AMRO,7,93,0,1
2020-05-17,KY,Cayman Islands,AMRO,1,94,0,1
2020-05-18,KY,Cayman Islands,AMRO,0,94,0,1
2020-05-19,KY,Cayman Islands,AMRO,0,94,0,1
2020-05-20,KY,Cayman Islands,AMRO,0,94,0,1
2020-05-21,KY,Cayman Islands,AMRO,17,111,0,1
2020-05-22,KY,Cayman Islands,AMRO,0,111,0,1
2020-05-23,KY,Cayman Islands,AMRO,10,121,0,1
2020-05-24,KY,Cayman Islands,AMRO,8,129,0,1
2020-05-25,KY,Cayman Islands,AMRO,0,129,0,1
2020-05-26,KY,Cayman Islands,AMRO,0,129,0,1
2020-05-27,KY,Cayman Islands,AMRO,5,134,0,1
2020-05-28,KY,Cayman Islands,AMRO,3,137,0,1
2020-05-29,KY,Cayman Islands,AMRO,3,140,0,1
2020-05-30,KY,Cayman Islands,AMRO,0,140,0,1
2020-05-31,KY,Cayman Islands,AMRO,1,141,0,1
2020-06-01,KY,Cayman Islands,AMRO,0,141,0,1
2020-06-02,KY,Cayman Islands,AMRO,0,141,0,1
2020-06-03,KY,Cayman Islands,AMRO,9,150,0,1
2020-06-04,KY,Cayman Islands,AMRO,1,151,0,1
2020-06-05,KY,Cayman Islands,AMRO,5,156,0,1
2020-06-06,KY,Cayman Islands,AMRO,4,160,0,1
2020-06-07,KY,Cayman Islands,AMRO,4,164,0,1
2020-06-08,KY,Cayman Islands,AMRO,0,164,0,1
2020-03-29,CF,Central African Republic,AFRO,0,13,0,1
2020-03-30,CF,Central African Republic,AFRO,0,13,0,1
2020-03-31,CF,Central African Republic,AFRO,0,13,0,1
2020-04-01,CF,Central African Republic,AFRO,0,13,0,1
2020-04-02,CF,Central African Republic,AFRO,4,17,0,1
2020-04-03,CF,Central African Republic,AFRO,0,17,0,1
2020-04-04,CF,Central African Republic,AFRO,0,17,0,1
2020-04-05,CF,Central African Republic,AFRO,1,18,0,1
2020-04-06,CF,Central African Republic,AFRO,0,18,0,1
2020-04-07,CF,Central African Republic,AFRO,0,18,0,1
2020-04-08,CF,Central African Republic,AFRO,1,19,0,1
2020-04-09,CF,Central African Republic,AFRO,0,19,0,1
2020-04-10,CF,Central African Republic,AFRO,1,20,0,1
2020-04-11,CF,Central African Republic,AFRO,0,20,0,1
2020-04-12,CF,Central African Republic,AFRO,0,20,0,1
2020-04-13,CF,Central African Republic,AFRO,0,20,0,1
2020-04-14,CF,Central African Republic,AFRO,0,20,0,1
2020-04-15,CF,Central African Republic,AFRO,1,21,0,1
2020-04-16,CF,Central African Republic,AFRO,0,21,0,1
2020-04-17,CF,Central African Republic,AFRO,0,21,0,1
2020-04-18,CF,Central African Republic,AFRO,0,21,0,1
2020-04-19,CF,Central African Republic,AFRO,0,21,0,1
2020-04-20,CF,Central African Republic,AFRO,0,21,0,1
2020-04-21,CF,Central African Republic,AFRO,2,23,0,1
2020-04-22,CF,Central African Republic,AFRO,0,23,0,1
2020-04-23,CF,Central African Republic,AFRO,3,26,0,1
2020-04-24,CF,Central African Republic,AFRO,4,30,0,1
2020-04-25,CF,Central African Republic,AFRO,0,30,0,1
2020-04-26,CF,Central African Republic,AFRO,0,30,0,1
2020-04-27,CF,Central African Republic,AFRO,24,54,0,1
2020-04-28,CF,Central African Republic,AFRO,9,63,0,1
2020-04-29,CF,Central African Republic,AFRO,0,63,0,1
2020-04-30,CF,Central African Republic,AFRO,1,64,0,1
2020-05-01,CF,Central African Republic,AFRO,22,86,0,1
2020-05-02,CF,Central African Republic,AFRO,2,88,0,1
2020-05-03,CF,Central African Republic,AFRO,0,88,0,1
2020-05-04,CF,Central African Republic,AFRO,1,89,0,1
2020-05-05,CF,Central African Republic,AFRO,22,111,0,1
2020-05-06,CF,Central African Republic,AFRO,3,114,0,1
2020-05-07,CF,Central African Republic,AFRO,0,114,0,1
2020-05-08,CF,Central African Republic,AFRO,50,164,0,1
2020-05-09,CF,Central African Republic,AFRO,3,167,0,1
2020-05-10,CF,Central African Republic,AFRO,3,170,0,1
2020-05-11,CF,Central African Republic,AFRO,36,206,0,1
2020-05-12,CF,Central African Republic,AFRO,0,206,0,1
2020-05-13,CF,Central African Republic,AFRO,1,207,0,1
2020-05-14,CF,Central African Republic,AFRO,8,215,0,1
2020-05-15,CF,Central African Republic,AFRO,114,329,0,1
2020-05-16,CF,Central African Republic,AFRO,3,332,0,1
2020-05-17,CF,Central African Republic,AFRO,35,367,0,1
2020-05-18,CF,Central African Republic,AFRO,5,372,0,1
2020-05-19,CF,Central African Republic,AFRO,77,449,0,1
2020-05-20,CF,Central African Republic,AFRO,2,451,0,1
2020-05-21,CF,Central African Republic,AFRO,9,460,0,1
2020-05-22,CF,Central African Republic,AFRO,63,523,0,1
2020-05-23,CF,Central African Republic,AFRO,77,600,0,1
2020-05-24,CF,Central African Republic,AFRO,4,604,0,1
2020-05-25,CF,Central African Republic,AFRO,52,656,0,1
2020-05-26,CF,Central African Republic,AFRO,67,723,0,1
2020-05-27,CF,Central African Republic,AFRO,35,758,0,1
2020-05-28,CF,Central African Republic,AFRO,53,811,0,1
2020-05-29,CF,Central African Republic,AFRO,136,947,0,1
2020-05-30,CF,Central African Republic,AFRO,16,963,0,1
2020-05-31,CF,Central African Republic,AFRO,89,1052,1,2
2020-06-01,CF,Central African Republic,AFRO,112,1164,2,4
2020-06-02,CF,Central African Republic,AFRO,0,1164,0,4
2020-06-03,CF,Central African Republic,AFRO,120,1284,0,4
2020-06-04,CF,Central African Republic,AFRO,112,1396,0,4
2020-06-05,CF,Central African Republic,AFRO,180,1576,0,4
2020-06-06,CF,Central African Republic,AFRO,23,1599,0,4
2020-06-07,CF,Central African Republic,AFRO,143,1742,1,5
2020-06-08,CF,Central African Republic,AFRO,72,1814,0,5
2020-03-29,TD,Chad,AFRO,0,5,0,12
2020-03-30,TD,Chad,AFRO,2,7,0,12
2020-03-31,TD,Chad,AFRO,0,7,0,12
2020-04-01,TD,Chad,AFRO,1,8,0,12
2020-04-02,TD,Chad,AFRO,0,8,0,12
2020-04-03,TD,Chad,AFRO,1,9,0,12
2020-04-04,TD,Chad,AFRO,0,9,0,12
2020-04-05,TD,Chad,AFRO,0,9,0,12
2020-04-06,TD,Chad,AFRO,0,9,0,12
2020-04-07,TD,Chad,AFRO,1,10,0,12
2020-04-08,TD,Chad,AFRO,0,10,0,12
2020-04-09,TD,Chad,AFRO,1,11,0,12
2020-04-10,TD,Chad,AFRO,0,11,0,12
2020-04-11,TD,Chad,AFRO,0,11,0,12
2020-04-12,TD,Chad,AFRO,7,18,0,12
2020-04-13,TD,Chad,AFRO,5,23,0,12
2020-04-14,TD,Chad,AFRO,0,23,0,12
2020-04-15,TD,Chad,AFRO,0,23,0,12
2020-04-16,TD,Chad,AFRO,4,27,0,12
2020-04-17,TD,Chad,AFRO,4,31,0,12
2020-04-18,TD,Chad,AFRO,2,33,0,12
2020-04-19,TD,Chad,AFRO,0,33,0,12
2020-04-20,TD,Chad,AFRO,0,33,0,12
2020-04-21,TD,Chad,AFRO,1,34,0,12
2020-04-22,TD,Chad,AFRO,0,34,0,12
2020-04-23,TD,Chad,AFRO,6,40,0,12
2020-04-24,TD,Chad,AFRO,0,40,0,12
2020-04-25,TD,Chad,AFRO,0,40,0,12
2020-04-26,TD,Chad,AFRO,6,46,0,12
2020-04-27,TD,Chad,AFRO,0,46,0,12
2020-04-28,TD,Chad,AFRO,6,52,0,12
2020-04-29,TD,Chad,AFRO,0,52,0,12
2020-04-30,TD,Chad,AFRO,0,52,3,15
2020-05-01,TD,Chad,AFRO,21,73,0,15
2020-05-02,TD,Chad,AFRO,44,117,5,20
2020-05-03,TD,Chad,AFRO,0,117,0,20
2020-05-04,TD,Chad,AFRO,0,117,0,20
2020-05-05,TD,Chad,AFRO,53,170,7,27
2020-05-06,TD,Chad,AFRO,0,170,0,27
2020-05-07,TD,Chad,AFRO,0,170,0,27
2020-05-08,TD,Chad,AFRO,83,253,10,37
2020-05-09,TD,Chad,AFRO,7,260,2,39
2020-05-10,TD,Chad,AFRO,62,322,2,41
2020-05-11,TD,Chad,AFRO,0,322,0,41
2020-05-12,TD,Chad,AFRO,35,357,1,42
2020-05-13,TD,Chad,AFRO,15,372,2,44
2020-05-14,TD,Chad,AFRO,0,372,0,44
2020-05-15,TD,Chad,AFRO,27,399,4,48
2020-05-16,TD,Chad,AFRO,29,428,3,51
2020-05-17,TD,Chad,AFRO,75,503,4,55
2020-05-18,TD,Chad,AFRO,16,519,1,56
2020-05-19,TD,Chad,AFRO,0,519,0,56
2020-05-20,TD,Chad,AFRO,46,565,3,59
2020-05-21,TD,Chad,AFRO,23,588,1,60
2020-05-22,TD,Chad,AFRO,23,611,1,61
2020-05-23,TD,Chad,AFRO,0,611,1,62
2020-05-24,TD,Chad,AFRO,64,675,0,62
2020-05-25,TD,Chad,AFRO,12,687,1,63
2020-05-26,TD,Chad,AFRO,13,700,1,64
2020-05-27,TD,Chad,AFRO,15,715,2,66
2020-05-28,TD,Chad,AFRO,11,726,1,67
2020-05-29,TD,Chad,AFRO,33,759,0,67
2020-05-30,TD,Chad,AFRO,0,759,0,67
2020-05-31,TD,Chad,AFRO,19,778,0,67
2020-06-01,TD,Chad,AFRO,12,790,1,68
2020-06-02,TD,Chad,AFRO,13,803,0,68
2020-06-03,TD,Chad,AFRO,0,803,0,68
2020-06-04,TD,Chad,AFRO,25,828,0,68
2020-06-05,TD,Chad,AFRO,8,836,2,70
2020-06-06,TD,Chad,AFRO,0,836,1,71
2020-06-07,TD,Chad,AFRO,1,837,0,71
2020-06-08,TD,Chad,AFRO,0,837,0,71
2020-03-29,CL,Chile,AMRO,299,1909,1,6
2020-03-30,CL,Chile,AMRO,230,2139,1,7
2020-03-31,CL,Chile,AMRO,310,2449,1,8
2020-04-01,CL,Chile,AMRO,289,2738,4,12
2020-04-02,CL,Chile,AMRO,293,3031,4,16
2020-04-03,CL,Chile,AMRO,373,3404,2,18
2020-04-04,CL,Chile,AMRO,333,3737,4,22
2020-04-05,CL,Chile,AMRO,424,4161,5,27
2020-04-06,CL,Chile,AMRO,310,4471,7,34
2020-04-07,CL,Chile,AMRO,344,4815,3,37
2020-04-08,CL,Chile,AMRO,301,5116,6,43
2020-04-09,CL,Chile,AMRO,430,5546,5,48
2020-04-10,CL,Chile,AMRO,426,5972,9,57
2020-04-11,CL,Chile,AMRO,529,6501,8,65
2020-04-12,CL,Chile,AMRO,426,6927,8,73
2020-04-13,CL,Chile,AMRO,286,7213,7,80
2020-04-14,CL,Chile,AMRO,312,7525,2,82
2020-04-15,CL,Chile,AMRO,392,7917,10,92
2020-04-16,CL,Chile,AMRO,356,8273,2,94
2020-04-17,CL,Chile,AMRO,534,8807,11,105
2020-04-18,CL,Chile,AMRO,445,9252,11,116
2020-04-19,CL,Chile,AMRO,478,9730,10,126
2020-04-20,CL,Chile,AMRO,358,10088,7,133
2020-04-21,CL,Chile,AMRO,419,10507,6,139
2020-04-22,CL,Chile,AMRO,325,10832,8,147
2020-04-23,CL,Chile,AMRO,464,11296,13,160
2020-04-24,CL,Chile,AMRO,516,11812,8,168
2020-04-25,CL,Chile,AMRO,494,12306,6,174
2020-04-26,CL,Chile,AMRO,552,12858,7,181
2020-04-27,CL,Chile,AMRO,473,13331,8,189
2020-04-28,CL,Chile,AMRO,482,13813,9,198
2020-04-29,CL,Chile,AMRO,552,14365,9,207
2020-04-30,CL,Chile,AMRO,770,15135,9,216
2020-05-01,CL,Chile,AMRO,888,16023,11,227
2020-05-02,CL,Chile,AMRO,985,17008,7,234
2020-05-03,CL,Chile,AMRO,1427,18435,13,247
2020-05-04,CL,Chile,AMRO,1228,19663,13,260
2020-05-05,CL,Chile,AMRO,980,20643,10,270
2020-05-06,CL,Chile,AMRO,1373,22016,5,275
2020-05-07,CL,Chile,AMRO,1032,23048,6,281
2020-05-08,CL,Chile,AMRO,1533,24581,4,285
2020-05-09,CL,Chile,AMRO,1391,25972,9,294
2020-05-10,CL,Chile,AMRO,1247,27219,10,304
2020-05-11,CL,Chile,AMRO,1647,28866,8,312
2020-05-12,CL,Chile,AMRO,1197,30063,11,323
2020-05-13,CL,Chile,AMRO,1658,31721,12,335
2020-05-14,CL,Chile,AMRO,2660,34381,11,346
2020-05-15,CL,Chile,AMRO,2659,37040,22,368
2020-05-16,CL,Chile,AMRO,2502,39542,26,394
2020-05-17,CL,Chile,AMRO,1886,41428,27,421
2020-05-18,CL,Chile,AMRO,2353,43781,29,450
2020-05-19,CL,Chile,AMRO,2278,46059,28,478
2020-05-20,CL,Chile,AMRO,3520,49579,31,509
2020-05-21,CL,Chile,AMRO,4038,53617,35,544
2020-05-22,CL,Chile,AMRO,3964,57581,45,589
2020-05-23,CL,Chile,AMRO,4276,61857,41,630
2020-05-24,CL,Chile,AMRO,3536,65393,43,673
2020-05-25,CL,Chile,AMRO,3709,69102,45,718
2020-05-26,CL,Chile,AMRO,4895,73997,43,761
2020-05-27,CL,Chile,AMRO,3964,77961,45,806
2020-05-28,CL,Chile,AMRO,4328,82289,35,841
2020-05-29,CL,Chile,AMRO,4654,86943,49,890
2020-05-30,CL,Chile,AMRO,3695,90638,54,944
2020-05-31,CL,Chile,AMRO,4220,94858,53,997
2020-06-01,CL,Chile,AMRO,4830,99688,57,1054
2020-06-02,CL,Chile,AMRO,5471,105159,59,1113
2020-06-03,CL,Chile,AMRO,3527,108686,75,1188
2020-06-04,CL,Chile,AMRO,4942,113628,87,1275
2020-06-05,CL,Chile,AMRO,4664,118292,81,1356
2020-06-06,CL,Chile,AMRO,4207,122499,92,1448
2020-06-07,CL,Chile,AMRO,5246,127745,93,1541
2020-06-08,CL,Chile,AMRO,6405,134150,649,2190
2020-03-29,CN,China,WPRO,128,82341,5,3306
2020-03-30,CN,China,WPRO,106,82447,4,3310
2020-03-31,CN,China,WPRO,98,82545,4,3314
2020-04-01,CN,China,WPRO,86,82631,7,3321
2020-04-02,CN,China,WPRO,93,82724,6,3327
2020-04-03,CN,China,WPRO,78,82802,4,3331
2020-04-04,CN,China,WPRO,73,82875,4,3335
2020-04-05,CN,China,WPRO,55,82930,3,3338
2020-04-06,CN,China,WPRO,75,83005,2,3340
2020-04-07,CN,China,WPRO,67,83072,0,3340
2020-04-08,CN,China,WPRO,85,83157,2,3342
2020-04-09,CN,China,WPRO,92,83249,2,3344
2020-04-10,CN,China,WPRO,56,83305,1,3345
2020-04-11,CN,China,WPRO,64,83369,4,3349
2020-04-12,CN,China,WPRO,113,83482,0,3349
2020-04-13,CN,China,WPRO,115,83597,2,3351
2020-04-14,CN,China,WPRO,99,83696,0,3351
2020-04-15,CN,China,WPRO,49,83745,1,3352
2020-04-16,CN,China,WPRO,52,83797,0,3352
2020-04-17,CN,China,WPRO,27,83824,0,3352
2020-04-18,CN,China,WPRO,356,84180,1290,4642
2020-04-19,CN,China,WPRO,21,84201,0,4642
2020-04-20,CN,China,WPRO,36,84237,0,4642
2020-04-21,CN,China,WPRO,13,84250,0,4642
2020-04-22,CN,China,WPRO,37,84287,0,4642
2020-04-23,CN,China,WPRO,15,84302,0,4642
2020-04-24,CN,China,WPRO,9,84311,0,4642
2020-04-25,CN,China,WPRO,13,84324,0,4642
2020-04-26,CN,China,WPRO,14,84338,0,4642
2020-04-27,CN,China,WPRO,3,84341,1,4643
2020-04-28,CN,China,WPRO,6,84347,0,4643
2020-04-29,CN,China,WPRO,22,84369,0,4643
2020-04-30,CN,China,WPRO,4,84373,0,4643
2020-05-01,CN,China,WPRO,12,84385,0,4643
2020-05-02,CN,China,WPRO,3,84388,0,4643
2020-05-03,CN,China,WPRO,5,84393,0,4643
2020-05-04,CN,China,WPRO,7,84400,0,4643
2020-05-05,CN,China,WPRO,4,84404,0,4643
2020-05-06,CN,China,WPRO,2,84406,0,4643
2020-05-07,CN,China,WPRO,3,84409,0,4643
2020-05-08,CN,China,WPRO,6,84415,0,4643
2020-05-09,CN,China,WPRO,1,84416,0,4643
2020-05-10,CN,China,WPRO,14,84430,0,4643
2020-05-11,CN,China,WPRO,20,84450,0,4643
2020-05-12,CN,China,WPRO,1,84451,1,4644
2020-05-13,CN,China,WPRO,7,84458,0,4644
2020-05-14,CN,China,WPRO,6,84464,0,4644
2020-05-15,CN,China,WPRO,5,84469,0,4644
2020-05-16,CN,China,WPRO,9,84478,0,4644
2020-05-17,CN,China,WPRO,6,84484,1,4645
2020-05-18,CN,China,WPRO,10,84494,0,4645
2020-05-19,CN,China,WPRO,6,84500,0,4645
2020-05-20,CN,China,WPRO,5,84505,0,4645
2020-05-21,CN,China,WPRO,2,84507,0,4645
2020-05-22,CN,China,WPRO,13,84520,0,4645
2020-05-23,CN,China,WPRO,2,84522,0,4645
2020-05-24,CN,China,WPRO,3,84525,0,4645
2020-05-25,CN,China,WPRO,11,84536,0,4645
2020-05-26,CN,China,WPRO,7,84543,0,4645
2020-05-27,CN,China,WPRO,1,84544,0,4645
2020-05-28,CN,China,WPRO,3,84547,0,4645
2020-05-29,CN,China,WPRO,0,84547,0,4645
2020-05-30,CN,China,WPRO,18,84565,0,4645
2020-05-31,CN,China,WPRO,5,84570,0,4645
2020-06-01,CN,China,WPRO,18,84588,0,4645
2020-06-02,CN,China,WPRO,9,84597,0,4645
2020-06-03,CN,China,WPRO,5,84602,0,4645
2020-06-04,CN,China,WPRO,1,84603,0,4645
2020-06-05,CN,China,WPRO,11,84614,0,4645
2020-06-06,CN,China,WPRO,6,84620,0,4645
2020-06-07,CN,China,WPRO,9,84629,0,4645
2020-06-08,CN,China,WPRO,5,84634,0,4645
2020-03-29,CO,Colombia,AMRO,232,723,0,6
2020-03-30,CO,Colombia,AMRO,69,792,0,6
2020-03-31,CO,Colombia,AMRO,-90,702,4,10
2020-04-01,CO,Colombia,AMRO,96,798,4,14
2020-04-02,CO,Colombia,AMRO,108,906,2,16
2020-04-03,CO,Colombia,AMRO,159,1065,1,17
2020-04-04,CO,Colombia,AMRO,96,1161,2,19
2020-04-05,CO,Colombia,AMRO,106,1267,6,25
2020-04-06,CO,Colombia,AMRO,139,1406,7,32
2020-04-07,CO,Colombia,AMRO,79,1485,3,35
2020-04-08,CO,Colombia,AMRO,94,1579,11,46
2020-04-09,CO,Colombia,AMRO,201,1780,4,50
2020-04-10,CO,Colombia,AMRO,274,2054,5,55
2020-04-11,CO,Colombia,AMRO,169,2223,14,69
2020-04-12,CO,Colombia,AMRO,250,2473,11,80
2020-04-13,CO,Colombia,AMRO,236,2709,20,100
2020-04-14,CO,Colombia,AMRO,67,2776,9,109
2020-04-15,CO,Colombia,AMRO,76,2852,3,112
2020-04-16,CO,Colombia,AMRO,127,2979,15,127
2020-04-17,CO,Colombia,AMRO,126,3105,4,131
2020-04-18,CO,Colombia,AMRO,128,3233,13,144
2020-04-19,CO,Colombia,AMRO,206,3439,9,153
2020-04-20,CO,Colombia,AMRO,182,3621,13,166
2020-04-21,CO,Colombia,AMRO,171,3792,13,179
2020-04-22,CO,Colombia,AMRO,185,3977,10,189
2020-04-23,CO,Colombia,AMRO,172,4149,7,196
2020-04-24,CO,Colombia,AMRO,207,4356,10,206
2020-04-25,CO,Colombia,AMRO,205,4561,9,215
2020-04-26,CO,Colombia,AMRO,320,4881,10,225
2020-04-27,CO,Colombia,AMRO,261,5142,8,233
2020-04-28,CO,Colombia,AMRO,237,5379,11,244
2020-04-29,CO,Colombia,AMRO,218,5597,9,253
2020-04-30,CO,Colombia,AMRO,352,5949,16,269
2020-05-01,CO,Colombia,AMRO,262,6211,9,278
2020-05-02,CO,Colombia,AMRO,296,6507,15,293
2020-05-03,CO,Colombia,AMRO,499,7006,21,314
2020-05-04,CO,Colombia,AMRO,279,7285,10,324
2020-05-05,CO,Colombia,AMRO,383,7668,16,340
2020-05-06,CO,Colombia,AMRO,305,7973,18,358
2020-05-07,CO,Colombia,AMRO,640,8613,20,378
2020-05-08,CO,Colombia,AMRO,0,8613,0,378
2020-05-09,CO,Colombia,AMRO,843,9456,29,407
2020-05-10,CO,Colombia,AMRO,595,10051,21,428
2020-05-11,CO,Colombia,AMRO,444,10495,17,445
2020-05-12,CO,Colombia,AMRO,568,11063,18,463
2020-05-13,CO,Colombia,AMRO,550,11613,16,479
2020-05-14,CO,Colombia,AMRO,659,12272,14,493
2020-05-15,CO,Colombia,AMRO,658,12930,16,509
2020-05-16,CO,Colombia,AMRO,680,13610,16,525
2020-05-17,CO,Colombia,AMRO,606,14216,21,546
2020-05-18,CO,Colombia,AMRO,723,14939,16,562
2020-05-19,CO,Colombia,AMRO,635,15574,12,574
2020-05-20,CO,Colombia,AMRO,721,16295,18,592
2020-05-21,CO,Colombia,AMRO,640,16935,21,613
2020-05-22,CO,Colombia,AMRO,752,17687,17,630
2020-05-23,CO,Colombia,AMRO,643,18330,22,652
2020-05-24,CO,Colombia,AMRO,801,19131,30,682
2020-05-25,CO,Colombia,AMRO,1046,20177,23,705
2020-05-26,CO,Colombia,AMRO,998,21175,22,727
2020-05-27,CO,Colombia,AMRO,806,21981,23,750
2020-05-28,CO,Colombia,AMRO,1022,23003,26,776
2020-05-29,CO,Colombia,AMRO,1101,24104,27,803
2020-05-30,CO,Colombia,AMRO,1262,25366,19,822
2020-05-31,CO,Colombia,AMRO,1322,26688,31,853
2020-06-01,CO,Colombia,AMRO,1548,28236,37,890
2020-06-02,CO,Colombia,AMRO,1147,29383,49,939
2020-06-03,CO,Colombia,AMRO,1110,30493,30,969
2020-06-04,CO,Colombia,AMRO,1340,31833,40,1009
2020-06-05,CO,Colombia,AMRO,1521,33354,36,1045
2020-06-06,CO,Colombia,AMRO,1766,35120,42,1087
2020-06-07,CO,Colombia,AMRO,1515,36635,58,1145
2020-06-08,CO,Colombia,AMRO,1392,38027,60,1205
2020-03-29,KM,Comoros,AFRO,0,1,0,1
2020-03-30,KM,Comoros,AFRO,0,1,0,1
2020-03-31,KM,Comoros,AFRO,0,1,0,1
2020-04-01,KM,Comoros,AFRO,0,1,0,1
2020-04-02,KM,Comoros,AFRO,0,1,0,1
2020-04-03,KM,Comoros,AFRO,0,1,0,1
2020-04-04,KM,Comoros,AFRO,0,1,0,1
2020-04-05,KM,Comoros,AFRO,0,1,0,1
2020-04-06,KM,Comoros,AFRO,0,1,0,1
2020-04-07,KM,Comoros,AFRO,0,1,0,1
2020-04-08,KM,Comoros,AFRO,0,1,0,1
2020-04-09,KM,Comoros,AFRO,0,1,0,1
2020-04-10,KM,Comoros,AFRO,0,1,0,1
2020-04-11,KM,Comoros,AFRO,0,1,0,1
2020-04-12,KM,Comoros,AFRO,0,1,0,1
2020-04-13,KM,Comoros,AFRO,0,1,0,1
2020-04-14,KM,Comoros,AFRO,0,1,0,1
2020-04-15,KM,Comoros,AFRO,0,1,0,1
2020-04-16,KM,Comoros,AFRO,0,1,0,1
2020-04-17,KM,Comoros,AFRO,0,1,0,1
2020-04-18,KM,Comoros,AFRO,0,1,0,1
2020-04-19,KM,Comoros,AFRO,0,1,0,1
2020-04-20,KM,Comoros,AFRO,0,1,0,1
2020-04-21,KM,Comoros,AFRO,0,1,0,1
2020-04-22,KM,Comoros,AFRO,0,1,0,1
2020-04-23,KM,Comoros,AFRO,0,1,0,1
2020-04-24,KM,Comoros,AFRO,0,1,0,1
2020-04-25,KM,Comoros,AFRO,0,1,0,1
2020-04-26,KM,Comoros,AFRO,0,1,0,1
2020-04-27,KM,Comoros,AFRO,0,1,0,1
2020-04-28,KM,Comoros,AFRO,0,1,0,1
2020-04-29,KM,Comoros,AFRO,0,1,0,1
2020-04-30,KM,Comoros,AFRO,0,1,0,1
2020-05-01,KM,Comoros,AFRO,0,1,0,1
2020-05-02,KM,Comoros,AFRO,0,1,0,1
2020-05-03,KM,Comoros,AFRO,2,3,0,1
2020-05-04,KM,Comoros,AFRO,1,4,0,1
2020-05-05,KM,Comoros,AFRO,0,4,0,1
2020-05-06,KM,Comoros,AFRO,0,4,0,1
2020-05-07,KM,Comoros,AFRO,4,8,0,1
2020-05-08,KM,Comoros,AFRO,0,8,0,1
2020-05-09,KM,Comoros,AFRO,0,8,0,1
2020-05-10,KM,Comoros,AFRO,3,11,0,1
2020-05-11,KM,Comoros,AFRO,0,11,0,1
2020-05-12,KM,Comoros,AFRO,0,11,0,1
2020-05-13,KM,Comoros,AFRO,0,11,0,1
2020-05-14,KM,Comoros,AFRO,0,11,0,1
2020-05-15,KM,Comoros,AFRO,0,11,0,1
2020-05-16,KM,Comoros,AFRO,0,11,0,1
2020-05-17,KM,Comoros,AFRO,0,11,0,1
2020-05-18,KM,Comoros,AFRO,0,11,0,1
2020-05-19,KM,Comoros,AFRO,0,11,0,1
2020-05-20,KM,Comoros,AFRO,23,34,0,1
2020-05-21,KM,Comoros,AFRO,0,34,0,1
2020-05-22,KM,Comoros,AFRO,0,34,0,1
2020-05-23,KM,Comoros,AFRO,0,34,0,1
2020-05-24,KM,Comoros,AFRO,0,34,0,1
2020-05-25,KM,Comoros,AFRO,9,43,0,1
2020-05-26,KM,Comoros,AFRO,0,43,0,1
2020-05-27,KM,Comoros,AFRO,0,43,0,1
2020-05-28,KM,Comoros,AFRO,0,43,1,2
2020-05-29,KM,Comoros,AFRO,0,43,0,2
2020-05-30,KM,Comoros,AFRO,19,62,0,2
2020-05-31,KM,Comoros,AFRO,0,62,0,2
2020-06-01,KM,Comoros,AFRO,0,62,0,2
2020-06-02,KM,Comoros,AFRO,0,62,0,2
2020-06-03,KM,Comoros,AFRO,0,62,0,2
2020-06-04,KM,Comoros,AFRO,0,62,0,2
2020-06-05,KM,Comoros,AFRO,0,62,0,2
2020-06-06,KM,Comoros,AFRO,0,62,0,2
2020-06-07,KM,Comoros,AFRO,9,71,0,2
2020-06-08,KM,Comoros,AFRO,0,71,0,2
2020-03-29,CG,Congo,AFRO,0,19,0,1
2020-03-30,CG,Congo,AFRO,0,19,0,1
2020-03-31,CG,Congo,AFRO,0,19,0,1
2020-04-01,CG,Congo,AFRO,3,22,0,1
2020-04-02,CG,Congo,AFRO,0,22,1,2
2020-04-03,CG,Congo,AFRO,19,41,0,2
2020-04-04,CG,Congo,AFRO,1,42,2,4
2020-04-05,CG,Congo,AFRO,7,49,0,4
2020-04-06,CG,Congo,AFRO,0,49,0,4
2020-04-07,CG,Congo,AFRO,0,49,0,4
2020-04-08,CG,Congo,AFRO,0,49,0,4
2020-04-09,CG,Congo,AFRO,11,60,0,4
2020-04-10,CG,Congo,AFRO,0,60,0,4
2020-04-11,CG,Congo,AFRO,10,70,0,4
2020-04-12,CG,Congo,AFRO,0,70,0,4
2020-04-13,CG,Congo,AFRO,0,70,0,4
2020-04-14,CG,Congo,AFRO,4,74,0,4
2020-04-15,CG,Congo,AFRO,43,117,0,4
2020-04-16,CG,Congo,AFRO,0,117,0,4
2020-04-17,CG,Congo,AFRO,0,117,0,4
2020-04-18,CG,Congo,AFRO,26,143,1,5
2020-04-19,CG,Congo,AFRO,0,143,0,5
2020-04-20,CG,Congo,AFRO,17,160,0,5
2020-04-21,CG,Congo,AFRO,0,160,0,5
2020-04-22,CG,Congo,AFRO,5,165,0,5
2020-04-23,CG,Congo,AFRO,21,186,0,5
2020-04-24,CG,Congo,AFRO,0,186,0,5
2020-04-25,CG,Congo,AFRO,14,200,0,5
2020-04-26,CG,Congo,AFRO,0,200,2,7
2020-04-27,CG,Congo,AFRO,0,200,0,7
2020-04-28,CG,Congo,AFRO,7,207,0,7
2020-04-29,CG,Congo,AFRO,0,207,0,7
2020-04-30,CG,Congo,AFRO,13,220,1,8
2020-05-01,CG,Congo,AFRO,0,220,1,9
2020-05-02,CG,Congo,AFRO,9,229,0,9
2020-05-03,CG,Congo,AFRO,0,229,0,9
2020-05-04,CG,Congo,AFRO,0,229,0,9
2020-05-05,CG,Congo,AFRO,7,236,0,9
2020-05-06,CG,Congo,AFRO,0,236,0,9
2020-05-07,CG,Congo,AFRO,28,264,0,9
2020-05-08,CG,Congo,AFRO,10,274,0,9
2020-05-09,CG,Congo,AFRO,13,287,0,9
2020-05-10,CG,Congo,AFRO,0,287,0,9
2020-05-11,CG,Congo,AFRO,46,333,1,10
2020-05-12,CG,Congo,AFRO,0,333,0,10
2020-05-13,CG,Congo,AFRO,8,341,0,10
2020-05-14,CG,Congo,AFRO,0,341,0,10
2020-05-15,CG,Congo,AFRO,50,391,4,14
2020-05-16,CG,Congo,AFRO,0,391,0,14
2020-05-17,CG,Congo,AFRO,19,410,0,14
2020-05-18,CG,Congo,AFRO,0,410,0,14
2020-05-19,CG,Congo,AFRO,4,414,0,14
2020-05-20,CG,Congo,AFRO,24,438,0,14
2020-05-21,CG,Congo,AFRO,0,438,0,14
2020-05-22,CG,Congo,AFRO,31,469,0,14
2020-05-23,CG,Congo,AFRO,0,469,1,15
2020-05-24,CG,Congo,AFRO,18,487,0,15
2020-05-25,CG,Congo,AFRO,0,487,0,15
2020-05-26,CG,Congo,AFRO,44,531,1,16
2020-05-27,CG,Congo,AFRO,38,569,2,18
2020-05-28,CG,Congo,AFRO,2,571,0,18
2020-05-29,CG,Congo,AFRO,4,575,0,18
2020-05-30,CG,Congo,AFRO,12,587,0,18
2020-05-31,CG,Congo,AFRO,17,604,1,19
2020-06-01,CG,Congo,AFRO,7,611,0,19
2020-06-02,CG,Congo,AFRO,7,618,0,19
2020-06-03,CG,Congo,AFRO,14,632,0,19
2020-06-04,CG,Congo,AFRO,0,632,0,19
2020-06-05,CG,Congo,AFRO,3,635,0,19
2020-06-06,CG,Congo,AFRO,48,683,2,21
2020-06-07,CG,Congo,AFRO,0,683,0,21
2020-06-08,CG,Congo,AFRO,35,718,2,23
2020-03-29,CK,Cook Islands,WPRO,0,0,0,0
2020-03-30,CK,Cook Islands,WPRO,0,0,0,0
2020-03-31,CK,Cook Islands,WPRO,0,0,0,0
2020-04-01,CK,Cook Islands,WPRO,0,0,0,0
2020-04-02,CK,Cook Islands,WPRO,0,0,0,0
2020-04-03,CK,Cook Islands,WPRO,0,0,0,0
2020-04-04,CK,Cook Islands,WPRO,0,0,0,0
2020-04-05,CK,Cook Islands,WPRO,0,0,0,0
2020-04-06,CK,Cook Islands,WPRO,0,0,0,0
2020-04-07,CK,Cook Islands,WPRO,0,0,0,0
2020-04-08,CK,Cook Islands,WPRO,0,0,0,0
2020-04-09,CK,Cook Islands,WPRO,0,0,0,0
2020-04-10,CK,Cook Islands,WPRO,0,0,0,0
2020-04-11,CK,Cook Islands,WPRO,0,0,0,0
2020-04-12,CK,Cook Islands,WPRO,0,0,0,0
2020-04-13,CK,Cook Islands,WPRO,0,0,0,0
2020-04-14,CK,Cook Islands,WPRO,0,0,0,0
2020-04-15,CK,Cook Islands,WPRO,0,0,0,0
2020-04-16,CK,Cook Islands,WPRO,0,0,0,0
2020-04-17,CK,Cook Islands,WPRO,0,0,0,0
2020-04-18,CK,Cook Islands,WPRO,0,0,0,0
2020-04-19,CK,Cook Islands,WPRO,0,0,0,0
2020-04-20,CK,Cook Islands,WPRO,0,0,0,0
2020-04-21,CK,Cook Islands,WPRO,0,0,0,0
2020-04-22,CK,Cook Islands,WPRO,0,0,0,0
2020-04-23,CK,Cook Islands,WPRO,0,0,0,0
2020-04-24,CK,Cook Islands,WPRO,0,0,0,0
2020-04-25,CK,Cook Islands,WPRO,0,0,0,0
2020-04-26,CK,Cook Islands,WPRO,0,0,0,0
2020-04-27,CK,Cook Islands,WPRO,0,0,0,0
2020-04-28,CK,Cook Islands,WPRO,0,0,0,0
2020-04-29,CK,Cook Islands,WPRO,0,0,0,0
2020-04-30,CK,Cook Islands,WPRO,0,0,0,0
2020-05-01,CK,Cook Islands,WPRO,0,0,0,0
2020-05-02,CK,Cook Islands,WPRO,0,0,0,0
2020-05-03,CK,Cook Islands,WPRO,0,0,0,0
2020-05-04,CK,Cook Islands,WPRO,0,0,0,0
2020-05-05,CK,Cook Islands,WPRO,0,0,0,0
2020-05-06,CK,Cook Islands,WPRO,0,0,0,0
2020-05-07,CK,Cook Islands,WPRO,0,0,0,0
2020-05-08,CK,Cook Islands,WPRO,0,0,0,0
2020-05-09,CK,Cook Islands,WPRO,0,0,0,0
2020-05-10,CK,Cook Islands,WPRO,0,0,0,0
2020-05-11,CK,Cook Islands,WPRO,0,0,0,0
2020-05-12,CK,Cook Islands,WPRO,0,0,0,0
2020-05-13,CK,Cook Islands,WPRO,0,0,0,0
2020-05-14,CK,Cook Islands,WPRO,0,0,0,0
2020-05-15,CK,Cook Islands,WPRO,0,0,0,0
2020-05-16,CK,Cook Islands,WPRO,0,0,0,0
2020-05-17,CK,Cook Islands,WPRO,0,0,0,0
2020-05-18,CK,Cook Islands,WPRO,0,0,0,0
2020-05-19,CK,Cook Islands,WPRO,0,0,0,0
2020-05-20,CK,Cook Islands,WPRO,0,0,0,0
2020-05-21,CK,Cook Islands,WPRO,0,0,0,0
2020-05-22,CK,Cook Islands,WPRO,0,0,0,0
2020-05-23,CK,Cook Islands,WPRO,0,0,0,0
2020-05-24,CK,Cook Islands,WPRO,0,0,0,0
2020-05-25,CK,Cook Islands,WPRO,0,0,0,0
2020-05-26,CK,Cook Islands,WPRO,0,0,0,0
2020-05-27,CK,Cook Islands,WPRO,0,0,0,0
2020-05-28,CK,Cook Islands,WPRO,0,0,0,0
2020-05-29,CK,Cook Islands,WPRO,0,0,0,0
2020-05-30,CK,Cook Islands,WPRO,0,0,0,0
2020-05-31,CK,Cook Islands,WPRO,0,0,0,0
2020-06-01,CK,Cook Islands,WPRO,0,0,0,0
2020-06-02,CK,Cook Islands,WPRO,0,0,0,0
2020-06-03,CK,Cook Islands,WPRO,0,0,0,0
2020-06-04,CK,Cook Islands,WPRO,0,0,0,0
2020-06-05,CK,Cook Islands,WPRO,0,0,0,0
2020-06-06,CK,Cook Islands,WPRO,0,0,0,0
2020-06-07,CK,Cook Islands,WPRO,0,0,0,0
2020-06-08,CK,Cook Islands,WPRO,0,0,0,0
2020-03-29,CR,Costa Rica,AMRO,32,263,0,2
2020-03-30,CR,Costa Rica,AMRO,32,295,0,2
2020-03-31,CR,Costa Rica,AMRO,19,314,0,2
2020-04-01,CR,Costa Rica,AMRO,16,330,0,2
2020-04-02,CR,Costa Rica,AMRO,17,347,0,2
2020-04-03,CR,Costa Rica,AMRO,28,375,0,2
2020-04-04,CR,Costa Rica,AMRO,21,396,0,2
2020-04-05,CR,Costa Rica,AMRO,20,416,0,2
2020-04-06,CR,Costa Rica,AMRO,19,435,0,2
2020-04-07,CR,Costa Rica,AMRO,19,454,0,2
2020-04-08,CR,Costa Rica,AMRO,13,467,0,2
2020-04-09,CR,Costa Rica,AMRO,16,483,0,2
2020-04-10,CR,Costa Rica,AMRO,19,502,0,2
2020-04-11,CR,Costa Rica,AMRO,37,539,1,3
2020-04-12,CR,Costa Rica,AMRO,19,558,0,3
2020-04-13,CR,Costa Rica,AMRO,19,577,0,3
2020-04-14,CR,Costa Rica,AMRO,18,595,0,3
2020-04-15,CR,Costa Rica,AMRO,17,612,0,3
2020-04-16,CR,Costa Rica,AMRO,6,618,0,3
2020-04-17,CR,Costa Rica,AMRO,8,626,1,4
2020-04-18,CR,Costa Rica,AMRO,16,642,0,4
2020-04-19,CR,Costa Rica,AMRO,7,649,0,4
2020-04-20,CR,Costa Rica,AMRO,6,655,0,4
2020-04-21,CR,Costa Rica,AMRO,5,660,0,4
2020-04-22,CR,Costa Rica,AMRO,2,662,2,6
2020-04-23,CR,Costa Rica,AMRO,7,669,0,6
2020-04-24,CR,Costa Rica,AMRO,12,681,0,6
2020-04-25,CR,Costa Rica,AMRO,5,686,0,6
2020-04-26,CR,Costa Rica,AMRO,1,687,0,6
2020-04-27,CR,Costa Rica,AMRO,6,693,0,6
2020-04-28,CR,Costa Rica,AMRO,2,695,0,6
2020-04-29,CR,Costa Rica,AMRO,2,697,0,6
2020-04-30,CR,Costa Rica,AMRO,8,705,0,6
2020-05-01,CR,Costa Rica,AMRO,8,713,0,6
2020-05-02,CR,Costa Rica,AMRO,6,719,0,6
2020-05-03,CR,Costa Rica,AMRO,6,725,0,6
2020-05-04,CR,Costa Rica,AMRO,8,733,0,6
2020-05-05,CR,Costa Rica,AMRO,6,739,0,6
2020-05-06,CR,Costa Rica,AMRO,3,742,0,6
2020-05-07,CR,Costa Rica,AMRO,13,755,0,6
2020-05-08,CR,Costa Rica,AMRO,6,761,0,6
2020-05-09,CR,Costa Rica,AMRO,4,765,0,6
2020-05-10,CR,Costa Rica,AMRO,8,773,0,6
2020-05-11,CR,Costa Rica,AMRO,7,780,0,6
2020-05-12,CR,Costa Rica,AMRO,12,792,0,6
2020-05-13,CR,Costa Rica,AMRO,9,801,1,7
2020-05-14,CR,Costa Rica,AMRO,3,804,0,7
2020-05-15,CR,Costa Rica,AMRO,11,815,0,7
2020-05-16,CR,Costa Rica,AMRO,15,830,1,8
2020-05-17,CR,Costa Rica,AMRO,13,843,0,8
2020-05-18,CR,Costa Rica,AMRO,10,853,2,10
2020-05-19,CR,Costa Rica,AMRO,10,863,0,10
2020-05-20,CR,Costa Rica,AMRO,3,866,0,10
2020-05-21,CR,Costa Rica,AMRO,16,882,0,10
2020-05-22,CR,Costa Rica,AMRO,15,897,0,10
2020-05-23,CR,Costa Rica,AMRO,6,903,0,10
2020-05-24,CR,Costa Rica,AMRO,8,911,0,10
2020-05-25,CR,Costa Rica,AMRO,7,918,0,10
2020-05-26,CR,Costa Rica,AMRO,12,930,0,10
2020-05-27,CR,Costa Rica,AMRO,21,951,0,10
2020-05-28,CR,Costa Rica,AMRO,5,956,0,10
2020-05-29,CR,Costa Rica,AMRO,28,984,0,10
2020-05-30,CR,Costa Rica,AMRO,16,1000,0,10
2020-05-31,CR,Costa Rica,AMRO,22,1022,0,10
2020-06-01,CR,Costa Rica,AMRO,25,1047,0,10
2020-06-02,CR,Costa Rica,AMRO,9,1056,0,10
2020-06-03,CR,Costa Rica,AMRO,28,1084,0,10
2020-06-04,CR,Costa Rica,AMRO,21,1105,0,10
2020-06-05,CR,Costa Rica,AMRO,52,1157,0,10
2020-06-06,CR,Costa Rica,AMRO,37,1194,0,10
2020-06-07,CR,Costa Rica,AMRO,34,1228,0,10
2020-06-08,CR,Costa Rica,AMRO,35,1263,0,10
2020-03-29,CI,Côte d’Ivoire,AFRO,5,178,0,2
2020-03-30,CI,Côte d’Ivoire,AFRO,8,186,0,2
2020-03-31,CI,Côte d’Ivoire,AFRO,13,199,0,2
2020-04-01,CI,Côte d’Ivoire,AFRO,16,215,0,2
2020-04-02,CI,Côte d’Ivoire,AFRO,12,227,0,2
2020-04-03,CI,Côte d’Ivoire,AFRO,26,253,0,2
2020-04-04,CI,Côte d’Ivoire,AFRO,16,269,0,2
2020-04-05,CI,Côte d’Ivoire,AFRO,69,338,2,4
2020-04-06,CI,Côte d’Ivoire,AFRO,24,362,0,4
2020-04-07,CI,Côte d’Ivoire,AFRO,33,395,0,4
2020-04-08,CI,Côte d’Ivoire,AFRO,52,447,0,4
2020-04-09,CI,Côte d’Ivoire,AFRO,40,487,0,4
2020-04-10,CI,Côte d’Ivoire,AFRO,51,538,0,4
2020-04-11,CI,Côte d’Ivoire,AFRO,41,579,0,4
2020-04-12,CI,Côte d’Ivoire,AFRO,49,628,1,5
2020-04-13,CI,Côte d’Ivoire,AFRO,9,637,1,6
2020-04-14,CI,Côte d’Ivoire,AFRO,17,654,1,7
2020-04-15,CI,Côte d’Ivoire,AFRO,32,686,0,7
2020-04-16,CI,Côte d’Ivoire,AFRO,51,737,0,7
2020-04-17,CI,Côte d’Ivoire,AFRO,57,794,0,7
2020-04-18,CI,Côte d’Ivoire,AFRO,50,844,0,7
2020-04-19,CI,Côte d’Ivoire,AFRO,24,868,2,9
2020-04-20,CI,Côte d’Ivoire,AFRO,41,909,1,10
2020-04-21,CI,Côte d’Ivoire,AFRO,60,969,2,12
2020-04-22,CI,Côte d’Ivoire,AFRO,44,1013,2,14
2020-04-23,CI,Côte d’Ivoire,AFRO,55,1068,1,15
2020-04-24,CI,Côte d’Ivoire,AFRO,50,1118,0,15
2020-04-25,CI,Côte d’Ivoire,AFRO,32,1150,0,15
2020-04-26,CI,Côte d’Ivoire,AFRO,0,1150,0,15
2020-04-27,CI,Côte d’Ivoire,AFRO,0,1150,0,15
2020-04-28,CI,Côte d’Ivoire,AFRO,14,1164,0,15
2020-04-29,CI,Côte d’Ivoire,AFRO,19,1183,0,15
2020-04-30,CI,Côte d’Ivoire,AFRO,55,1238,0,15
2020-05-01,CI,Côte d’Ivoire,AFRO,37,1275,0,15
2020-05-02,CI,Côte d’Ivoire,AFRO,58,1333,1,16
2020-05-03,CI,Côte d’Ivoire,AFRO,29,1362,0,16
2020-05-04,CI,Côte d’Ivoire,AFRO,36,1398,2,18
2020-05-05,CI,Côte d’Ivoire,AFRO,34,1432,0,18
2020-05-06,CI,Côte d’Ivoire,AFRO,32,1464,1,19
2020-05-07,CI,Côte d’Ivoire,AFRO,52,1516,0,19
2020-05-08,CI,Côte d’Ivoire,AFRO,55,1571,2,21
2020-05-09,CI,Côte d’Ivoire,AFRO,31,1602,0,21
2020-05-10,CI,Côte d’Ivoire,AFRO,65,1667,1,22
2020-05-11,CI,Côte d’Ivoire,AFRO,33,1700,0,22
2020-05-12,CI,Côte d’Ivoire,AFRO,30,1730,0,22
2020-05-13,CI,Côte d’Ivoire,AFRO,127,1857,0,22
2020-05-14,CI,Côte d’Ivoire,AFRO,55,1912,3,25
2020-05-15,CI,Côte d’Ivoire,AFRO,59,1971,0,25
2020-05-16,CI,Côte d’Ivoire,AFRO,46,2017,0,25
2020-05-17,CI,Côte d’Ivoire,AFRO,44,2061,1,26
2020-05-18,CI,Côte d’Ivoire,AFRO,48,2109,2,28
2020-05-19,CI,Côte d’Ivoire,AFRO,10,2119,1,29
2020-05-20,CI,Côte d’Ivoire,AFRO,34,2153,0,29
2020-05-21,CI,Côte d’Ivoire,AFRO,78,2231,1,30
2020-05-22,CI,Côte d’Ivoire,AFRO,70,2301,0,30
2020-05-23,CI,Côte d’Ivoire,AFRO,40,2341,0,30
2020-05-24,CI,Côte d’Ivoire,AFRO,25,2366,1,31
2020-05-25,CI,Côte d’Ivoire,AFRO,10,2376,0,31
2020-05-26,CI,Côte d’Ivoire,AFRO,47,2423,0,31
2020-05-27,CI,Côte d’Ivoire,AFRO,54,2477,0,31
2020-05-28,CI,Côte d’Ivoire,AFRO,79,2556,1,32
2020-05-29,CI,Côte d’Ivoire,AFRO,85,2641,1,33
2020-05-30,CI,Côte d’Ivoire,AFRO,109,2750,0,33
2020-05-31,CI,Côte d’Ivoire,AFRO,49,2799,1,34
2020-06-01,CI,Côte d’Ivoire,AFRO,34,2833,0,34
2020-06-02,CI,Côte d’Ivoire,AFRO,118,2951,0,34
2020-06-03,CI,Côte d’Ivoire,AFRO,73,3024,0,34
2020-06-04,CI,Côte d’Ivoire,AFRO,86,3110,2,36
2020-06-05,CI,Côte d’Ivoire,AFRO,152,3262,0,36
2020-06-06,CI,Côte d’Ivoire,AFRO,169,3431,1,37
2020-06-07,CI,Côte d’Ivoire,AFRO,126,3557,0,37
2020-06-08,CI,Côte d’Ivoire,AFRO,182,3739,0,37
2020-03-29,HR,Croatia,EURO,71,657,2,5
2020-03-30,HR,Croatia,EURO,56,713,1,6
2020-03-31,HR,Croatia,EURO,77,790,0,6
2020-04-01,HR,Croatia,EURO,77,867,0,6
2020-04-02,HR,Croatia,EURO,96,963,0,6
2020-04-03,HR,Croatia,EURO,48,1011,1,7
2020-04-04,HR,Croatia,EURO,68,1079,1,8
2020-04-05,HR,Croatia,EURO,47,1126,4,12
2020-04-06,HR,Croatia,EURO,56,1182,3,15
2020-04-07,HR,Croatia,EURO,40,1222,1,16
2020-04-08,HR,Croatia,EURO,60,1282,2,18
2020-04-09,HR,Croatia,EURO,61,1343,1,19
2020-04-10,HR,Croatia,EURO,64,1407,1,20
2020-04-11,HR,Croatia,EURO,88,1495,1,21
2020-04-12,HR,Croatia,EURO,39,1534,0,21
2020-04-13,HR,Croatia,EURO,66,1600,2,23
2020-04-14,HR,Croatia,EURO,50,1650,2,25
2020-04-15,HR,Croatia,EURO,54,1704,6,31
2020-04-16,HR,Croatia,EURO,37,1741,2,33
2020-04-17,HR,Croatia,EURO,50,1791,2,35
2020-04-18,HR,Croatia,EURO,23,1814,1,36
2020-04-19,HR,Croatia,EURO,18,1832,3,39
2020-04-20,HR,Croatia,EURO,39,1871,8,47
2020-04-21,HR,Croatia,EURO,10,1881,0,47
2020-04-22,HR,Croatia,EURO,27,1908,1,48
2020-04-23,HR,Croatia,EURO,42,1950,0,48
2020-04-24,HR,Croatia,EURO,31,1981,2,50
2020-04-25,HR,Croatia,EURO,28,2009,1,51
2020-04-26,HR,Croatia,EURO,7,2016,3,54
2020-04-27,HR,Croatia,EURO,14,2030,1,55
2020-04-28,HR,Croatia,EURO,9,2039,4,59
2020-04-29,HR,Croatia,EURO,8,2047,4,63
2020-04-30,HR,Croatia,EURO,15,2062,4,67
2020-05-01,HR,Croatia,EURO,14,2076,2,69
2020-05-02,HR,Croatia,EURO,9,2085,6,75
2020-05-03,HR,Croatia,EURO,3,2088,2,77
2020-05-04,HR,Croatia,EURO,8,2096,2,79
2020-05-05,HR,Croatia,EURO,5,2101,1,80
2020-05-06,HR,Croatia,EURO,11,2112,3,83
2020-05-07,HR,Croatia,EURO,7,2119,2,85
2020-05-08,HR,Croatia,EURO,6,2125,1,86
2020-05-09,HR,Croatia,EURO,36,2161,0,86
2020-05-10,HR,Croatia,EURO,15,2176,1,87
2020-05-11,HR,Croatia,EURO,11,2187,3,90
2020-05-12,HR,Croatia,EURO,9,2196,1,91
2020-05-13,HR,Croatia,EURO,11,2207,0,91
2020-05-14,HR,Croatia,EURO,6,2213,3,94
2020-05-15,HR,Croatia,EURO,8,2221,0,94
2020-05-16,HR,Croatia,EURO,1,2222,1,95
2020-05-17,HR,Croatia,EURO,2,2224,0,95
2020-05-18,HR,Croatia,EURO,2,2226,0,95
2020-05-19,HR,Croatia,EURO,2,2228,0,95
2020-05-20,HR,Croatia,EURO,4,2232,1,96
2020-05-21,HR,Croatia,EURO,2,2234,0,96
2020-05-22,HR,Croatia,EURO,3,2237,1,97
2020-05-23,HR,Croatia,EURO,6,2243,2,99
2020-05-24,HR,Croatia,EURO,0,2243,0,99
2020-05-25,HR,Croatia,EURO,1,2244,0,99
2020-05-26,HR,Croatia,EURO,0,2244,1,100
2020-05-27,HR,Croatia,EURO,0,2244,1,101
2020-05-28,HR,Croatia,EURO,0,2244,0,101
2020-05-29,HR,Croatia,EURO,1,2245,1,102
2020-05-30,HR,Croatia,EURO,0,2245,1,103
2020-05-31,HR,Croatia,EURO,1,2246,0,103
2020-06-01,HR,Croatia,EURO,0,2246,0,103
2020-06-02,HR,Croatia,EURO,0,2246,0,103
2020-06-03,HR,Croatia,EURO,0,2246,0,103
2020-06-04,HR,Croatia,EURO,0,2246,0,103
2020-06-05,HR,Croatia,EURO,1,2247,0,103
2020-06-06,HR,Croatia,EURO,0,2247,0,103
2020-06-07,HR,Croatia,EURO,0,2247,1,104
2020-06-08,HR,Croatia,EURO,0,2247,0,104
2020-03-29,CU,Cuba,AMRO,39,119,1,3
2020-03-30,CU,Cuba,AMRO,20,139,0,3
2020-03-31,CU,Cuba,AMRO,31,170,1,4
2020-04-01,CU,Cuba,AMRO,16,186,2,6
2020-04-02,CU,Cuba,AMRO,26,212,0,6
2020-04-03,CU,Cuba,AMRO,21,233,0,6
2020-04-04,CU,Cuba,AMRO,36,269,0,6
2020-04-05,CU,Cuba,AMRO,19,288,0,6
2020-04-06,CU,Cuba,AMRO,32,320,2,8
2020-04-07,CU,Cuba,AMRO,30,350,1,9
2020-04-08,CU,Cuba,AMRO,46,396,2,11
2020-04-09,CU,Cuba,AMRO,61,457,1,12
2020-04-10,CU,Cuba,AMRO,58,515,3,15
2020-04-11,CU,Cuba,AMRO,49,564,0,15
2020-04-12,CU,Cuba,AMRO,56,620,1,16
2020-04-13,CU,Cuba,AMRO,49,669,2,18
2020-04-14,CU,Cuba,AMRO,57,726,3,21
2020-04-15,CU,Cuba,AMRO,40,766,0,21
2020-04-16,CU,Cuba,AMRO,48,814,3,24
2020-04-17,CU,Cuba,AMRO,48,862,3,27
2020-04-18,CU,Cuba,AMRO,61,923,4,31
2020-04-19,CU,Cuba,AMRO,63,986,1,32
2020-04-20,CU,Cuba,AMRO,49,1035,2,34
2020-04-21,CU,Cuba,AMRO,52,1087,2,36
2020-04-22,CU,Cuba,AMRO,50,1137,2,38
2020-04-23,CU,Cuba,AMRO,52,1189,2,40
2020-04-24,CU,Cuba,AMRO,46,1235,3,43
2020-04-25,CU,Cuba,AMRO,50,1285,6,49
2020-04-26,CU,Cuba,AMRO,52,1337,2,51
2020-04-27,CU,Cuba,AMRO,32,1369,3,54
2020-04-28,CU,Cuba,AMRO,20,1389,2,56
2020-04-29,CU,Cuba,AMRO,48,1437,2,58
2020-04-30,CU,Cuba,AMRO,30,1467,0,58
2020-05-01,CU,Cuba,AMRO,34,1501,3,61
2020-05-02,CU,Cuba,AMRO,36,1537,3,64
2020-05-03,CU,Cuba,AMRO,74,1611,2,66
2020-05-04,CU,Cuba,AMRO,38,1649,1,67
2020-05-05,CU,Cuba,AMRO,19,1668,2,69
2020-05-06,CU,Cuba,AMRO,17,1685,0,69
2020-05-07,CU,Cuba,AMRO,18,1703,0,69
2020-05-08,CU,Cuba,AMRO,26,1729,4,73
2020-05-09,CU,Cuba,AMRO,12,1741,1,74
2020-05-10,CU,Cuba,AMRO,13,1754,0,74
2020-05-11,CU,Cuba,AMRO,12,1766,3,77
2020-05-12,CU,Cuba,AMRO,17,1783,0,77
2020-05-13,CU,Cuba,AMRO,21,1804,1,78
2020-05-14,CU,Cuba,AMRO,6,1810,1,79
2020-05-15,CU,Cuba,AMRO,20,1830,0,79
2020-05-16,CU,Cuba,AMRO,10,1840,0,79
2020-05-17,CU,Cuba,AMRO,22,1862,0,79
2020-05-18,CU,Cuba,AMRO,10,1872,0,79
2020-05-19,CU,Cuba,AMRO,9,1881,0,79
2020-05-20,CU,Cuba,AMRO,6,1887,0,79
2020-05-21,CU,Cuba,AMRO,13,1900,0,79
2020-05-22,CU,Cuba,AMRO,8,1908,1,80
2020-05-23,CU,Cuba,AMRO,8,1916,1,81
2020-05-24,CU,Cuba,AMRO,15,1931,0,81
2020-05-25,CU,Cuba,AMRO,10,1941,1,82
2020-05-26,CU,Cuba,AMRO,6,1947,0,82
2020-05-27,CU,Cuba,AMRO,16,1963,0,82
2020-05-28,CU,Cuba,AMRO,11,1974,0,82
2020-05-29,CU,Cuba,AMRO,9,1983,0,82
2020-05-30,CU,Cuba,AMRO,22,2005,0,82
2020-05-31,CU,Cuba,AMRO,20,2025,1,83
2020-06-01,CU,Cuba,AMRO,20,2045,0,83
2020-06-02,CU,Cuba,AMRO,38,2083,0,83
2020-06-03,CU,Cuba,AMRO,9,2092,0,83
2020-06-04,CU,Cuba,AMRO,15,2107,0,83
2020-06-05,CU,Cuba,AMRO,12,2119,0,83
2020-06-06,CU,Cuba,AMRO,14,2133,0,83
2020-06-07,CU,Cuba,AMRO,40,2173,0,83
2020-06-08,CU,Cuba,AMRO,18,2191,0,83
2020-03-29,CW,Curaçao,AMRO,0,7,0,1
2020-03-30,CW,Curaçao,AMRO,0,7,0,1
2020-03-31,CW,Curaçao,AMRO,4,11,0,1
2020-04-01,CW,Curaçao,AMRO,0,11,0,1
2020-04-02,CW,Curaçao,AMRO,0,11,0,1
2020-04-03,CW,Curaçao,AMRO,0,11,0,1
2020-04-04,CW,Curaçao,AMRO,0,11,0,1
2020-04-05,CW,Curaçao,AMRO,0,11,0,1
2020-04-06,CW,Curaçao,AMRO,0,11,0,1
2020-04-07,CW,Curaçao,AMRO,2,13,0,1
2020-04-08,CW,Curaçao,AMRO,0,13,0,1
2020-04-09,CW,Curaçao,AMRO,1,14,0,1
2020-04-10,CW,Curaçao,AMRO,0,14,0,1
2020-04-11,CW,Curaçao,AMRO,0,14,0,1
2020-04-12,CW,Curaçao,AMRO,0,14,0,1
2020-04-13,CW,Curaçao,AMRO,0,14,0,1
2020-04-14,CW,Curaçao,AMRO,0,14,0,1
2020-04-15,CW,Curaçao,AMRO,0,14,0,1
2020-04-16,CW,Curaçao,AMRO,0,14,0,1
2020-04-17,CW,Curaçao,AMRO,0,14,0,1
2020-04-18,CW,Curaçao,AMRO,0,14,0,1
2020-04-19,CW,Curaçao,AMRO,0,14,0,1
2020-04-20,CW,Curaçao,AMRO,0,14,0,1
2020-04-21,CW,Curaçao,AMRO,0,14,0,1
2020-04-22,CW,Curaçao,AMRO,0,14,0,1
2020-04-23,CW,Curaçao,AMRO,0,14,0,1
2020-04-24,CW,Curaçao,AMRO,0,14,0,1
2020-04-25,CW,Curaçao,AMRO,0,14,0,1
2020-04-26,CW,Curaçao,AMRO,0,14,0,1
2020-04-27,CW,Curaçao,AMRO,0,14,0,1
2020-04-28,CW,Curaçao,AMRO,2,16,0,1
2020-04-29,CW,Curaçao,AMRO,0,16,0,1
2020-04-30,CW,Curaçao,AMRO,0,16,0,1
2020-05-01,CW,Curaçao,AMRO,0,16,0,1
2020-05-02,CW,Curaçao,AMRO,0,16,0,1
2020-05-03,CW,Curaçao,AMRO,0,16,0,1
2020-05-04,CW,Curaçao,AMRO,0,16,0,1
2020-05-05,CW,Curaçao,AMRO,0,16,0,1
2020-05-06,CW,Curaçao,AMRO,0,16,0,1
2020-05-07,CW,Curaçao,AMRO,0,16,0,1
2020-05-08,CW,Curaçao,AMRO,0,16,0,1
2020-05-09,CW,Curaçao,AMRO,0,16,0,1
2020-05-10,CW,Curaçao,AMRO,0,16,0,1
2020-05-11,CW,Curaçao,AMRO,0,16,0,1
2020-05-12,CW,Curaçao,AMRO,0,16,0,1
2020-05-13,CW,Curaçao,AMRO,0,16,0,1
2020-05-14,CW,Curaçao,AMRO,0,16,0,1
2020-05-15,CW,Curaçao,AMRO,0,16,0,1
2020-05-16,CW,Curaçao,AMRO,0,16,0,1
2020-05-17,CW,Curaçao,AMRO,0,16,0,1
2020-05-18,CW,Curaçao,AMRO,0,16,0,1
2020-05-19,CW,Curaçao,AMRO,0,16,0,1
2020-05-20,CW,Curaçao,AMRO,0,16,0,1
2020-05-21,CW,Curaçao,AMRO,0,16,0,1
2020-05-22,CW,Curaçao,AMRO,0,16,0,1
2020-05-23,CW,Curaçao,AMRO,0,16,0,1
2020-05-24,CW,Curaçao,AMRO,0,16,0,1
2020-05-25,CW,Curaçao,AMRO,1,17,0,1
2020-05-26,CW,Curaçao,AMRO,0,17,0,1
2020-05-27,CW,Curaçao,AMRO,1,18,0,1
2020-05-28,CW,Curaçao,AMRO,0,18,0,1
2020-05-29,CW,Curaçao,AMRO,2,20,0,1
2020-05-30,CW,Curaçao,AMRO,0,20,0,1
2020-05-31,CW,Curaçao,AMRO,0,20,0,1
2020-06-01,CW,Curaçao,AMRO,0,20,0,1
2020-06-02,CW,Curaçao,AMRO,0,20,0,1
2020-06-03,CW,Curaçao,AMRO,0,20,0,1
2020-06-04,CW,Curaçao,AMRO,0,20,0,1
2020-06-05,CW,Curaçao,AMRO,1,21,0,1
2020-06-06,CW,Curaçao,AMRO,0,21,0,1
2020-06-07,CW,Curaçao,AMRO,0,21,0,1
2020-06-08,CW,Curaçao,AMRO,0,21,0,1
2020-03-29,CY,Cyprus,EURO,17,179,0,5
2020-03-30,CY,Cyprus,EURO,35,214,1,6
2020-03-31,CY,Cyprus,EURO,16,230,1,7
2020-04-01,CY,Cyprus,EURO,32,262,1,8
2020-04-02,CY,Cyprus,EURO,58,320,1,9
2020-04-03,CY,Cyprus,EURO,36,356,0,9
2020-04-04,CY,Cyprus,EURO,40,396,0,9
2020-04-05,CY,Cyprus,EURO,30,426,0,9
2020-04-06,CY,Cyprus,EURO,20,446,0,9
2020-04-07,CY,Cyprus,EURO,19,465,0,9
2020-04-08,CY,Cyprus,EURO,29,494,0,9
2020-04-09,CY,Cyprus,EURO,32,526,0,9
2020-04-10,CY,Cyprus,EURO,38,564,1,10
2020-04-11,CY,Cyprus,EURO,31,595,0,10
2020-04-12,CY,Cyprus,EURO,21,616,0,10
2020-04-13,CY,Cyprus,EURO,17,633,1,11
2020-04-14,CY,Cyprus,EURO,29,662,1,12
2020-04-15,CY,Cyprus,EURO,33,695,0,12
2020-04-16,CY,Cyprus,EURO,20,715,0,12
2020-04-17,CY,Cyprus,EURO,20,735,0,12
2020-04-18,CY,Cyprus,EURO,0,735,0,12
2020-04-19,CY,Cyprus,EURO,26,761,0,12
2020-04-20,CY,Cyprus,EURO,6,767,0,12
2020-04-21,CY,Cyprus,EURO,5,772,0,12
2020-04-22,CY,Cyprus,EURO,12,784,0,12
2020-04-23,CY,Cyprus,EURO,6,790,2,14
2020-04-24,CY,Cyprus,EURO,5,795,0,14
2020-04-25,CY,Cyprus,EURO,9,804,0,14
2020-04-26,CY,Cyprus,EURO,6,810,0,14
2020-04-27,CY,Cyprus,EURO,7,817,0,14
2020-04-28,CY,Cyprus,EURO,5,822,1,15
2020-04-29,CY,Cyprus,EURO,15,837,0,15
2020-04-30,CY,Cyprus,EURO,6,843,0,15
2020-05-01,CY,Cyprus,EURO,7,850,0,15
2020-05-02,CY,Cyprus,EURO,7,857,0,15
2020-05-03,CY,Cyprus,EURO,7,864,0,15
2020-05-04,CY,Cyprus,EURO,8,872,0,15
2020-05-05,CY,Cyprus,EURO,2,874,0,15
2020-05-06,CY,Cyprus,EURO,4,878,0,15
2020-05-07,CY,Cyprus,EURO,5,883,0,15
2020-05-08,CY,Cyprus,EURO,6,889,0,15
2020-05-09,CY,Cyprus,EURO,2,891,0,15
2020-05-10,CY,Cyprus,EURO,1,892,0,15
2020-05-11,CY,Cyprus,EURO,6,898,1,16
2020-05-12,CY,Cyprus,EURO,3,901,0,16
2020-05-13,CY,Cyprus,EURO,2,903,0,16
2020-05-14,CY,Cyprus,EURO,2,905,1,17
2020-05-15,CY,Cyprus,EURO,2,907,0,17
2020-05-16,CY,Cyprus,EURO,3,910,0,17
2020-05-17,CY,Cyprus,EURO,4,914,0,17
2020-05-18,CY,Cyprus,EURO,2,916,0,17
2020-05-19,CY,Cyprus,EURO,1,917,0,17
2020-05-20,CY,Cyprus,EURO,1,918,0,17
2020-05-21,CY,Cyprus,EURO,4,922,0,17
2020-05-22,CY,Cyprus,EURO,1,923,0,17
2020-05-23,CY,Cyprus,EURO,4,927,0,17
2020-05-24,CY,Cyprus,EURO,0,927,0,17
2020-05-25,CY,Cyprus,EURO,8,935,0,17
2020-05-26,CY,Cyprus,EURO,2,937,0,17
2020-05-27,CY,Cyprus,EURO,2,939,0,17
2020-05-28,CY,Cyprus,EURO,0,939,0,17
2020-05-29,CY,Cyprus,EURO,2,941,0,17
2020-05-30,CY,Cyprus,EURO,0,941,0,17
2020-05-31,CY,Cyprus,EURO,2,943,0,17
2020-06-01,CY,Cyprus,EURO,1,944,0,17
2020-06-02,CY,Cyprus,EURO,5,949,0,17
2020-06-03,CY,Cyprus,EURO,3,952,0,17
2020-06-04,CY,Cyprus,EURO,6,958,0,17
2020-06-05,CY,Cyprus,EURO,0,958,0,17
2020-06-06,CY,Cyprus,EURO,2,960,0,17
2020-06-07,CY,Cyprus,EURO,0,960,1,18
2020-06-08,CY,Cyprus,EURO,4,964,0,18
2020-03-29,CZ,Czechia,EURO,264,2683,5,17
2020-03-30,CZ,Czechia,EURO,159,2842,6,23
2020-03-31,CZ,Czechia,EURO,184,3026,5,28
2020-04-01,CZ,Czechia,EURO,308,3334,7,35
2020-04-02,CZ,Czechia,EURO,284,3618,8,43
2020-04-03,CZ,Czechia,EURO,268,3886,6,49
2020-04-04,CZ,Czechia,EURO,334,4220,8,57
2020-04-05,CZ,Czechia,EURO,284,4504,9,66
2020-04-06,CZ,Czechia,EURO,118,4622,8,74
2020-04-07,CZ,Czechia,EURO,237,4859,8,82
2020-04-08,CZ,Czechia,EURO,196,5055,10,92
2020-04-09,CZ,Czechia,EURO,294,5349,15,107
2020-04-10,CZ,Czechia,EURO,259,5608,10,117
2020-04-11,CZ,Czechia,EURO,163,5771,11,128
2020-04-12,CZ,Czechia,EURO,171,5942,8,136
2020-04-13,CZ,Czechia,EURO,89,6031,10,146
2020-04-14,CZ,Czechia,EURO,68,6099,11,157
2020-04-15,CZ,Czechia,EURO,82,6181,9,166
2020-04-16,CZ,Czechia,EURO,160,6341,0,166
2020-04-17,CZ,Czechia,EURO,134,6475,2,168
2020-04-18,CZ,Czechia,EURO,116,6591,8,176
2020-04-19,CZ,Czechia,EURO,105,6696,4,180
2020-04-20,CZ,Czechia,EURO,93,6789,9,189
2020-04-21,CZ,Czechia,EURO,154,6943,7,196
2020-04-22,CZ,Czechia,EURO,133,7076,8,204
2020-04-23,CZ,Czechia,EURO,99,7175,2,206
2020-04-24,CZ,Czechia,EURO,57,7232,6,212
2020-04-25,CZ,Czechia,EURO,86,7318,6,218
2020-04-26,CZ,Czechia,EURO,79,7397,4,222
2020-04-27,CZ,Czechia,EURO,52,7449,2,224
2020-04-28,CZ,Czechia,EURO,41,7490,1,225
2020-04-29,CZ,Czechia,EURO,60,7550,4,229
2020-04-30,CZ,Czechia,EURO,75,7625,5,234
2020-05-01,CZ,Czechia,EURO,109,7734,8,242
2020-05-02,CZ,Czechia,EURO,57,7791,8,250
2020-05-03,CZ,Czechia,EURO,18,7809,1,251
2020-05-04,CZ,Czechia,EURO,26,7835,3,254
2020-05-05,CZ,Czechia,EURO,39,7874,5,259
2020-05-06,CZ,Czechia,EURO,77,7951,3,262
2020-05-07,CZ,Czechia,EURO,79,8030,3,265
2020-05-08,CZ,Czechia,EURO,59,8089,4,269
2020-05-09,CZ,Czechia,EURO,46,8135,5,274
2020-05-10,CZ,Czechia,EURO,18,8153,3,277
2020-05-11,CZ,Czechia,EURO,28,8181,3,280
2020-05-12,CZ,Czechia,EURO,58,8239,2,282
2020-05-13,CZ,Czechia,EURO,46,8285,3,285
2020-05-14,CZ,Czechia,EURO,52,8337,4,289
2020-05-15,CZ,Czechia,EURO,82,8419,3,292
2020-05-16,CZ,Czechia,EURO,55,8474,2,294
2020-05-17,CZ,Czechia,EURO,51,8525,1,295
2020-05-18,CZ,Czechia,EURO,20,8545,2,297
2020-05-19,CZ,Czechia,EURO,115,8660,3,300
2020-05-20,CZ,Czechia,EURO,63,8723,2,302
2020-05-21,CZ,Czechia,EURO,75,8798,5,307
2020-05-22,CZ,Czechia,EURO,37,8835,3,310
2020-05-23,CZ,Czechia,EURO,61,8896,2,312
2020-05-24,CZ,Czechia,EURO,77,8973,1,313
2020-05-25,CZ,Czechia,EURO,65,9038,1,314
2020-05-26,CZ,Czechia,EURO,47,9085,1,315
2020-05-27,CZ,Czechia,EURO,52,9137,1,316
2020-05-28,CZ,Czechia,EURO,37,9174,0,316
2020-05-29,CZ,Czechia,EURO,54,9228,2,318
2020-05-30,CZ,Czechia,EURO,57,9285,0,318
2020-05-31,CZ,Czechia,EURO,34,9319,0,318
2020-06-01,CZ,Czechia,EURO,38,9357,0,318
2020-06-02,CZ,Czechia,EURO,34,9391,2,320
2020-06-03,CZ,Czechia,EURO,66,9457,1,321
2020-06-04,CZ,Czechia,EURO,74,9531,1,322
2020-06-05,CZ,Czechia,EURO,64,9595,3,325
2020-06-06,CZ,Czechia,EURO,36,9631,0,325
2020-06-07,CZ,Czechia,EURO,39,9670,0,325
2020-06-08,CZ,Czechia,EURO,61,9731,1,326
2020-03-29,KP,Democratic People's Republic of Korea,SEARO,0,0,0,0
2020-03-30,KP,Democratic People's Republic of Korea,SEARO,0,0,0,0
2020-03-31,KP,Democratic People's Republic of Korea,SEARO,0,0,0,0
2020-04-01,KP,Democratic People's Republic of Korea,SEARO,0,0,0,0
2020-04-02,KP,Democratic People's Republic of Korea,SEARO,0,0,0,0
2020-04-03,KP,Democratic People's Republic of Korea,SEARO,0,0,0,0
2020-04-04,KP,Democratic People's Republic of Korea,SEARO,0,0,0,0
2020-04-05,KP,Democratic People's Republic of Korea,SEARO,0,0,0,0
2020-04-06,KP,Democratic People's Republic of Korea,SEARO,0,0,0,0
2020-04-07,KP,Democratic People's Republic of Korea,SEARO,0,0,0,0
2020-04-08,KP,Democratic People's Republic of Korea,SEARO,0,0,0,0
2020-04-09,KP,Democratic People's Republic of Korea,SEARO,0,0,0,0
2020-04-10,KP,Democratic People's Republic of Korea,SEARO,0,0,0,0
2020-04-11,KP,Democratic People's Republic of Korea,SEARO,0,0,0,0
2020-04-12,KP,Democratic People's Republic of Korea,SEARO,0,0,0,0
2020-04-13,KP,Democratic People's Republic of Korea,SEARO,0,0,0,0
2020-04-14,KP,Democratic People's Republic of Korea,SEARO,0,0,0,0
2020-04-15,KP,Democratic People's Republic of Korea,SEARO,0,0,0,0
2020-04-16,KP,Democratic People's Republic of Korea,SEARO,0,0,0,0
2020-04-17,KP,Democratic People's Republic of Korea,SEARO,0,0,0,0
2020-04-18,KP,Democratic People's Republic of Korea,SEARO,0,0,0,0
2020-04-19,KP,Democratic People's Republic of Korea,SEARO,0,0,0,0
2020-04-20,KP,Democratic People's Republic of Korea,SEARO,0,0,0,0
2020-04-21,KP,Democratic People's Republic of Korea,SEARO,0,0,0,0
2020-04-22,KP,Democratic People's Republic of Korea,SEARO,0,0,0,0
2020-04-23,KP,Democratic People's Republic of Korea,SEARO,0,0,0,0
2020-04-24,KP,Democratic People's Republic of Korea,SEARO,0,0,0,0
2020-04-25,KP,Democratic People's Republic of Korea,SEARO,0,0,0,0
2020-04-26,KP,Democratic People's Republic of Korea,SEARO,0,0,0,0
2020-04-27,KP,Democratic People's Republic of Korea,SEARO,0,0,0,0
2020-04-28,KP,Democratic People's Republic of Korea,SEARO,0,0,0,0
2020-04-29,KP,Democratic People's Republic of Korea,SEARO,0,0,0,0
2020-04-30,KP,Democratic People's Republic of Korea,SEARO,0,0,0,0
2020-05-01,KP,Democratic People's Republic of Korea,SEARO,0,0,0,0
2020-05-02,KP,Democratic People's Republic of Korea,SEARO,0,0,0,0
2020-05-03,KP,Democratic People's Republic of Korea,SEARO,0,0,0,0
2020-05-04,KP,Democratic People's Republic of Korea,SEARO,0,0,0,0
2020-05-05,KP,Democratic People's Republic of Korea,SEARO,0,0,0,0
2020-05-06,KP,Democratic People's Republic of Korea,SEARO,0,0,0,0
2020-05-07,KP,Democratic People's Republic of Korea,SEARO,0,0,0,0
2020-05-08,KP,Democratic People's Republic of Korea,SEARO,0,0,0,0
2020-05-09,KP,Democratic People's Republic of Korea,SEARO,0,0,0,0
2020-05-10,KP,Democratic People's Republic of Korea,SEARO,0,0,0,0
2020-05-11,KP,Democratic People's Republic of Korea,SEARO,0,0,0,0
2020-05-12,KP,Democratic People's Republic of Korea,SEARO,0,0,0,0
2020-05-13,KP,Democratic People's Republic of Korea,SEARO,0,0,0,0
2020-05-14,KP,Democratic People's Republic of Korea,SEARO,0,0,0,0
2020-05-15,KP,Democratic People's Republic of Korea,SEARO,0,0,0,0
2020-05-16,KP,Democratic People's Republic of Korea,SEARO,0,0,0,0
2020-05-17,KP,Democratic People's Republic of Korea,SEARO,0,0,0,0
2020-05-18,KP,Democratic People's Republic of Korea,SEARO,0,0,0,0
2020-05-19,KP,Democratic People's Republic of Korea,SEARO,0,0,0,0
2020-05-20,KP,Democratic People's Republic of Korea,SEARO,0,0,0,0
2020-05-21,KP,Democratic People's Republic of Korea,SEARO,0,0,0,0
2020-05-22,KP,Democratic People's Republic of Korea,SEARO,0,0,0,0
2020-05-23,KP,Democratic People's Republic of Korea,SEARO,0,0,0,0
2020-05-24,KP,Democratic People's Republic of Korea,SEARO,0,0,0,0
2020-05-25,KP,Democratic People's Republic of Korea,SEARO,0,0,0,0
2020-05-26,KP,Democratic People's Republic of Korea,SEARO,0,0,0,0
2020-05-27,KP,Democratic People's Republic of Korea,SEARO,0,0,0,0
2020-05-28,KP,Democratic People's Republic of Korea,SEARO,0,0,0,0
2020-05-29,KP,Democratic People's Republic of Korea,SEARO,0,0,0,0
2020-05-30,KP,Democratic People's Republic of Korea,SEARO,0,0,0,0
2020-05-31,KP,Democratic People's Republic of Korea,SEARO,0,0,0,0
2020-06-01,KP,Democratic People's Republic of Korea,SEARO,0,0,0,0
2020-06-02,KP,Democratic People's Republic of Korea,SEARO,0,0,0,0
2020-06-03,KP,Democratic People's Republic of Korea,SEARO,0,0,0,0
2020-06-04,KP,Democratic People's Republic of Korea,SEARO,0,0,0,0
2020-06-05,KP,Democratic People's Republic of Korea,SEARO,0,0,0,0
2020-06-06,KP,Democratic People's Republic of Korea,SEARO,0,0,0,0
2020-06-07,KP,Democratic People's Republic of Korea,SEARO,0,0,0,0
2020-06-08,KP,Democratic People's Republic of Korea,SEARO,0,0,0,0
2020-03-29,CD,Democratic Republic of the Congo,AFRO,7,65,0,209
2020-03-30,CD,Democratic Republic of the Congo,AFRO,16,81,0,209
2020-03-31,CD,Democratic Republic of the Congo,AFRO,17,98,0,209
2020-04-01,CD,Democratic Republic of the Congo,AFRO,11,109,0,209
2020-04-02,CD,Democratic Republic of the Congo,AFRO,14,123,0,209
2020-04-03,CD,Democratic Republic of the Congo,AFRO,11,134,0,209
2020-04-04,CD,Democratic Republic of the Congo,AFRO,14,148,0,209
2020-04-05,CD,Democratic Republic of the Congo,AFRO,6,154,0,209
2020-04-06,CD,Democratic Republic of the Congo,AFRO,7,161,0,209
2020-04-07,CD,Democratic Republic of the Congo,AFRO,19,180,0,209
2020-04-08,CD,Democratic Republic of the Congo,AFRO,3,183,0,209
2020-04-09,CD,Democratic Republic of the Congo,AFRO,24,207,0,209
2020-04-10,CD,Democratic Republic of the Congo,AFRO,8,215,0,209
2020-04-11,CD,Democratic Republic of the Congo,AFRO,8,223,0,209
2020-04-12,CD,Democratic Republic of the Congo,AFRO,11,234,0,209
2020-04-13,CD,Democratic Republic of the Congo,AFRO,1,235,0,209
2020-04-14,CD,Democratic Republic of the Congo,AFRO,6,241,0,209
2020-04-15,CD,Democratic Republic of the Congo,AFRO,13,254,0,209
2020-04-16,CD,Democratic Republic of the Congo,AFRO,13,267,1,210
2020-04-17,CD,Democratic Republic of the Congo,AFRO,20,287,1,211
2020-04-18,CD,Democratic Republic of the Congo,AFRO,20,307,2,213
2020-04-19,CD,Democratic Republic of the Congo,AFRO,20,327,0,213
2020-04-20,CD,Democratic Republic of the Congo,AFRO,5,332,0,213
2020-04-21,CD,Democratic Republic of the Congo,AFRO,18,350,0,213
2020-04-22,CD,Democratic Republic of the Congo,AFRO,9,359,0,213
2020-04-23,CD,Democratic Republic of the Congo,AFRO,18,377,0,213
2020-04-24,CD,Democratic Republic of the Congo,AFRO,17,394,0,213
2020-04-25,CD,Democratic Republic of the Congo,AFRO,22,416,3,216
2020-04-26,CD,Democratic Republic of the Congo,AFRO,26,442,0,216
2020-04-27,CD,Democratic Republic of the Congo,AFRO,17,459,0,216
2020-04-28,CD,Democratic Republic of the Congo,AFRO,12,471,2,218
2020-04-29,CD,Democratic Republic of the Congo,AFRO,20,491,0,218
2020-04-30,CD,Democratic Republic of the Congo,AFRO,9,500,1,219
2020-05-01,CD,Democratic Republic of the Congo,AFRO,72,572,0,219
2020-05-02,CD,Democratic Republic of the Congo,AFRO,32,604,1,220
2020-05-03,CD,Democratic Republic of the Congo,AFRO,70,674,1,221
2020-05-04,CD,Democratic Republic of the Congo,AFRO,8,682,1,222
2020-05-05,CD,Democratic Republic of the Congo,AFRO,23,705,0,222
2020-05-06,CD,Democratic Republic of the Congo,AFRO,92,797,1,223
2020-05-07,CD,Democratic Republic of the Congo,AFRO,66,863,1,224
2020-05-08,CD,Democratic Republic of the Congo,AFRO,34,897,0,224
2020-05-09,CD,Democratic Republic of the Congo,AFRO,40,937,3,227
2020-05-10,CD,Democratic Republic of the Congo,AFRO,54,991,2,229
2020-05-11,CD,Democratic Republic of the Congo,AFRO,33,1024,0,229
2020-05-12,CD,Democratic Republic of the Congo,AFRO,78,1102,3,232
2020-05-13,CD,Democratic Republic of the Congo,AFRO,67,1169,6,238
2020-05-14,CD,Democratic Republic of the Congo,AFRO,73,1242,0,238
2020-05-15,CD,Democratic Republic of the Congo,AFRO,56,1298,0,238
2020-05-16,CD,Democratic Republic of the Congo,AFRO,71,1369,10,248
2020-05-17,CD,Democratic Republic of the Congo,AFRO,85,1454,0,248
2020-05-18,CD,Democratic Republic of the Congo,AFRO,83,1537,0,248
2020-05-19,CD,Democratic Republic of the Congo,AFRO,91,1628,0,248
2020-05-20,CD,Democratic Republic of the Congo,AFRO,102,1730,0,248
2020-05-21,CD,Democratic Republic of the Congo,AFRO,104,1834,0,248
2020-05-22,CD,Democratic Republic of the Congo,AFRO,110,1944,2,250
2020-05-23,CD,Democratic Republic of the Congo,AFRO,80,2024,0,250
2020-05-24,CD,Democratic Republic of the Congo,AFRO,116,2140,0,250
2020-05-25,CD,Democratic Republic of the Congo,AFRO,156,2296,4,254
2020-05-26,CD,Democratic Republic of the Congo,AFRO,106,2402,1,255
2020-05-27,CD,Democratic Republic of the Congo,AFRO,143,2545,0,255
2020-05-28,CD,Democratic Republic of the Congo,AFRO,114,2659,1,256
2020-05-29,CD,Democratic Republic of the Congo,AFRO,173,2832,0,256
2020-05-30,CD,Democratic Republic of the Congo,AFRO,133,2965,0,256
2020-05-31,CD,Democratic Republic of the Congo,AFRO,83,3048,3,259
2020-06-01,CD,Democratic Republic of the Congo,AFRO,146,3194,0,259
2020-06-02,CD,Democratic Republic of the Congo,AFRO,131,3325,1,260
2020-06-03,CD,Democratic Republic of the Congo,AFRO,169,3494,3,263
2020-06-04,CD,Democratic Republic of the Congo,AFRO,149,3643,3,266
2020-06-05,CD,Democratic Republic of the Congo,AFRO,120,3763,0,266
2020-06-06,CD,Democratic Republic of the Congo,AFRO,114,3877,4,270
2020-06-07,CD,Democratic Republic of the Congo,AFRO,0,3877,0,270
2020-06-08,CD,Democratic Republic of the Congo,AFRO,228,4105,9,279
2020-03-29,DK,Denmark,EURO,155,2201,13,65
2020-03-30,DK,Denmark,EURO,194,2395,7,72
2020-03-31,DK,Denmark,EURO,182,2577,5,77
2020-04-01,DK,Denmark,EURO,283,2860,13,90
2020-04-02,DK,Denmark,EURO,247,3107,14,104
2020-04-03,DK,Denmark,EURO,279,3386,19,123
2020-04-04,DK,Denmark,EURO,371,3757,16,139
2020-04-05,DK,Denmark,EURO,320,4077,22,161
2020-04-06,DK,Denmark,EURO,292,4369,18,179
2020-04-07,DK,Denmark,EURO,312,4681,8,187
2020-04-08,DK,Denmark,EURO,390,5071,16,203
2020-04-09,DK,Denmark,EURO,331,5402,15,218
2020-04-10,DK,Denmark,EURO,233,5635,19,237
2020-04-11,DK,Denmark,EURO,184,5819,10,247
2020-04-12,DK,Denmark,EURO,177,5996,13,260
2020-04-13,DK,Denmark,EURO,178,6174,13,273
2020-04-14,DK,Denmark,EURO,144,6318,12,285
2020-04-15,DK,Denmark,EURO,193,6511,14,299
2020-04-16,DK,Denmark,EURO,170,6681,10,309
2020-04-17,DK,Denmark,EURO,198,6879,12,321
2020-04-18,DK,Denmark,EURO,194,7073,15,336
2020-04-19,DK,Denmark,EURO,169,7242,10,346
2020-04-20,DK,Denmark,EURO,142,7384,9,355
2020-04-21,DK,Denmark,EURO,131,7515,9,364
2020-04-22,DK,Denmark,EURO,180,7695,6,370
2020-04-23,DK,Denmark,EURO,217,7912,14,384
2020-04-24,DK,Denmark,EURO,161,8073,10,394
2020-04-25,DK,Denmark,EURO,137,8210,9,403
2020-04-26,DK,Denmark,EURO,235,8445,15,418
2020-04-27,DK,Denmark,EURO,130,8575,4,422
2020-04-28,DK,Denmark,EURO,123,8698,5,427
2020-04-29,DK,Denmark,EURO,153,8851,7,434
2020-04-30,DK,Denmark,EURO,157,9008,9,443
2020-05-01,DK,Denmark,EURO,150,9158,9,452
2020-05-02,DK,Denmark,EURO,153,9311,8,460
2020-05-03,DK,Denmark,EURO,96,9407,15,475
2020-05-04,DK,Denmark,EURO,116,9523,9,484
2020-05-05,DK,Denmark,EURO,147,9670,9,493
2020-05-06,DK,Denmark,EURO,151,9821,10,503
2020-05-07,DK,Denmark,EURO,117,9938,3,506
2020-05-08,DK,Denmark,EURO,145,10083,8,514
2020-05-09,DK,Denmark,EURO,135,10218,8,522
2020-05-10,DK,Denmark,EURO,101,10319,4,526
2020-05-11,DK,Denmark,EURO,110,10429,3,529
2020-05-12,DK,Denmark,EURO,84,10513,4,533
2020-05-13,DK,Denmark,EURO,78,10591,0,533
2020-05-14,DK,Denmark,EURO,76,10667,6,539
2020-05-15,DK,Denmark,EURO,46,10713,4,543
2020-05-16,DK,Denmark,EURO,78,10791,0,543
2020-05-17,DK,Denmark,EURO,67,10858,6,549
2020-05-18,DK,Denmark,EURO,69,10927,4,553
2020-05-19,DK,Denmark,EURO,41,10968,1,554
2020-05-20,DK,Denmark,EURO,76,11044,3,557
2020-05-21,DK,Denmark,EURO,73,11117,3,560
2020-05-22,DK,Denmark,EURO,65,11182,7,567
2020-05-23,DK,Denmark,EURO,48,11230,0,567
2020-05-24,DK,Denmark,EURO,59,11289,0,567
2020-05-25,DK,Denmark,EURO,71,11360,1,568
2020-05-26,DK,Denmark,EURO,27,11387,1,569
2020-05-27,DK,Denmark,EURO,41,11428,0,569
2020-05-28,DK,Denmark,EURO,52,11480,2,571
2020-05-29,DK,Denmark,EURO,32,11512,3,574
2020-05-30,DK,Denmark,EURO,81,11593,0,574
2020-05-31,DK,Denmark,EURO,40,11633,3,577
2020-06-01,DK,Denmark,EURO,36,11669,3,580
2020-06-02,DK,Denmark,EURO,30,11699,2,582
2020-06-03,DK,Denmark,EURO,35,11734,4,586
2020-06-04,DK,Denmark,EURO,37,11771,0,586
2020-06-05,DK,Denmark,EURO,40,11811,2,588
2020-06-06,DK,Denmark,EURO,64,11875,4,592
2020-06-07,DK,Denmark,EURO,49,11924,1,593
2020-06-08,DK,Denmark,EURO,24,11948,2,595
2020-03-29,DJ,Djibouti,EMRO,2,15,0,0
2020-03-30,DJ,Djibouti,EMRO,4,19,0,0
2020-03-31,DJ,Djibouti,EMRO,7,26,0,0
2020-04-01,DJ,Djibouti,EMRO,5,31,0,0
2020-04-02,DJ,Djibouti,EMRO,3,34,0,0
2020-04-03,DJ,Djibouti,EMRO,7,41,0,0
2020-04-04,DJ,Djibouti,EMRO,9,50,0,0
2020-04-05,DJ,Djibouti,EMRO,1,51,0,0
2020-04-06,DJ,Djibouti,EMRO,8,59,0,0
2020-04-07,DJ,Djibouti,EMRO,31,90,0,0
2020-04-08,DJ,Djibouti,EMRO,31,121,0,0
2020-04-09,DJ,Djibouti,EMRO,14,135,0,0
2020-04-10,DJ,Djibouti,EMRO,5,140,0,0
2020-04-11,DJ,Djibouti,EMRO,10,150,1,1
2020-04-12,DJ,Djibouti,EMRO,37,187,1,2
2020-04-13,DJ,Djibouti,EMRO,28,215,0,2
2020-04-14,DJ,Djibouti,EMRO,83,298,0,2
2020-04-15,DJ,Djibouti,EMRO,65,363,0,2
2020-04-16,DJ,Djibouti,EMRO,72,435,0,2
2020-04-17,DJ,Djibouti,EMRO,156,591,0,2
2020-04-18,DJ,Djibouti,EMRO,141,732,0,2
2020-04-19,DJ,Djibouti,EMRO,0,732,0,2
2020-04-20,DJ,Djibouti,EMRO,114,846,0,2
2020-04-21,DJ,Djibouti,EMRO,0,846,0,2
2020-04-22,DJ,Djibouti,EMRO,99,945,0,2
2020-04-23,DJ,Djibouti,EMRO,29,974,0,2
2020-04-24,DJ,Djibouti,EMRO,12,986,0,2
2020-04-25,DJ,Djibouti,EMRO,13,999,0,2
2020-04-26,DJ,Djibouti,EMRO,9,1008,0,2
2020-04-27,DJ,Djibouti,EMRO,15,1023,0,2
2020-04-28,DJ,Djibouti,EMRO,12,1035,0,2
2020-04-29,DJ,Djibouti,EMRO,37,1072,0,2
2020-04-30,DJ,Djibouti,EMRO,5,1077,0,2
2020-05-01,DJ,Djibouti,EMRO,12,1089,0,2
2020-05-02,DJ,Djibouti,EMRO,8,1097,0,2
2020-05-03,DJ,Djibouti,EMRO,15,1112,0,2
2020-05-04,DJ,Djibouti,EMRO,0,1112,0,2
2020-05-05,DJ,Djibouti,EMRO,4,1116,0,2
2020-05-06,DJ,Djibouti,EMRO,4,1120,0,2
2020-05-07,DJ,Djibouti,EMRO,4,1124,1,3
2020-05-08,DJ,Djibouti,EMRO,9,1133,0,3
2020-05-09,DJ,Djibouti,EMRO,2,1135,0,3
2020-05-10,DJ,Djibouti,EMRO,54,1189,0,3
2020-05-11,DJ,Djibouti,EMRO,21,1210,0,3
2020-05-12,DJ,Djibouti,EMRO,17,1227,0,3
2020-05-13,DJ,Djibouti,EMRO,29,1256,0,3
2020-05-14,DJ,Djibouti,EMRO,12,1268,0,3
2020-05-15,DJ,Djibouti,EMRO,16,1284,0,3
2020-05-16,DJ,Djibouti,EMRO,25,1309,1,4
2020-05-17,DJ,Djibouti,EMRO,22,1331,0,4
2020-05-18,DJ,Djibouti,EMRO,70,1401,0,4
2020-05-19,DJ,Djibouti,EMRO,117,1518,3,7
2020-05-20,DJ,Djibouti,EMRO,100,1618,0,7
2020-05-21,DJ,Djibouti,EMRO,210,1828,2,9
2020-05-22,DJ,Djibouti,EMRO,219,2047,1,10
2020-05-23,DJ,Djibouti,EMRO,223,2270,0,10
2020-05-24,DJ,Djibouti,EMRO,0,2270,0,10
2020-05-25,DJ,Djibouti,EMRO,0,2270,0,10
2020-05-26,DJ,Djibouti,EMRO,198,2468,4,14
2020-05-27,DJ,Djibouti,EMRO,0,2468,0,14
2020-05-28,DJ,Djibouti,EMRO,229,2697,4,18
2020-05-29,DJ,Djibouti,EMRO,217,2914,2,20
2020-05-30,DJ,Djibouti,EMRO,0,2914,0,20
2020-05-31,DJ,Djibouti,EMRO,280,3194,2,22
2020-06-01,DJ,Djibouti,EMRO,160,3354,2,24
2020-06-02,DJ,Djibouti,EMRO,215,3569,0,24
2020-06-03,DJ,Djibouti,EMRO,210,3779,1,25
2020-06-04,DJ,Djibouti,EMRO,156,3935,1,26
2020-06-05,DJ,Djibouti,EMRO,119,4054,0,26
2020-06-06,DJ,Djibouti,EMRO,69,4123,0,26
2020-06-07,DJ,Djibouti,EMRO,46,4169,0,26
2020-06-08,DJ,Djibouti,EMRO,38,4207,2,28
2020-03-29,DM,Dominica,AMRO,0,11,0,0
2020-03-30,DM,Dominica,AMRO,0,11,0,0
2020-03-31,DM,Dominica,AMRO,0,11,0,0
2020-04-01,DM,Dominica,AMRO,0,11,0,0
2020-04-02,DM,Dominica,AMRO,0,11,0,0
2020-04-03,DM,Dominica,AMRO,0,11,0,0
2020-04-04,DM,Dominica,AMRO,0,11,0,0
2020-04-05,DM,Dominica,AMRO,0,11,0,0
2020-04-06,DM,Dominica,AMRO,0,11,0,0
2020-04-07,DM,Dominica,AMRO,3,14,0,0
2020-04-08,DM,Dominica,AMRO,1,15,0,0
2020-04-09,DM,Dominica,AMRO,0,15,0,0
2020-04-10,DM,Dominica,AMRO,0,15,0,0
2020-04-11,DM,Dominica,AMRO,1,16,0,0
2020-04-12,DM,Dominica,AMRO,0,16,0,0
2020-04-13,DM,Dominica,AMRO,0,16,0,0
2020-04-14,DM,Dominica,AMRO,0,16,0,0
2020-04-15,DM,Dominica,AMRO,0,16,0,0
2020-04-16,DM,Dominica,AMRO,0,16,0,0
2020-04-17,DM,Dominica,AMRO,0,16,0,0
2020-04-18,DM,Dominica,AMRO,0,16,0,0
2020-04-19,DM,Dominica,AMRO,0,16,0,0
2020-04-20,DM,Dominica,AMRO,0,16,0,0
2020-04-21,DM,Dominica,AMRO,0,16,0,0
2020-04-22,DM,Dominica,AMRO,0,16,0,0
2020-04-23,DM,Dominica,AMRO,0,16,0,0
2020-04-24,DM,Dominica,AMRO,0,16,0,0
2020-04-25,DM,Dominica,AMRO,0,16,0,0
2020-04-26,DM,Dominica,AMRO,0,16,0,0
2020-04-27,DM,Dominica,AMRO,0,16,0,0
2020-04-28,DM,Dominica,AMRO,0,16,0,0
2020-04-29,DM,Dominica,AMRO,0,16,0,0
2020-04-30,DM,Dominica,AMRO,0,16,0,0
2020-05-01,DM,Dominica,AMRO,0,16,0,0
2020-05-02,DM,Dominica,AMRO,0,16,0,0
2020-05-03,DM,Dominica,AMRO,0,16,0,0
2020-05-04,DM,Dominica,AMRO,0,16,0,0
2020-05-05,DM,Dominica,AMRO,0,16,0,0
2020-05-06,DM,Dominica,AMRO,0,16,0,0
2020-05-07,DM,Dominica,AMRO,0,16,0,0
2020-05-08,DM,Dominica,AMRO,0,16,0,0
2020-05-09,DM,Dominica,AMRO,0,16,0,0
2020-05-10,DM,Dominica,AMRO,0,16,0,0
2020-05-11,DM,Dominica,AMRO,0,16,0,0
2020-05-12,DM,Dominica,AMRO,0,16,0,0
2020-05-13,DM,Dominica,AMRO,0,16,0,0
2020-05-14,DM,Dominica,AMRO,0,16,0,0
2020-05-15,DM,Dominica,AMRO,0,16,0,0
2020-05-16,DM,Dominica,AMRO,0,16,0,0
2020-05-17,DM,Dominica,AMRO,0,16,0,0
2020-05-18,DM,Dominica,AMRO,0,16,0,0
2020-05-19,DM,Dominica,AMRO,0,16,0,0
2020-05-20,DM,Dominica,AMRO,0,16,0,0
2020-05-21,DM,Dominica,AMRO,0,16,0,0
2020-05-22,DM,Dominica,AMRO,0,16,0,0
2020-05-23,DM,Dominica,AMRO,0,16,0,0
2020-05-24,DM,Dominica,AMRO,0,16,0,0
2020-05-25,DM,Dominica,AMRO,0,16,0,0
2020-05-26,DM,Dominica,AMRO,0,16,0,0
2020-05-27,DM,Dominica,AMRO,0,16,0,0
2020-05-28,DM,Dominica,AMRO,0,16,0,0
2020-05-29,DM,Dominica,AMRO,0,16,0,0
2020-05-30,DM,Dominica,AMRO,0,16,0,0
2020-05-31,DM,Dominica,AMRO,0,16,0,0
2020-06-01,DM,Dominica,AMRO,0,16,0,0
2020-06-02,DM,Dominica,AMRO,0,16,0,0
2020-06-03,DM,Dominica,AMRO,0,16,0,0
2020-06-04,DM,Dominica,AMRO,0,16,0,0
2020-06-05,DM,Dominica,AMRO,0,16,0,0
2020-06-06,DM,Dominica,AMRO,0,16,0,0
2020-06-07,DM,Dominica,AMRO,0,16,0,0
2020-06-08,DM,Dominica,AMRO,0,16,0,0
2020-03-29,DO,Dominican Republic,AMRO,0,581,0,20
2020-03-30,DO,Dominican Republic,AMRO,0,581,0,20
2020-03-31,DO,Dominican Republic,AMRO,320,901,22,42
2020-04-01,DO,Dominican Republic,AMRO,208,1109,9,51
2020-04-02,DO,Dominican Republic,AMRO,175,1284,6,57
2020-04-03,DO,Dominican Republic,AMRO,96,1380,3,60
2020-04-04,DO,Dominican Republic,AMRO,108,1488,8,68
2020-04-05,DO,Dominican Republic,AMRO,0,1488,0,68
2020-04-06,DO,Dominican Republic,AMRO,0,1488,0,68
2020-04-07,DO,Dominican Republic,AMRO,340,1828,18,86
2020-04-08,DO,Dominican Republic,AMRO,128,1956,12,98
2020-04-09,DO,Dominican Republic,AMRO,0,1956,0,98
2020-04-10,DO,Dominican Republic,AMRO,393,2349,20,118
2020-04-11,DO,Dominican Republic,AMRO,0,2349,0,118
2020-04-12,DO,Dominican Republic,AMRO,271,2620,8,126
2020-04-13,DO,Dominican Republic,AMRO,347,2967,47,173
2020-04-14,DO,Dominican Republic,AMRO,200,3167,4,177
2020-04-15,DO,Dominican Republic,AMRO,119,3286,6,183
2020-04-16,DO,Dominican Republic,AMRO,328,3614,6,189
2020-04-17,DO,Dominican Republic,AMRO,141,3755,7,196
2020-04-18,DO,Dominican Republic,AMRO,371,4126,4,200
2020-04-19,DO,Dominican Republic,AMRO,209,4335,17,217
2020-04-20,DO,Dominican Republic,AMRO,345,4680,9,226
2020-04-21,DO,Dominican Republic,AMRO,284,4964,9,235
2020-04-22,DO,Dominican Republic,AMRO,80,5044,10,245
2020-04-23,DO,Dominican Republic,AMRO,256,5300,15,260
2020-04-24,DO,Dominican Republic,AMRO,243,5543,5,265
2020-04-25,DO,Dominican Republic,AMRO,206,5749,2,267
2020-04-26,DO,Dominican Republic,AMRO,177,5926,6,273
2020-04-27,DO,Dominican Republic,AMRO,209,6135,5,278
2020-04-28,DO,Dominican Republic,AMRO,158,6293,4,282
2020-04-29,DO,Dominican Republic,AMRO,123,6416,4,286
2020-04-30,DO,Dominican Republic,AMRO,236,6652,7,293
2020-05-01,DO,Dominican Republic,AMRO,320,6972,8,301
2020-05-02,DO,Dominican Republic,AMRO,316,7288,12,313
2020-05-03,DO,Dominican Republic,AMRO,290,7578,13,326
2020-05-04,DO,Dominican Republic,AMRO,376,7954,7,333
2020-05-05,DO,Dominican Republic,AMRO,281,8235,13,346
2020-05-06,DO,Dominican Republic,AMRO,245,8480,8,354
2020-05-07,DO,Dominican Republic,AMRO,327,8807,8,362
2020-05-08,DO,Dominican Republic,AMRO,288,9095,11,373
2020-05-09,DO,Dominican Republic,AMRO,281,9376,7,380
2020-05-10,DO,Dominican Republic,AMRO,506,9882,5,385
2020-05-11,DO,Dominican Republic,AMRO,465,10347,3,388
2020-05-12,DO,Dominican Republic,AMRO,287,10634,5,393
2020-05-13,DO,Dominican Republic,AMRO,266,10900,9,402
2020-05-14,DO,Dominican Republic,AMRO,296,11196,7,409
2020-05-15,DO,Dominican Republic,AMRO,124,11320,13,422
2020-05-16,DO,Dominican Republic,AMRO,419,11739,2,424
2020-05-17,DO,Dominican Republic,AMRO,371,12110,4,428
2020-05-18,DO,Dominican Republic,AMRO,204,12314,0,428
2020-05-19,DO,Dominican Republic,AMRO,411,12725,6,434
2020-05-20,DO,Dominican Republic,AMRO,498,13223,7,441
2020-05-21,DO,Dominican Republic,AMRO,254,13477,5,446
2020-05-22,DO,Dominican Republic,AMRO,180,13657,2,448
2020-05-23,DO,Dominican Republic,AMRO,332,13989,8,456
2020-05-24,DO,Dominican Republic,AMRO,433,14422,2,458
2020-05-25,DO,Dominican Republic,AMRO,379,14801,0,458
2020-05-26,DO,Dominican Republic,AMRO,272,15073,2,460
2020-05-27,DO,Dominican Republic,AMRO,191,15264,8,468
2020-05-28,DO,Dominican Republic,AMRO,459,15723,6,474
2020-05-29,DO,Dominican Republic,AMRO,345,16068,11,485
2020-05-30,DO,Dominican Republic,AMRO,463,16531,3,488
2020-05-31,DO,Dominican Republic,AMRO,377,16908,10,498
2020-06-01,DO,Dominican Republic,AMRO,377,17285,4,502
2020-06-02,DO,Dominican Republic,AMRO,287,17572,0,502
2020-06-03,DO,Dominican Republic,AMRO,180,17752,13,515
2020-06-04,DO,Dominican Republic,AMRO,288,18040,1,516
2020-06-05,DO,Dominican Republic,AMRO,279,18319,4,520
2020-06-06,DO,Dominican Republic,AMRO,389,18708,5,525
2020-06-07,DO,Dominican Republic,AMRO,487,19195,11,536
2020-06-08,DO,Dominican Republic,AMRO,405,19600,2,538
2020-03-29,EC,Ecuador,AMRO,228,1823,12,48
2020-03-30,EC,Ecuador,AMRO,67,1890,9,57
2020-03-31,EC,Ecuador,AMRO,72,1962,3,60
2020-04-01,EC,Ecuador,AMRO,278,2240,15,75
2020-04-02,EC,Ecuador,AMRO,508,2748,18,93
2020-04-03,EC,Ecuador,AMRO,415,3163,27,120
2020-04-04,EC,Ecuador,AMRO,0,3163,0,120
2020-04-05,EC,Ecuador,AMRO,302,3465,52,172
2020-04-06,EC,Ecuador,AMRO,0,3465,0,172
2020-04-07,EC,Ecuador,AMRO,282,3747,19,191
2020-04-08,EC,Ecuador,AMRO,248,3995,29,220
2020-04-09,EC,Ecuador,AMRO,455,4450,22,242
2020-04-10,EC,Ecuador,AMRO,515,4965,30,272
2020-04-11,EC,Ecuador,AMRO,2196,7161,25,297
2020-04-12,EC,Ecuador,AMRO,96,7257,18,315
2020-04-13,EC,Ecuador,AMRO,209,7466,18,333
2020-04-14,EC,Ecuador,AMRO,63,7529,22,355
2020-04-15,EC,Ecuador,AMRO,74,7603,14,369
2020-04-16,EC,Ecuador,AMRO,255,7858,19,388
2020-04-17,EC,Ecuador,AMRO,367,8225,15,403
2020-04-18,EC,Ecuador,AMRO,225,8450,18,421
2020-04-19,EC,Ecuador,AMRO,572,9022,35,456
2020-04-20,EC,Ecuador,AMRO,446,9468,18,474
2020-04-21,EC,Ecuador,AMRO,660,10128,33,507
2020-04-22,EC,Ecuador,AMRO,270,10398,13,520
2020-04-23,EC,Ecuador,AMRO,452,10850,17,537
2020-04-24,EC,Ecuador,AMRO,333,11183,23,560
2020-04-25,EC,Ecuador,AMRO,11536,22719,16,576
2020-04-26,EC,Ecuador,AMRO,0,22719,0,576
2020-04-27,EC,Ecuador,AMRO,0,22719,0,576
2020-04-28,EC,Ecuador,AMRO,521,23240,87,663
2020-04-29,EC,Ecuador,AMRO,1018,24258,208,871
2020-04-30,EC,Ecuador,AMRO,417,24675,12,883
2020-05-01,EC,Ecuador,AMRO,259,24934,17,900
2020-05-02,EC,Ecuador,AMRO,1402,26336,163,1063
2020-05-03,EC,Ecuador,AMRO,1128,27464,308,1371
2020-05-04,EC,Ecuador,AMRO,2074,29538,193,1564
2020-05-05,EC,Ecuador,AMRO,2343,31881,5,1569
2020-05-06,EC,Ecuador,AMRO,0,31881,0,1569
2020-05-07,EC,Ecuador,AMRO,-2461,29420,49,1618
2020-05-08,EC,Ecuador,AMRO,878,30298,36,1654
2020-05-09,EC,Ecuador,AMRO,-1480,28818,50,1704
2020-05-10,EC,Ecuador,AMRO,253,29071,13,1717
2020-05-11,EC,Ecuador,AMRO,488,29559,410,2127
2020-05-12,EC,Ecuador,AMRO,-50,29509,18,2145
2020-05-13,EC,Ecuador,AMRO,910,30419,182,2327
2020-05-14,EC,Ecuador,AMRO,67,30486,7,2334
2020-05-15,EC,Ecuador,AMRO,16,30502,4,2338
2020-05-16,EC,Ecuador,AMRO,0,30502,0,2338
2020-05-17,EC,Ecuador,AMRO,965,31467,256,2594
2020-05-18,EC,Ecuador,AMRO,1256,32723,94,2688
2020-05-19,EC,Ecuador,AMRO,459,33182,48,2736
2020-05-20,EC,Ecuador,AMRO,969,34151,103,2839
2020-05-21,EC,Ecuador,AMRO,703,34854,49,2888
2020-05-22,EC,Ecuador,AMRO,452,35306,51,2939
2020-05-23,EC,Ecuador,AMRO,522,35828,117,3056
2020-05-24,EC,Ecuador,AMRO,430,36258,40,3096
2020-05-25,EC,Ecuador,AMRO,498,36756,12,3108
2020-05-26,EC,Ecuador,AMRO,599,37355,95,3203
2020-05-27,EC,Ecuador,AMRO,0,37355,0,3203
2020-05-28,EC,Ecuador,AMRO,748,38103,72,3275
2020-05-29,EC,Ecuador,AMRO,368,38471,38,3313
2020-05-30,EC,Ecuador,AMRO,100,38571,21,3334
2020-05-31,EC,Ecuador,AMRO,272,38843,12,3346
2020-06-01,EC,Ecuador,AMRO,255,39098,12,3358
2020-06-02,EC,Ecuador,AMRO,896,39994,36,3394
2020-06-03,EC,Ecuador,AMRO,420,40414,44,3438
2020-06-04,EC,Ecuador,AMRO,552,40966,48,3486
2020-06-05,EC,Ecuador,AMRO,609,41575,48,3534
2020-06-06,EC,Ecuador,AMRO,531,42106,58,3592
2020-06-07,EC,Ecuador,AMRO,622,42728,16,3608
2020-06-08,EC,Ecuador,AMRO,392,43120,13,3621
2020-03-29,EG,Egypt,EMRO,40,576,6,36
2020-03-30,EG,Egypt,EMRO,33,609,4,40
2020-03-31,EG,Egypt,EMRO,47,656,1,41
2020-04-01,EG,Egypt,EMRO,54,710,5,46
2020-04-02,EG,Egypt,EMRO,69,779,6,52
2020-04-03,EG,Egypt,EMRO,86,865,6,58
2020-04-04,EG,Egypt,EMRO,120,985,8,66
2020-04-05,EG,Egypt,EMRO,85,1070,5,71
2020-04-06,EG,Egypt,EMRO,103,1173,7,78
2020-04-07,EG,Egypt,EMRO,149,1322,7,85
2020-04-08,EG,Egypt,EMRO,128,1450,9,94
2020-04-09,EG,Egypt,EMRO,110,1560,9,103
2020-04-10,EG,Egypt,EMRO,139,1699,15,118
2020-04-11,EG,Egypt,EMRO,95,1794,17,135
2020-04-12,EG,Egypt,EMRO,145,1939,11,146
2020-04-13,EG,Egypt,EMRO,126,2065,13,159
2020-04-14,EG,Egypt,EMRO,125,2190,5,164
2020-04-15,EG,Egypt,EMRO,160,2350,14,178
2020-04-16,EG,Egypt,EMRO,155,2505,5,183
2020-04-17,EG,Egypt,EMRO,168,2673,13,196
2020-04-18,EG,Egypt,EMRO,171,2844,9,205
2020-04-19,EG,Egypt,EMRO,188,3032,19,224
2020-04-20,EG,Egypt,EMRO,112,3144,15,239
2020-04-21,EG,Egypt,EMRO,189,3333,11,250
2020-04-22,EG,Egypt,EMRO,157,3490,14,264
2020-04-23,EG,Egypt,EMRO,169,3659,12,276
2020-04-24,EG,Egypt,EMRO,232,3891,11,287
2020-04-25,EG,Egypt,EMRO,201,4092,7,294
2020-04-26,EG,Egypt,EMRO,227,4319,13,307
2020-04-27,EG,Egypt,EMRO,215,4534,10,317
2020-04-28,EG,Egypt,EMRO,248,4782,20,337
2020-04-29,EG,Egypt,EMRO,260,5042,22,359
2020-04-30,EG,Egypt,EMRO,226,5268,21,380
2020-05-01,EG,Egypt,EMRO,269,5537,12,392
2020-05-02,EG,Egypt,EMRO,358,5895,14,406
2020-05-03,EG,Egypt,EMRO,298,6193,9,415
2020-05-04,EG,Egypt,EMRO,272,6465,14,429
2020-05-05,EG,Egypt,EMRO,348,6813,7,436
2020-05-06,EG,Egypt,EMRO,388,7201,16,452
2020-05-07,EG,Egypt,EMRO,387,7588,17,469
2020-05-08,EG,Egypt,EMRO,393,7981,13,482
2020-05-09,EG,Egypt,EMRO,495,8476,21,503
2020-05-10,EG,Egypt,EMRO,488,8964,11,514
2020-05-11,EG,Egypt,EMRO,436,9400,11,525
2020-05-12,EG,Egypt,EMRO,346,9746,8,533
2020-05-13,EG,Egypt,EMRO,347,10093,11,544
2020-05-14,EG,Egypt,EMRO,338,10431,12,556
2020-05-15,EG,Egypt,EMRO,398,10829,15,571
2020-05-16,EG,Egypt,EMRO,399,11228,21,592
2020-05-17,EG,Egypt,EMRO,491,11719,20,612
2020-05-18,EG,Egypt,EMRO,510,12229,18,630
2020-05-19,EG,Egypt,EMRO,535,12764,15,645
2020-05-20,EG,Egypt,EMRO,720,13484,14,659
2020-05-21,EG,Egypt,EMRO,745,14229,21,680
2020-05-22,EG,Egypt,EMRO,774,15003,16,696
2020-05-23,EG,Egypt,EMRO,783,15786,11,707
2020-05-24,EG,Egypt,EMRO,727,16513,28,735
2020-05-25,EG,Egypt,EMRO,752,17265,29,764
2020-05-26,EG,Egypt,EMRO,702,17967,19,783
2020-05-27,EG,Egypt,EMRO,789,18756,14,797
2020-05-28,EG,Egypt,EMRO,910,19666,19,816
2020-05-29,EG,Egypt,EMRO,1127,20793,29,845
2020-05-30,EG,Egypt,EMRO,1289,22082,34,879
2020-05-31,EG,Egypt,EMRO,1367,23449,34,913
2020-06-01,EG,Egypt,EMRO,1536,24985,46,959
2020-06-02,EG,Egypt,EMRO,1399,26384,46,1005
2020-06-03,EG,Egypt,EMRO,1152,27536,47,1052
2020-06-04,EG,Egypt,EMRO,1079,28615,36,1088
2020-06-05,EG,Egypt,EMRO,1152,29767,38,1126
2020-06-06,EG,Egypt,EMRO,1348,31115,40,1166
2020-06-07,EG,Egypt,EMRO,1497,32612,32,1198
2020-06-08,EG,Egypt,EMRO,1467,34079,39,1237
2020-03-29,SV,El Salvador,AMRO,6,19,0,0
2020-03-30,SV,El Salvador,AMRO,5,24,0,0
2020-03-31,SV,El Salvador,AMRO,6,30,0,0
2020-04-01,SV,El Salvador,AMRO,2,32,0,0
2020-04-02,SV,El Salvador,AMRO,0,32,1,1
2020-04-03,SV,El Salvador,AMRO,9,41,1,2
2020-04-04,SV,El Salvador,AMRO,5,46,0,2
2020-04-05,SV,El Salvador,AMRO,10,56,1,3
2020-04-06,SV,El Salvador,AMRO,6,62,0,3
2020-04-07,SV,El Salvador,AMRO,7,69,0,3
2020-04-08,SV,El Salvador,AMRO,9,78,1,4
2020-04-09,SV,El Salvador,AMRO,15,93,1,5
2020-04-10,SV,El Salvador,AMRO,10,103,0,5
2020-04-11,SV,El Salvador,AMRO,14,117,1,6
2020-04-12,SV,El Salvador,AMRO,1,118,0,6
2020-04-13,SV,El Salvador,AMRO,7,125,0,6
2020-04-14,SV,El Salvador,AMRO,12,137,0,6
2020-04-15,SV,El Salvador,AMRO,12,149,0,6
2020-04-16,SV,El Salvador,AMRO,10,159,0,6
2020-04-17,SV,El Salvador,AMRO,5,164,0,6
2020-04-18,SV,El Salvador,AMRO,13,177,1,7
2020-04-19,SV,El Salvador,AMRO,13,190,0,7
2020-04-20,SV,El Salvador,AMRO,11,201,0,7
2020-04-21,SV,El Salvador,AMRO,17,218,0,7
2020-04-22,SV,El Salvador,AMRO,7,225,0,7
2020-04-23,SV,El Salvador,AMRO,12,237,0,7
2020-04-24,SV,El Salvador,AMRO,13,250,1,8
2020-04-25,SV,El Salvador,AMRO,11,261,0,8
2020-04-26,SV,El Salvador,AMRO,13,274,0,8
2020-04-27,SV,El Salvador,AMRO,24,298,0,8
2020-04-28,SV,El Salvador,AMRO,25,323,0,8
2020-04-29,SV,El Salvador,AMRO,22,345,0,8
2020-04-30,SV,El Salvador,AMRO,32,377,1,9
2020-05-01,SV,El Salvador,AMRO,18,395,0,9
2020-05-02,SV,El Salvador,AMRO,29,424,1,10
2020-05-03,SV,El Salvador,AMRO,22,446,0,10
2020-05-04,SV,El Salvador,AMRO,44,490,1,11
2020-05-05,SV,El Salvador,AMRO,65,555,1,12
2020-05-06,SV,El Salvador,AMRO,32,587,1,13
2020-05-07,SV,El Salvador,AMRO,46,633,1,14
2020-05-08,SV,El Salvador,AMRO,62,695,1,15
2020-05-09,SV,El Salvador,AMRO,47,742,0,15
2020-05-10,SV,El Salvador,AMRO,42,784,1,16
2020-05-11,SV,El Salvador,AMRO,105,889,1,17
2020-05-12,SV,El Salvador,AMRO,69,958,0,17
2020-05-13,SV,El Salvador,AMRO,40,998,1,18
2020-05-14,SV,El Salvador,AMRO,39,1037,2,20
2020-05-15,SV,El Salvador,AMRO,75,1112,0,20
2020-05-16,SV,El Salvador,AMRO,98,1210,3,23
2020-05-17,SV,El Salvador,AMRO,55,1265,2,25
2020-05-18,SV,El Salvador,AMRO,73,1338,2,27
2020-05-19,SV,El Salvador,AMRO,75,1413,3,30
2020-05-20,SV,El Salvador,AMRO,85,1498,0,30
2020-05-21,SV,El Salvador,AMRO,73,1571,1,31
2020-05-22,SV,El Salvador,AMRO,69,1640,1,32
2020-05-23,SV,El Salvador,AMRO,85,1725,1,33
2020-05-24,SV,El Salvador,AMRO,94,1819,0,33
2020-05-25,SV,El Salvador,AMRO,96,1915,2,35
2020-05-26,SV,El Salvador,AMRO,68,1983,0,35
2020-05-27,SV,El Salvador,AMRO,59,2042,1,36
2020-05-28,SV,El Salvador,AMRO,67,2109,1,37
2020-05-29,SV,El Salvador,AMRO,85,2194,2,39
2020-05-30,SV,El Salvador,AMRO,84,2278,3,42
2020-05-31,SV,El Salvador,AMRO,117,2395,2,44
2020-06-01,SV,El Salvador,AMRO,122,2517,2,46
2020-06-02,SV,El Salvador,AMRO,65,2582,0,46
2020-06-03,SV,El Salvador,AMRO,71,2653,0,46
2020-06-04,SV,El Salvador,AMRO,52,2705,5,51
2020-06-05,SV,El Salvador,AMRO,76,2781,1,52
2020-06-06,SV,El Salvador,AMRO,68,2849,1,53
2020-06-07,SV,El Salvador,AMRO,85,2934,0,53
2020-06-08,SV,El Salvador,AMRO,81,3015,2,55
2020-03-29,GQ,Equatorial Guinea,AFRO,0,13,0,1
2020-03-30,GQ,Equatorial Guinea,AFRO,1,14,0,1
2020-03-31,GQ,Equatorial Guinea,AFRO,0,14,0,1
2020-04-01,GQ,Equatorial Guinea,AFRO,2,16,0,1
2020-04-02,GQ,Equatorial Guinea,AFRO,0,16,0,1
2020-04-03,GQ,Equatorial Guinea,AFRO,0,16,0,1
2020-04-04,GQ,Equatorial Guinea,AFRO,0,16,0,1
2020-04-05,GQ,Equatorial Guinea,AFRO,0,16,0,1
2020-04-06,GQ,Equatorial Guinea,AFRO,0,16,0,1
2020-04-07,GQ,Equatorial Guinea,AFRO,0,16,0,1
2020-04-08,GQ,Equatorial Guinea,AFRO,0,16,0,1
2020-04-09,GQ,Equatorial Guinea,AFRO,2,18,0,1
2020-04-10,GQ,Equatorial Guinea,AFRO,0,18,0,1
2020-04-11,GQ,Equatorial Guinea,AFRO,0,18,0,1
2020-04-12,GQ,Equatorial Guinea,AFRO,3,21,0,1
2020-04-13,GQ,Equatorial Guinea,AFRO,2,23,0,1
2020-04-14,GQ,Equatorial Guinea,AFRO,18,41,0,1
2020-04-15,GQ,Equatorial Guinea,AFRO,0,41,0,1
2020-04-16,GQ,Equatorial Guinea,AFRO,10,51,0,1
2020-04-17,GQ,Equatorial Guinea,AFRO,28,79,0,1
2020-04-18,GQ,Equatorial Guinea,AFRO,0,79,0,1
2020-04-19,GQ,Equatorial Guinea,AFRO,0,79,0,1
2020-04-20,GQ,Equatorial Guinea,AFRO,0,79,0,1
2020-04-21,GQ,Equatorial Guinea,AFRO,72,151,0,1
2020-04-22,GQ,Equatorial Guinea,AFRO,56,207,0,1
2020-04-23,GQ,Equatorial Guinea,AFRO,5,212,0,1
2020-04-24,GQ,Equatorial Guinea,AFRO,0,212,0,1
2020-04-25,GQ,Equatorial Guinea,AFRO,0,212,0,1
2020-04-26,GQ,Equatorial Guinea,AFRO,73,285,0,1
2020-04-27,GQ,Equatorial Guinea,AFRO,16,301,0,1
2020-04-28,GQ,Equatorial Guinea,AFRO,30,331,0,1
2020-04-29,GQ,Equatorial Guinea,AFRO,15,346,0,1
2020-04-30,GQ,Equatorial Guinea,AFRO,32,378,0,1
2020-05-01,GQ,Equatorial Guinea,AFRO,34,412,1,2
2020-05-02,GQ,Equatorial Guinea,AFRO,26,438,2,4
2020-05-03,GQ,Equatorial Guinea,AFRO,67,505,0,4
2020-05-04,GQ,Equatorial Guinea,AFRO,6,511,0,4
2020-05-05,GQ,Equatorial Guinea,AFRO,28,539,0,4
2020-05-06,GQ,Equatorial Guinea,AFRO,29,568,1,5
2020-05-07,GQ,Equatorial Guinea,AFRO,15,583,0,5
2020-05-08,GQ,Equatorial Guinea,AFRO,43,626,0,5
2020-05-09,GQ,Equatorial Guinea,AFRO,25,651,1,6
2020-05-10,GQ,Equatorial Guinea,AFRO,37,688,1,7
2020-05-11,GQ,Equatorial Guinea,AFRO,18,706,0,7
2020-05-12,GQ,Equatorial Guinea,AFRO,27,733,0,7
2020-05-13,GQ,Equatorial Guinea,AFRO,37,770,0,7
2020-05-14,GQ,Equatorial Guinea,AFRO,35,805,0,7
2020-05-15,GQ,Equatorial Guinea,AFRO,64,869,0,7
2020-05-16,GQ,Equatorial Guinea,AFRO,18,887,0,7
2020-05-17,GQ,Equatorial Guinea,AFRO,40,927,0,7
2020-05-18,GQ,Equatorial Guinea,AFRO,31,958,0,7
2020-05-19,GQ,Equatorial Guinea,AFRO,39,997,0,7
2020-05-20,GQ,Equatorial Guinea,AFRO,49,1046,3,10
2020-05-21,GQ,Equatorial Guinea,AFRO,70,1116,1,11
2020-05-22,GQ,Equatorial Guinea,AFRO,53,1169,0,11
2020-05-23,GQ,Equatorial Guinea,AFRO,85,1254,0,11
2020-05-24,GQ,Equatorial Guinea,AFRO,59,1313,1,12
2020-05-25,GQ,Equatorial Guinea,AFRO,17,1330,0,12
2020-05-26,GQ,Equatorial Guinea,AFRO,53,1383,0,12
2020-05-27,GQ,Equatorial Guinea,AFRO,56,1439,0,12
2020-05-28,GQ,Equatorial Guinea,AFRO,99,1538,0,12
2020-05-29,GQ,Equatorial Guinea,AFRO,70,1608,0,12
2020-05-30,GQ,Equatorial Guinea,AFRO,58,1666,0,12
2020-05-31,GQ,Equatorial Guinea,AFRO,62,1728,0,12
2020-06-01,GQ,Equatorial Guinea,AFRO,46,1774,0,12
2020-06-02,GQ,Equatorial Guinea,AFRO,58,1832,0,12
2020-06-03,GQ,Equatorial Guinea,AFRO,75,1907,0,12
2020-06-04,GQ,Equatorial Guinea,AFRO,74,1981,0,12
2020-06-05,GQ,Equatorial Guinea,AFRO,111,2092,0,12
2020-06-06,GQ,Equatorial Guinea,AFRO,49,2141,0,12
2020-06-07,GQ,Equatorial Guinea,AFRO,47,2188,0,12
2020-06-08,GQ,Equatorial Guinea,AFRO,27,2215,0,12
2020-03-29,ER,Eritrea,AFRO,0,6,0,1
2020-03-30,ER,Eritrea,AFRO,6,12,0,1
2020-03-31,ER,Eritrea,AFRO,3,15,0,1
2020-04-01,ER,Eritrea,AFRO,0,15,0,1
2020-04-02,ER,Eritrea,AFRO,5,20,0,1
2020-04-03,ER,Eritrea,AFRO,0,20,0,1
2020-04-04,ER,Eritrea,AFRO,0,20,0,1
2020-04-05,ER,Eritrea,AFRO,0,20,0,1
2020-04-06,ER,Eritrea,AFRO,9,29,0,1
2020-04-07,ER,Eritrea,AFRO,2,31,0,1
2020-04-08,ER,Eritrea,AFRO,0,31,0,1
2020-04-09,ER,Eritrea,AFRO,2,33,0,1
2020-04-10,ER,Eritrea,AFRO,0,33,0,1
2020-04-11,ER,Eritrea,AFRO,1,34,0,1
2020-04-12,ER,Eritrea,AFRO,0,34,0,1
2020-04-13,ER,Eritrea,AFRO,0,34,0,1
2020-04-14,ER,Eritrea,AFRO,0,34,0,1
2020-04-15,ER,Eritrea,AFRO,0,34,0,1
2020-04-16,ER,Eritrea,AFRO,1,35,0,1
2020-04-17,ER,Eritrea,AFRO,0,35,0,1
2020-04-18,ER,Eritrea,AFRO,0,35,0,1
2020-04-19,ER,Eritrea,AFRO,4,39,0,1
2020-04-20,ER,Eritrea,AFRO,0,39,0,1
2020-04-21,ER,Eritrea,AFRO,0,39,0,1
2020-04-22,ER,Eritrea,AFRO,0,39,0,1
2020-04-23,ER,Eritrea,AFRO,0,39,0,1
2020-04-24,ER,Eritrea,AFRO,0,39,0,1
2020-04-25,ER,Eritrea,AFRO,0,39,0,1
2020-04-26,ER,Eritrea,AFRO,0,39,0,1
2020-04-27,ER,Eritrea,AFRO,0,39,0,1
2020-04-28,ER,Eritrea,AFRO,0,39,0,1
2020-04-29,ER,Eritrea,AFRO,0,39,0,1
2020-04-30,ER,Eritrea,AFRO,0,39,0,1
2020-05-01,ER,Eritrea,AFRO,0,39,0,1
2020-05-02,ER,Eritrea,AFRO,0,39,0,1
2020-05-03,ER,Eritrea,AFRO,0,39,0,1
2020-05-04,ER,Eritrea,AFRO,0,39,0,1
2020-05-05,ER,Eritrea,AFRO,0,39,0,1
2020-05-06,ER,Eritrea,AFRO,0,39,0,1
2020-05-07,ER,Eritrea,AFRO,0,39,0,1
2020-05-08,ER,Eritrea,AFRO,0,39,0,1
2020-05-09,ER,Eritrea,AFRO,0,39,0,1
2020-05-10,ER,Eritrea,AFRO,0,39,0,1
2020-05-11,ER,Eritrea,AFRO,0,39,0,1
2020-05-12,ER,Eritrea,AFRO,0,39,0,1
2020-05-13,ER,Eritrea,AFRO,0,39,0,1
2020-05-14,ER,Eritrea,AFRO,0,39,0,1
2020-05-15,ER,Eritrea,AFRO,0,39,0,1
2020-05-16,ER,Eritrea,AFRO,0,39,0,1
2020-05-17,ER,Eritrea,AFRO,0,39,0,1
2020-05-18,ER,Eritrea,AFRO,0,39,0,1
2020-05-19,ER,Eritrea,AFRO,0,39,0,1
2020-05-20,ER,Eritrea,AFRO,0,39,0,1
2020-05-21,ER,Eritrea,AFRO,0,39,0,1
2020-05-22,ER,Eritrea,AFRO,0,39,0,1
2020-05-23,ER,Eritrea,AFRO,0,39,0,1
2020-05-24,ER,Eritrea,AFRO,0,39,0,1
2020-05-25,ER,Eritrea,AFRO,0,39,0,1
2020-05-26,ER,Eritrea,AFRO,0,39,0,1
2020-05-27,ER,Eritrea,AFRO,0,39,0,1
2020-05-28,ER,Eritrea,AFRO,0,39,0,1
2020-05-29,ER,Eritrea,AFRO,0,39,0,1
2020-05-30,ER,Eritrea,AFRO,0,39,0,1
2020-05-31,ER,Eritrea,AFRO,0,39,0,1
2020-06-01,ER,Eritrea,AFRO,0,39,0,1
2020-06-02,ER,Eritrea,AFRO,0,39,0,1
2020-06-03,ER,Eritrea,AFRO,0,39,0,1
2020-06-04,ER,Eritrea,AFRO,0,39,0,1
2020-06-05,ER,Eritrea,AFRO,2,41,0,1
2020-06-06,ER,Eritrea,AFRO,0,41,0,1
2020-06-07,ER,Eritrea,AFRO,0,41,0,1
2020-06-08,ER,Eritrea,AFRO,0,41,0,1
2020-03-29,EE,Estonia,EURO,40,663,0,1
2020-03-30,EE,Estonia,EURO,32,695,2,3
2020-03-31,EE,Estonia,EURO,31,726,0,3
2020-04-01,EE,Estonia,EURO,57,783,1,4
2020-04-02,EE,Estonia,EURO,79,862,1,5
2020-04-03,EE,Estonia,EURO,93,955,6,11
2020-04-04,EE,Estonia,EURO,74,1029,1,12
2020-04-05,EE,Estonia,EURO,63,1092,1,13
2020-04-06,EE,Estonia,EURO,11,1103,2,15
2020-04-07,EE,Estonia,EURO,42,1145,4,19
2020-04-08,EE,Estonia,EURO,36,1181,2,21
2020-04-09,EE,Estonia,EURO,23,1204,3,24
2020-04-10,EE,Estonia,EURO,51,1255,0,24
2020-04-11,EE,Estonia,EURO,46,1301,0,24
2020-04-12,EE,Estonia,EURO,5,1306,0,24
2020-04-13,EE,Estonia,EURO,17,1323,1,25
2020-04-14,EE,Estonia,EURO,45,1368,3,28
2020-04-15,EE,Estonia,EURO,27,1395,3,31
2020-04-16,EE,Estonia,EURO,34,1429,4,35
2020-04-17,EE,Estonia,EURO,25,1454,1,36
2020-04-18,EE,Estonia,EURO,53,1507,2,38
2020-04-19,EE,Estonia,EURO,16,1523,0,38
2020-04-20,EE,Estonia,EURO,7,1530,2,40
2020-04-21,EE,Estonia,EURO,17,1547,0,40
2020-04-22,EE,Estonia,EURO,7,1554,3,43
2020-04-23,EE,Estonia,EURO,33,1587,1,44
2020-04-24,EE,Estonia,EURO,14,1601,1,45
2020-04-25,EE,Estonia,EURO,29,1630,1,46
2020-04-26,EE,Estonia,EURO,9,1639,0,46
2020-04-27,EE,Estonia,EURO,4,1643,3,49
2020-04-28,EE,Estonia,EURO,10,1653,1,50
2020-04-29,EE,Estonia,EURO,9,1662,0,50
2020-04-30,EE,Estonia,EURO,23,1685,0,50
2020-05-01,EE,Estonia,EURO,5,1690,2,52
2020-05-02,EE,Estonia,EURO,5,1695,0,52
2020-05-03,EE,Estonia,EURO,1,1696,1,53
2020-05-04,EE,Estonia,EURO,3,1699,2,55
2020-05-05,EE,Estonia,EURO,8,1707,0,55
2020-05-06,EE,Estonia,EURO,2,1709,0,55
2020-05-07,EE,Estonia,EURO,7,1716,0,55
2020-05-08,EE,Estonia,EURO,5,1721,1,56
2020-05-09,EE,Estonia,EURO,8,1729,0,56
2020-05-10,EE,Estonia,EURO,6,1735,4,60
2020-05-11,EE,Estonia,EURO,2,1737,0,60
2020-05-12,EE,Estonia,EURO,5,1742,1,61
2020-05-13,EE,Estonia,EURO,6,1748,0,61
2020-05-14,EE,Estonia,EURO,7,1755,0,61
2020-05-15,EE,Estonia,EURO,8,1763,1,62
2020-05-16,EE,Estonia,EURO,4,1767,1,63
2020-05-17,EE,Estonia,EURO,4,1771,0,63
2020-05-18,EE,Estonia,EURO,10,1781,0,63
2020-05-19,EE,Estonia,EURO,6,1787,0,63
2020-05-20,EE,Estonia,EURO,4,1791,0,63
2020-05-21,EE,Estonia,EURO,6,1797,0,63
2020-05-22,EE,Estonia,EURO,7,1804,0,63
2020-05-23,EE,Estonia,EURO,14,1818,0,63
2020-05-24,EE,Estonia,EURO,2,1820,0,63
2020-05-25,EE,Estonia,EURO,1,1821,0,63
2020-05-26,EE,Estonia,EURO,10,1831,0,63
2020-05-27,EE,Estonia,EURO,6,1837,0,63
2020-05-28,EE,Estonia,EURO,11,1848,0,63
2020-05-29,EE,Estonia,EURO,9,1857,0,63
2020-05-30,EE,Estonia,EURO,6,1863,0,63
2020-05-31,EE,Estonia,EURO,4,1867,0,63
2020-06-01,EE,Estonia,EURO,2,1869,0,63
2020-06-02,EE,Estonia,EURO,0,1869,0,63
2020-06-03,EE,Estonia,EURO,10,1879,0,63
2020-06-04,EE,Estonia,EURO,10,1889,0,63
2020-06-05,EE,Estonia,EURO,21,1910,0,63
2020-06-06,EE,Estonia,EURO,22,1932,0,63
2020-06-07,EE,Estonia,EURO,7,1939,0,63
2020-06-08,EE,Estonia,EURO,1,1940,0,63
2020-03-29,SZ,Eswatini,AFRO,0,9,0,1
2020-03-30,SZ,Eswatini,AFRO,0,9,0,1
2020-03-31,SZ,Eswatini,AFRO,0,9,0,1
2020-04-01,SZ,Eswatini,AFRO,0,9,0,1
2020-04-02,SZ,Eswatini,AFRO,0,9,0,1
2020-04-03,SZ,Eswatini,AFRO,0,9,0,1
2020-04-04,SZ,Eswatini,AFRO,0,9,0,1
2020-04-05,SZ,Eswatini,AFRO,0,9,0,1
2020-04-06,SZ,Eswatini,AFRO,0,9,0,1
2020-04-07,SZ,Eswatini,AFRO,0,9,0,1
2020-04-08,SZ,Eswatini,AFRO,1,10,0,1
2020-04-09,SZ,Eswatini,AFRO,2,12,0,1
2020-04-10,SZ,Eswatini,AFRO,0,12,0,1
2020-04-11,SZ,Eswatini,AFRO,0,12,0,1
2020-04-12,SZ,Eswatini,AFRO,2,14,0,1
2020-04-13,SZ,Eswatini,AFRO,0,14,0,1
2020-04-14,SZ,Eswatini,AFRO,0,14,0,1
2020-04-15,SZ,Eswatini,AFRO,1,15,0,1
2020-04-16,SZ,Eswatini,AFRO,1,16,0,1
2020-04-17,SZ,Eswatini,AFRO,1,17,0,1
2020-04-18,SZ,Eswatini,AFRO,2,19,0,1
2020-04-19,SZ,Eswatini,AFRO,3,22,0,1
2020-04-20,SZ,Eswatini,AFRO,0,22,0,1
2020-04-21,SZ,Eswatini,AFRO,2,24,0,1
2020-04-22,SZ,Eswatini,AFRO,0,24,0,1
2020-04-23,SZ,Eswatini,AFRO,8,32,0,1
2020-04-24,SZ,Eswatini,AFRO,4,36,0,1
2020-04-25,SZ,Eswatini,AFRO,4,40,0,1
2020-04-26,SZ,Eswatini,AFRO,16,56,0,1
2020-04-27,SZ,Eswatini,AFRO,3,59,0,1
2020-04-28,SZ,Eswatini,AFRO,6,65,0,1
2020-04-29,SZ,Eswatini,AFRO,6,71,0,1
2020-04-30,SZ,Eswatini,AFRO,20,91,0,1
2020-05-01,SZ,Eswatini,AFRO,9,100,0,1
2020-05-02,SZ,Eswatini,AFRO,6,106,0,1
2020-05-03,SZ,Eswatini,AFRO,2,108,0,1
2020-05-04,SZ,Eswatini,AFRO,4,112,0,1
2020-05-05,SZ,Eswatini,AFRO,4,116,0,1
2020-05-06,SZ,Eswatini,AFRO,3,119,0,1
2020-05-07,SZ,Eswatini,AFRO,4,123,1,2
2020-05-08,SZ,Eswatini,AFRO,30,153,0,2
2020-05-09,SZ,Eswatini,AFRO,6,159,0,2
2020-05-10,SZ,Eswatini,AFRO,4,163,0,2
2020-05-11,SZ,Eswatini,AFRO,9,172,0,2
2020-05-12,SZ,Eswatini,AFRO,3,175,0,2
2020-05-13,SZ,Eswatini,AFRO,9,184,0,2
2020-05-14,SZ,Eswatini,AFRO,3,187,0,2
2020-05-15,SZ,Eswatini,AFRO,0,187,0,2
2020-05-16,SZ,Eswatini,AFRO,3,190,0,2
2020-05-17,SZ,Eswatini,AFRO,12,202,0,2
2020-05-18,SZ,Eswatini,AFRO,3,205,0,2
2020-05-19,SZ,Eswatini,AFRO,0,205,0,2
2020-05-20,SZ,Eswatini,AFRO,3,208,0,2
2020-05-21,SZ,Eswatini,AFRO,9,217,0,2
2020-05-22,SZ,Eswatini,AFRO,3,220,0,2
2020-05-23,SZ,Eswatini,AFRO,5,225,0,2
2020-05-24,SZ,Eswatini,AFRO,13,238,0,2
2020-05-25,SZ,Eswatini,AFRO,12,250,0,2
2020-05-26,SZ,Eswatini,AFRO,6,256,0,2
2020-05-27,SZ,Eswatini,AFRO,5,261,0,2
2020-05-28,SZ,Eswatini,AFRO,11,272,0,2
2020-05-29,SZ,Eswatini,AFRO,7,279,0,2
2020-05-30,SZ,Eswatini,AFRO,4,283,0,2
2020-05-31,SZ,Eswatini,AFRO,0,283,0,2
2020-06-01,SZ,Eswatini,AFRO,2,285,0,2
2020-06-02,SZ,Eswatini,AFRO,8,293,1,3
2020-06-03,SZ,Eswatini,AFRO,1,294,0,3
2020-06-04,SZ,Eswatini,AFRO,1,295,0,3
2020-06-05,SZ,Eswatini,AFRO,16,311,0,3
2020-06-06,SZ,Eswatini,AFRO,5,316,0,3
2020-06-07,SZ,Eswatini,AFRO,17,333,0,3
2020-06-08,SZ,Eswatini,AFRO,0,333,0,3
2020-03-29,ET,Ethiopia,AFRO,0,16,0,23
2020-03-30,ET,Ethiopia,AFRO,5,21,0,23
2020-03-31,ET,Ethiopia,AFRO,2,23,0,23
2020-04-01,ET,Ethiopia,AFRO,3,26,0,23
2020-04-02,ET,Ethiopia,AFRO,0,26,0,23
2020-04-03,ET,Ethiopia,AFRO,5,31,0,23
2020-04-04,ET,Ethiopia,AFRO,4,35,0,23
2020-04-05,ET,Ethiopia,AFRO,3,38,0,23
2020-04-06,ET,Ethiopia,AFRO,5,43,0,23
2020-04-07,ET,Ethiopia,AFRO,1,44,0,23
2020-04-08,ET,Ethiopia,AFRO,8,52,0,23
2020-04-09,ET,Ethiopia,AFRO,3,55,0,23
2020-04-10,ET,Ethiopia,AFRO,1,56,0,23
2020-04-11,ET,Ethiopia,AFRO,9,65,0,23
2020-04-12,ET,Ethiopia,AFRO,4,69,0,23
2020-04-13,ET,Ethiopia,AFRO,2,71,0,23
2020-04-14,ET,Ethiopia,AFRO,3,74,0,23
2020-04-15,ET,Ethiopia,AFRO,8,82,0,23
2020-04-16,ET,Ethiopia,AFRO,10,92,0,23
2020-04-17,ET,Ethiopia,AFRO,0,92,0,23
2020-04-18,ET,Ethiopia,AFRO,4,96,0,23
2020-04-19,ET,Ethiopia,AFRO,9,105,0,23
2020-04-20,ET,Ethiopia,AFRO,3,108,0,23
2020-04-21,ET,Ethiopia,AFRO,3,111,0,23
2020-04-22,ET,Ethiopia,AFRO,3,114,0,23
2020-04-23,ET,Ethiopia,AFRO,2,116,0,23
2020-04-24,ET,Ethiopia,AFRO,0,116,0,23
2020-04-25,ET,Ethiopia,AFRO,1,117,1,24
2020-04-26,ET,Ethiopia,AFRO,5,122,0,24
2020-04-27,ET,Ethiopia,AFRO,1,123,0,24
2020-04-28,ET,Ethiopia,AFRO,1,124,0,24
2020-04-29,ET,Ethiopia,AFRO,2,126,0,24
2020-04-30,ET,Ethiopia,AFRO,4,130,0,24
2020-05-01,ET,Ethiopia,AFRO,1,131,0,24
2020-05-02,ET,Ethiopia,AFRO,2,133,0,24
2020-05-03,ET,Ethiopia,AFRO,0,133,0,24
2020-05-04,ET,Ethiopia,AFRO,2,135,0,24
2020-05-05,ET,Ethiopia,AFRO,5,140,0,24
2020-05-06,ET,Ethiopia,AFRO,5,145,0,24
2020-05-07,ET,Ethiopia,AFRO,17,162,0,24
2020-05-08,ET,Ethiopia,AFRO,29,191,0,24
2020-05-09,ET,Ethiopia,AFRO,3,194,0,24
2020-05-10,ET,Ethiopia,AFRO,16,210,1,25
2020-05-11,ET,Ethiopia,AFRO,29,239,0,25
2020-05-12,ET,Ethiopia,AFRO,11,250,0,25
2020-05-13,ET,Ethiopia,AFRO,11,261,0,25
2020-05-14,ET,Ethiopia,AFRO,2,263,0,25
2020-05-15,ET,Ethiopia,AFRO,9,272,0,25
2020-05-16,ET,Ethiopia,AFRO,15,287,0,25
2020-05-17,ET,Ethiopia,AFRO,19,306,0,25
2020-05-18,ET,Ethiopia,AFRO,11,317,0,25
2020-05-19,ET,Ethiopia,AFRO,35,352,0,25
2020-05-20,ET,Ethiopia,AFRO,13,365,0,25
2020-05-21,ET,Ethiopia,AFRO,24,389,0,25
2020-05-22,ET,Ethiopia,AFRO,10,399,0,25
2020-05-23,ET,Ethiopia,AFRO,34,433,0,25
2020-05-24,ET,Ethiopia,AFRO,61,494,0,25
2020-05-25,ET,Ethiopia,AFRO,88,582,0,25
2020-05-26,ET,Ethiopia,AFRO,73,655,0,25
2020-05-27,ET,Ethiopia,AFRO,46,701,1,26
2020-05-28,ET,Ethiopia,AFRO,30,731,0,26
2020-05-29,ET,Ethiopia,AFRO,100,831,1,27
2020-05-30,ET,Ethiopia,AFRO,137,968,1,28
2020-05-31,ET,Ethiopia,AFRO,95,1063,0,28
2020-06-01,ET,Ethiopia,AFRO,109,1172,0,28
2020-06-02,ET,Ethiopia,AFRO,85,1257,1,29
2020-06-03,ET,Ethiopia,AFRO,87,1344,2,31
2020-06-04,ET,Ethiopia,AFRO,142,1486,3,34
2020-06-05,ET,Ethiopia,AFRO,150,1636,1,35
2020-06-06,ET,Ethiopia,AFRO,169,1805,1,36
2020-06-07,ET,Ethiopia,AFRO,129,1934,1,37
2020-06-08,ET,Ethiopia,AFRO,86,2020,7,44
2020-03-29,FK,Falkland Islands (Malvinas),AMRO,0,0,0,0
2020-03-30,FK,Falkland Islands (Malvinas),AMRO,0,0,0,0
2020-03-31,FK,Falkland Islands (Malvinas),AMRO,0,0,0,0
2020-04-01,FK,Falkland Islands (Malvinas),AMRO,0,0,0,0
2020-04-02,FK,Falkland Islands (Malvinas),AMRO,0,0,0,0
2020-04-03,FK,Falkland Islands (Malvinas),AMRO,0,0,0,0
2020-04-04,FK,Falkland Islands (Malvinas),AMRO,0,0,0,0
2020-04-05,FK,Falkland Islands (Malvinas),AMRO,1,1,0,0
2020-04-06,FK,Falkland Islands (Malvinas),AMRO,1,2,0,0
2020-04-07,FK,Falkland Islands (Malvinas),AMRO,0,2,0,0
2020-04-08,FK,Falkland Islands (Malvinas),AMRO,0,2,0,0
2020-04-09,FK,Falkland Islands (Malvinas),AMRO,3,5,0,0
2020-04-10,FK,Falkland Islands (Malvinas),AMRO,0,5,0,0
2020-04-11,FK,Falkland Islands (Malvinas),AMRO,0,5,0,0
2020-04-12,FK,Falkland Islands (Malvinas),AMRO,0,5,0,0
2020-04-13,FK,Falkland Islands (Malvinas),AMRO,0,5,0,0
2020-04-14,FK,Falkland Islands (Malvinas),AMRO,0,5,0,0
2020-04-15,FK,Falkland Islands (Malvinas),AMRO,6,11,0,0
2020-04-16,FK,Falkland Islands (Malvinas),AMRO,0,11,0,0
2020-04-17,FK,Falkland Islands (Malvinas),AMRO,0,11,0,0
2020-04-18,FK,Falkland Islands (Malvinas),AMRO,0,11,0,0
2020-04-19,FK,Falkland Islands (Malvinas),AMRO,0,11,0,0
2020-04-20,FK,Falkland Islands (Malvinas),AMRO,0,11,0,0
2020-04-21,FK,Falkland Islands (Malvinas),AMRO,0,11,0,0
2020-04-22,FK,Falkland Islands (Malvinas),AMRO,0,11,0,0
2020-04-23,FK,Falkland Islands (Malvinas),AMRO,1,12,0,0
2020-04-24,FK,Falkland Islands (Malvinas),AMRO,0,12,0,0
2020-04-25,FK,Falkland Islands (Malvinas),AMRO,0,12,0,0
2020-04-26,FK,Falkland Islands (Malvinas),AMRO,1,13,0,0
2020-04-27,FK,Falkland Islands (Malvinas),AMRO,0,13,0,0
2020-04-28,FK,Falkland Islands (Malvinas),AMRO,0,13,0,0
2020-04-29,FK,Falkland Islands (Malvinas),AMRO,0,13,0,0
2020-04-30,FK,Falkland Islands (Malvinas),AMRO,0,13,0,0
2020-05-01,FK,Falkland Islands (Malvinas),AMRO,0,13,0,0
2020-05-02,FK,Falkland Islands (Malvinas),AMRO,0,13,0,0
2020-05-03,FK,Falkland Islands (Malvinas),AMRO,0,13,0,0
2020-05-04,FK,Falkland Islands (Malvinas),AMRO,0,13,0,0
2020-05-05,FK,Falkland Islands (Malvinas),AMRO,0,13,0,0
2020-05-06,FK,Falkland Islands (Malvinas),AMRO,0,13,0,0
2020-05-07,FK,Falkland Islands (Malvinas),AMRO,0,13,0,0
2020-05-08,FK,Falkland Islands (Malvinas),AMRO,0,13,0,0
2020-05-09,FK,Falkland Islands (Malvinas),AMRO,0,13,0,0
2020-05-10,FK,Falkland Islands (Malvinas),AMRO,0,13,0,0
2020-05-11,FK,Falkland Islands (Malvinas),AMRO,0,13,0,0
2020-05-12,FK,Falkland Islands (Malvinas),AMRO,0,13,0,0
2020-05-13,FK,Falkland Islands (Malvinas),AMRO,0,13,0,0
2020-05-14,FK,Falkland Islands (Malvinas),AMRO,0,13,0,0
2020-05-15,FK,Falkland Islands (Malvinas),AMRO,0,13,0,0
2020-05-16,FK,Falkland Islands (Malvinas),AMRO,0,13,0,0
2020-05-17,FK,Falkland Islands (Malvinas),AMRO,0,13,0,0
2020-05-18,FK,Falkland Islands (Malvinas),AMRO,0,13,0,0
2020-05-19,FK,Falkland Islands (Malvinas),AMRO,0,13,0,0
2020-05-20,FK,Falkland Islands (Malvinas),AMRO,0,13,0,0
2020-05-21,FK,Falkland Islands (Malvinas),AMRO,0,13,0,0
2020-05-22,FK,Falkland Islands (Malvinas),AMRO,0,13,0,0
2020-05-23,FK,Falkland Islands (Malvinas),AMRO,0,13,0,0
2020-05-24,FK,Falkland Islands (Malvinas),AMRO,0,13,0,0
2020-05-25,FK,Falkland Islands (Malvinas),AMRO,0,13,0,0
2020-05-26,FK,Falkland Islands (Malvinas),AMRO,0,13,0,0
2020-05-27,FK,Falkland Islands (Malvinas),AMRO,0,13,0,0
2020-05-28,FK,Falkland Islands (Malvinas),AMRO,0,13,0,0
2020-05-29,FK,Falkland Islands (Malvinas),AMRO,0,13,0,0
2020-05-30,FK,Falkland Islands (Malvinas),AMRO,0,13,0,0
2020-05-31,FK,Falkland Islands (Malvinas),AMRO,0,13,0,0
2020-06-01,FK,Falkland Islands (Malvinas),AMRO,0,13,0,0
2020-06-02,FK,Falkland Islands (Malvinas),AMRO,0,13,0,0
2020-06-03,FK,Falkland Islands (Malvinas),AMRO,0,13,0,0
2020-06-04,FK,Falkland Islands (Malvinas),AMRO,0,13,0,0
2020-06-05,FK,Falkland Islands (Malvinas),AMRO,0,13,0,0
2020-06-06,FK,Falkland Islands (Malvinas),AMRO,0,13,0,0
2020-06-07,FK,Falkland Islands (Malvinas),AMRO,0,13,0,0
2020-06-08,FK,Falkland Islands (Malvinas),AMRO,0,13,0,0
2020-03-29,FO,Faroe Islands,EURO,6,156,0,0
2020-03-30,FO,Faroe Islands,EURO,4,160,0,0
2020-03-31,FO,Faroe Islands,EURO,8,168,0,0
2020-04-01,FO,Faroe Islands,EURO,2,170,0,0
2020-04-02,FO,Faroe Islands,EURO,4,174,0,0
2020-04-03,FO,Faroe Islands,EURO,4,178,0,0
2020-04-04,FO,Faroe Islands,EURO,1,179,0,0
2020-04-05,FO,Faroe Islands,EURO,2,181,0,0
2020-04-06,FO,Faroe Islands,EURO,0,181,0,0
2020-04-07,FO,Faroe Islands,EURO,2,183,0,0
2020-04-08,FO,Faroe Islands,EURO,1,184,0,0
2020-04-09,FO,Faroe Islands,EURO,0,184,0,0
2020-04-10,FO,Faroe Islands,EURO,0,184,0,0
2020-04-11,FO,Faroe Islands,EURO,0,184,0,0
2020-04-12,FO,Faroe Islands,EURO,0,184,0,0
2020-04-13,FO,Faroe Islands,EURO,0,184,0,0
2020-04-14,FO,Faroe Islands,EURO,0,184,0,0
2020-04-15,FO,Faroe Islands,EURO,0,184,0,0
2020-04-16,FO,Faroe Islands,EURO,0,184,0,0
2020-04-17,FO,Faroe Islands,EURO,0,184,0,0
2020-04-18,FO,Faroe Islands,EURO,0,184,0,0
2020-04-19,FO,Faroe Islands,EURO,1,185,0,0
2020-04-20,FO,Faroe Islands,EURO,0,185,0,0
2020-04-21,FO,Faroe Islands,EURO,0,185,0,0
2020-04-22,FO,Faroe Islands,EURO,0,185,0,0
2020-04-23,FO,Faroe Islands,EURO,2,187,0,0
2020-04-24,FO,Faroe Islands,EURO,0,187,0,0
2020-04-25,FO,Faroe Islands,EURO,0,187,0,0
2020-04-26,FO,Faroe Islands,EURO,0,187,0,0
2020-04-27,FO,Faroe Islands,EURO,0,187,0,0
2020-04-28,FO,Faroe Islands,EURO,0,187,0,0
2020-04-29,FO,Faroe Islands,EURO,0,187,0,0
2020-04-30,FO,Faroe Islands,EURO,0,187,0,0
2020-05-01,FO,Faroe Islands,EURO,0,187,0,0
2020-05-02,FO,Faroe Islands,EURO,0,187,0,0
2020-05-03,FO,Faroe Islands,EURO,0,187,0,0
2020-05-04,FO,Faroe Islands,EURO,0,187,0,0
2020-05-05,FO,Faroe Islands,EURO,0,187,0,0
2020-05-06,FO,Faroe Islands,EURO,0,187,0,0
2020-05-07,FO,Faroe Islands,EURO,0,187,0,0
2020-05-08,FO,Faroe Islands,EURO,0,187,0,0
2020-05-09,FO,Faroe Islands,EURO,0,187,0,0
2020-05-10,FO,Faroe Islands,EURO,0,187,0,0
2020-05-11,FO,Faroe Islands,EURO,0,187,0,0
2020-05-12,FO,Faroe Islands,EURO,0,187,0,0
2020-05-13,FO,Faroe Islands,EURO,0,187,0,0
2020-05-14,FO,Faroe Islands,EURO,0,187,0,0
2020-05-15,FO,Faroe Islands,EURO,0,187,0,0
2020-05-16,FO,Faroe Islands,EURO,0,187,0,0
2020-05-17,FO,Faroe Islands,EURO,0,187,0,0
2020-05-18,FO,Faroe Islands,EURO,0,187,0,0
2020-05-19,FO,Faroe Islands,EURO,0,187,0,0
2020-05-20,FO,Faroe Islands,EURO,0,187,0,0
2020-05-21,FO,Faroe Islands,EURO,0,187,0,0
2020-05-22,FO,Faroe Islands,EURO,0,187,0,0
2020-05-23,FO,Faroe Islands,EURO,0,187,0,0
2020-05-24,FO,Faroe Islands,EURO,0,187,0,0
2020-05-25,FO,Faroe Islands,EURO,0,187,0,0
2020-05-26,FO,Faroe Islands,EURO,0,187,0,0
2020-05-27,FO,Faroe Islands,EURO,0,187,0,0
2020-05-28,FO,Faroe Islands,EURO,0,187,0,0
2020-05-29,FO,Faroe Islands,EURO,0,187,0,0
2020-05-30,FO,Faroe Islands,EURO,0,187,0,0
2020-05-31,FO,Faroe Islands,EURO,0,187,0,0
2020-06-01,FO,Faroe Islands,EURO,0,187,0,0
2020-06-02,FO,Faroe Islands,EURO,0,187,0,0
2020-06-03,FO,Faroe Islands,EURO,0,187,0,0
2020-06-04,FO,Faroe Islands,EURO,0,187,0,0
2020-06-05,FO,Faroe Islands,EURO,0,187,0,0
2020-06-06,FO,Faroe Islands,EURO,0,187,0,0
2020-06-07,FO,Faroe Islands,EURO,0,187,0,0
2020-06-08,FO,Faroe Islands,EURO,0,187,0,0
2020-03-29,FJ,Fiji,WPRO,0,5,0,0
2020-03-30,FJ,Fiji,WPRO,0,5,0,0
2020-03-31,FJ,Fiji,WPRO,0,5,0,0
2020-04-01,FJ,Fiji,WPRO,0,5,0,0
2020-04-02,FJ,Fiji,WPRO,0,5,0,0
2020-04-03,FJ,Fiji,WPRO,2,7,0,0
2020-04-04,FJ,Fiji,WPRO,0,7,0,0
2020-04-05,FJ,Fiji,WPRO,5,12,0,0
2020-04-06,FJ,Fiji,WPRO,0,12,0,0
2020-04-07,FJ,Fiji,WPRO,3,15,0,0
2020-04-08,FJ,Fiji,WPRO,0,15,0,0
2020-04-09,FJ,Fiji,WPRO,0,15,0,0
2020-04-10,FJ,Fiji,WPRO,0,15,0,0
2020-04-11,FJ,Fiji,WPRO,1,16,0,0
2020-04-12,FJ,Fiji,WPRO,0,16,0,0
2020-04-13,FJ,Fiji,WPRO,0,16,0,0
2020-04-14,FJ,Fiji,WPRO,0,16,0,0
2020-04-15,FJ,Fiji,WPRO,0,16,0,0
2020-04-16,FJ,Fiji,WPRO,0,16,0,0
2020-04-17,FJ,Fiji,WPRO,1,17,0,0
2020-04-18,FJ,Fiji,WPRO,0,17,0,0
2020-04-19,FJ,Fiji,WPRO,0,17,0,0
2020-04-20,FJ,Fiji,WPRO,0,17,0,0
2020-04-21,FJ,Fiji,WPRO,1,18,0,0
2020-04-22,FJ,Fiji,WPRO,0,18,0,0
2020-04-23,FJ,Fiji,WPRO,0,18,0,0
2020-04-24,FJ,Fiji,WPRO,0,18,0,0
2020-04-25,FJ,Fiji,WPRO,0,18,0,0
2020-04-26,FJ,Fiji,WPRO,0,18,0,0
2020-04-27,FJ,Fiji,WPRO,0,18,0,0
2020-04-28,FJ,Fiji,WPRO,0,18,0,0
2020-04-29,FJ,Fiji,WPRO,0,18,0,0
2020-04-30,FJ,Fiji,WPRO,0,18,0,0
2020-05-01,FJ,Fiji,WPRO,0,18,0,0
2020-05-02,FJ,Fiji,WPRO,0,18,0,0
2020-05-03,FJ,Fiji,WPRO,0,18,0,0
2020-05-04,FJ,Fiji,WPRO,0,18,0,0
2020-05-05,FJ,Fiji,WPRO,0,18,0,0
2020-05-06,FJ,Fiji,WPRO,0,18,0,0
2020-05-07,FJ,Fiji,WPRO,0,18,0,0
2020-05-08,FJ,Fiji,WPRO,0,18,0,0
2020-05-09,FJ,Fiji,WPRO,0,18,0,0
2020-05-10,FJ,Fiji,WPRO,0,18,0,0
2020-05-11,FJ,Fiji,WPRO,0,18,0,0
2020-05-12,FJ,Fiji,WPRO,0,18,0,0
2020-05-13,FJ,Fiji,WPRO,0,18,0,0
2020-05-14,FJ,Fiji,WPRO,0,18,0,0
2020-05-15,FJ,Fiji,WPRO,0,18,0,0
2020-05-16,FJ,Fiji,WPRO,0,18,0,0
2020-05-17,FJ,Fiji,WPRO,0,18,0,0
2020-05-18,FJ,Fiji,WPRO,0,18,0,0
2020-05-19,FJ,Fiji,WPRO,0,18,0,0
2020-05-20,FJ,Fiji,WPRO,0,18,0,0
2020-05-21,FJ,Fiji,WPRO,0,18,0,0
2020-05-22,FJ,Fiji,WPRO,0,18,0,0
2020-05-23,FJ,Fiji,WPRO,0,18,0,0
2020-05-24,FJ,Fiji,WPRO,0,18,0,0
2020-05-25,FJ,Fiji,WPRO,0,18,0,0
2020-05-26,FJ,Fiji,WPRO,0,18,0,0
2020-05-27,FJ,Fiji,WPRO,0,18,0,0
2020-05-28,FJ,Fiji,WPRO,0,18,0,0
2020-05-29,FJ,Fiji,WPRO,0,18,0,0
2020-05-30,FJ,Fiji,WPRO,0,18,0,0
2020-05-31,FJ,Fiji,WPRO,0,18,0,0
2020-06-01,FJ,Fiji,WPRO,0,18,0,0
2020-06-02,FJ,Fiji,WPRO,0,18,0,0
2020-06-03,FJ,Fiji,WPRO,0,18,0,0
2020-06-04,FJ,Fiji,WPRO,0,18,0,0
2020-06-05,FJ,Fiji,WPRO,0,18,0,0
2020-06-06,FJ,Fiji,WPRO,0,18,0,0
2020-06-07,FJ,Fiji,WPRO,0,18,0,0
2020-06-08,FJ,Fiji,WPRO,0,18,0,0
2020-03-29,FI,Finland,EURO,95,1396,2,27
2020-03-30,FI,Finland,EURO,77,1473,4,31
2020-03-31,FI,Finland,EURO,70,1543,10,41
2020-04-01,FI,Finland,EURO,129,1672,10,51
2020-04-02,FI,Finland,EURO,125,1797,7,58
2020-04-03,FI,Finland,EURO,149,1946,4,62
2020-04-04,FI,Finland,EURO,161,2107,6,68
2020-04-05,FI,Finland,EURO,199,2306,5,73
2020-04-06,FI,Finland,EURO,81,2387,7,80
2020-04-07,FI,Finland,EURO,122,2509,4,84
2020-04-08,FI,Finland,EURO,209,2718,10,94
2020-04-09,FI,Finland,EURO,200,2918,17,111
2020-04-10,FI,Finland,EURO,138,3056,8,119
2020-04-11,FI,Finland,EURO,158,3214,11,130
2020-04-12,FI,Finland,EURO,71,3285,3,133
2020-04-13,FI,Finland,EURO,75,3360,3,136
2020-04-14,FI,Finland,EURO,80,3440,11,147
2020-04-15,FI,Finland,EURO,117,3557,12,159
2020-04-16,FI,Finland,EURO,175,3732,10,169
2020-04-17,FI,Finland,EURO,130,3862,14,183
2020-04-18,FI,Finland,EURO,120,3982,12,195
2020-04-19,FI,Finland,EURO,125,4107,10,205
2020-04-20,FI,Finland,EURO,56,4163,0,205
2020-04-21,FI,Finland,EURO,67,4230,6,211
2020-04-22,FI,Finland,EURO,143,4373,17,228
2020-04-23,FI,Finland,EURO,112,4485,4,232
2020-04-24,FI,Finland,EURO,124,4609,6,238
2020-04-25,FI,Finland,EURO,116,4725,0,238
2020-04-26,FI,Finland,EURO,92,4817,3,241
2020-04-27,FI,Finland,EURO,76,4893,6,247
2020-04-28,FI,Finland,EURO,73,4966,5,252
2020-04-29,FI,Finland,EURO,123,5089,1,253
2020-04-30,FI,Finland,EURO,139,5228,2,255
2020-05-01,FI,Finland,EURO,108,5336,1,256
2020-05-02,FI,Finland,EURO,86,5422,4,260
2020-05-03,FI,Finland,EURO,48,5470,2,262
2020-05-04,FI,Finland,EURO,58,5528,3,265
2020-05-05,FI,Finland,EURO,61,5589,3,268
2020-05-06,FI,Finland,EURO,133,5722,7,275
2020-05-07,FI,Finland,EURO,125,5847,4,279
2020-05-08,FI,Finland,EURO,95,5942,2,281
2020-05-09,FI,Finland,EURO,108,6050,7,288
2020-05-10,FI,Finland,EURO,81,6131,1,289
2020-05-11,FI,Finland,EURO,47,6178,2,291
2020-05-12,FI,Finland,EURO,28,6206,0,291
2020-05-13,FI,Finland,EURO,92,6298,1,292
2020-05-14,FI,Finland,EURO,67,6365,2,294
2020-05-15,FI,Finland,EURO,78,6443,2,296
2020-05-16,FI,Finland,EURO,50,6493,0,296
2020-05-17,FI,Finland,EURO,55,6548,1,297
2020-05-18,FI,Finland,EURO,25,6573,2,299
2020-05-19,FI,Finland,EURO,29,6602,0,299
2020-05-20,FI,Finland,EURO,45,6647,2,301
2020-05-21,FI,Finland,EURO,41,6688,0,301
2020-05-22,FI,Finland,EURO,43,6731,1,302
2020-05-23,FI,Finland,EURO,22,6753,0,302
2020-05-24,FI,Finland,EURO,32,6785,1,303
2020-05-25,FI,Finland,EURO,18,6803,0,303
2020-05-26,FI,Finland,EURO,20,6823,0,303
2020-05-27,FI,Finland,EURO,45,6868,1,304
2020-05-28,FI,Finland,EURO,33,6901,0,304
2020-05-29,FI,Finland,EURO,12,6913,0,304
2020-05-30,FI,Finland,EURO,30,6943,0,304
2020-05-31,FI,Finland,EURO,21,6964,1,305
2020-06-01,FI,Finland,EURO,10,6974,0,305
2020-06-02,FI,Finland,EURO,12,6986,0,305
2020-06-03,FI,Finland,EURO,17,7003,0,305
2020-06-04,FI,Finland,EURO,15,7018,0,305
2020-06-05,FI,Finland,EURO,25,7043,0,305
2020-06-06,FI,Finland,EURO,12,7055,0,305
2020-06-07,FI,Finland,EURO,13,7068,0,305
2020-06-08,FI,Finland,EURO,13,7081,0,305
2020-03-29,FR,France,EURO,4611,37145,319,2311
2020-03-30,FR,France,EURO,2491,39636,291,2602
2020-03-31,FR,France,EURO,4341,43977,415,3017
2020-04-01,FR,France,EURO,7500,51477,497,3514
2020-04-02,FR,France,EURO,4784,56261,505,4019
2020-04-03,FR,France,EURO,2066,58327,471,4490
2020-04-04,FR,France,EURO,5209,63536,2003,6493
2020-04-05,FR,France,EURO,4221,67757,1053,7546
2020-04-06,FR,France,EURO,1850,69607,518,8064
2020-04-07,FR,France,EURO,3881,73488,832,8896
2020-04-08,FR,France,EURO,3737,77225,1417,10313
2020-04-09,FR,France,EURO,3869,81094,540,10853
2020-04-10,FR,France,EURO,4256,85350,1339,12192
2020-04-11,FR,France,EURO,4333,89683,987,13179
2020-04-12,FR,France,EURO,3104,92787,635,13814
2020-04-13,FR,France,EURO,1595,94382,560,14374
2020-04-14,FR,France,EURO,2669,97051,572,14946
2020-04-15,FR,France,EURO,5483,102534,762,15708
2020-04-16,FR,France,EURO,2621,105155,1438,17146
2020-04-17,FR,France,EURO,2623,107778,753,17899
2020-04-18,FR,France,EURO,385,108163,760,18659
2020-04-19,FR,France,EURO,2558,110721,635,19294
2020-04-20,FR,France,EURO,742,111463,395,19689
2020-04-21,FR,France,EURO,2050,113513,544,20233
2020-04-22,FR,France,EURO,2638,116151,530,20763
2020-04-23,FR,France,EURO,1810,117961,544,21307
2020-04-24,FR,France,EURO,1623,119584,516,21823
2020-04-25,FR,France,EURO,1755,121339,389,22212
2020-04-26,FR,France,EURO,1537,122876,368,22580
2020-04-27,FR,France,EURO,404,123280,241,22821
2020-04-28,FR,France,EURO,1160,124440,440,23261
2020-04-29,FR,France,EURO,1025,125465,366,23627
2020-04-30,FR,France,EURO,1601,127066,427,24054
2020-05-01,FR,France,EURO,1055,128121,288,24342
2020-05-02,FR,France,EURO,601,128722,218,24560
2020-05-03,FR,France,EURO,736,129458,164,24724
2020-05-04,FR,France,EURO,250,129708,135,24859
2020-05-05,FR,France,EURO,534,130242,306,25165
2020-05-06,FR,France,EURO,1050,131292,326,25491
2020-05-07,FR,France,EURO,4176,135468,278,25769
2020-05-08,FR,France,EURO,512,135980,177,25946
2020-05-09,FR,France,EURO,598,136578,242,26188
2020-05-10,FR,France,EURO,430,137008,80,26268
2020-05-11,FR,France,EURO,65,137073,70,26338
2020-05-12,FR,France,EURO,863,137936,262,26600
2020-05-13,FR,France,EURO,977,138913,348,26948
2020-05-14,FR,France,EURO,985,139898,81,27029
2020-05-15,FR,France,EURO,213,140111,349,27378
2020-05-16,FR,France,EURO,73,140184,130,27508
2020-05-17,FR,France,EURO,1110,141294,88,27596
2020-05-18,FR,France,EURO,963,142257,66,27662
2020-05-19,FR,France,EURO,1027,143284,186,27848
2020-05-20,FR,France,EURO,131,143415,124,27972
2020-05-21,FR,France,EURO,761,144176,109,28081
2020-05-22,FR,France,EURO,226,144402,83,28164
2020-05-23,FR,France,EURO,101,144503,74,28238
2020-05-24,FR,France,EURO,692,145195,43,28281
2020-05-25,FR,France,EURO,689,145884,34,28315
2020-05-26,FR,France,EURO,649,146533,64,28379
2020-05-27,FR,France,EURO,587,147120,98,28477
2020-05-28,FR,France,EURO,552,147672,66,28543
2020-05-29,FR,France,EURO,316,147988,65,28608
2020-05-30,FR,France,EURO,126,148114,52,28660
2020-05-31,FR,France,EURO,122,148236,57,28717
2020-06-01,FR,France,EURO,554,148790,29,28746
2020-06-02,FR,France,EURO,572,149362,30,28776
2020-06-03,FR,France,EURO,548,149910,107,28883
2020-06-04,FR,France,EURO,536,150446,81,28964
2020-06-05,FR,France,EURO,207,150653,43,29007
2020-06-06,FR,France,EURO,81,150734,46,29053
2020-06-07,FR,France,EURO,507,151241,31,29084
2020-06-08,FR,France,EURO,524,151765,13,29097
2020-03-29,GF,French Guiana,AMRO,0,31,0,0
2020-03-30,GF,French Guiana,AMRO,0,31,0,0
2020-03-31,GF,French Guiana,AMRO,12,43,0,0
2020-04-01,GF,French Guiana,AMRO,3,46,0,0
2020-04-02,GF,French Guiana,AMRO,5,51,0,0
2020-04-03,GF,French Guiana,AMRO,4,55,0,0
2020-04-04,GF,French Guiana,AMRO,2,57,0,0
2020-04-05,GF,French Guiana,AMRO,5,62,0,0
2020-04-06,GF,French Guiana,AMRO,4,66,0,0
2020-04-07,GF,French Guiana,AMRO,2,68,0,0
2020-04-08,GF,French Guiana,AMRO,4,72,0,0
2020-04-09,GF,French Guiana,AMRO,5,77,0,0
2020-04-10,GF,French Guiana,AMRO,6,83,0,0
2020-04-11,GF,French Guiana,AMRO,1,84,0,0
2020-04-12,GF,French Guiana,AMRO,2,86,0,0
2020-04-13,GF,French Guiana,AMRO,0,86,0,0
2020-04-14,GF,French Guiana,AMRO,2,88,0,0
2020-04-15,GF,French Guiana,AMRO,0,88,0,0
2020-04-16,GF,French Guiana,AMRO,7,95,0,0
2020-04-17,GF,French Guiana,AMRO,1,96,0,0
2020-04-18,GF,French Guiana,AMRO,0,96,0,0
2020-04-19,GF,French Guiana,AMRO,0,96,0,0
2020-04-20,GF,French Guiana,AMRO,0,96,0,0
2020-04-21,GF,French Guiana,AMRO,1,97,1,1
2020-04-22,GF,French Guiana,AMRO,0,97,0,1
2020-04-23,GF,French Guiana,AMRO,0,97,0,1
2020-04-24,GF,French Guiana,AMRO,10,107,0,1
2020-04-25,GF,French Guiana,AMRO,2,109,0,1
2020-04-26,GF,French Guiana,AMRO,0,109,0,1
2020-04-27,GF,French Guiana,AMRO,0,109,0,1
2020-04-28,GF,French Guiana,AMRO,2,111,0,1
2020-04-29,GF,French Guiana,AMRO,13,124,0,1
2020-04-30,GF,French Guiana,AMRO,1,125,0,1
2020-05-01,GF,French Guiana,AMRO,1,126,0,1
2020-05-02,GF,French Guiana,AMRO,2,128,0,1
2020-05-03,GF,French Guiana,AMRO,0,128,0,1
2020-05-04,GF,French Guiana,AMRO,0,128,0,1
2020-05-05,GF,French Guiana,AMRO,5,133,0,1
2020-05-06,GF,French Guiana,AMRO,0,133,0,1
2020-05-07,GF,French Guiana,AMRO,5,138,0,1
2020-05-08,GF,French Guiana,AMRO,0,138,0,1
2020-05-09,GF,French Guiana,AMRO,3,141,0,1
2020-05-10,GF,French Guiana,AMRO,0,141,0,1
2020-05-11,GF,French Guiana,AMRO,3,144,0,1
2020-05-12,GF,French Guiana,AMRO,0,144,0,1
2020-05-13,GF,French Guiana,AMRO,2,146,0,1
2020-05-14,GF,French Guiana,AMRO,7,153,0,1
2020-05-15,GF,French Guiana,AMRO,11,164,0,1
2020-05-16,GF,French Guiana,AMRO,20,184,0,1
2020-05-17,GF,French Guiana,AMRO,5,189,0,1
2020-05-18,GF,French Guiana,AMRO,8,197,0,1
2020-05-19,GF,French Guiana,AMRO,0,197,0,1
2020-05-20,GF,French Guiana,AMRO,13,210,0,1
2020-05-21,GF,French Guiana,AMRO,8,218,0,1
2020-05-22,GF,French Guiana,AMRO,19,237,0,1
2020-05-23,GF,French Guiana,AMRO,12,249,0,1
2020-05-24,GF,French Guiana,AMRO,12,261,0,1
2020-05-25,GF,French Guiana,AMRO,18,279,0,1
2020-05-26,GF,French Guiana,AMRO,49,328,0,1
2020-05-27,GF,French Guiana,AMRO,25,353,0,1
2020-05-28,GF,French Guiana,AMRO,31,384,0,1
2020-05-29,GF,French Guiana,AMRO,25,409,0,1
2020-05-30,GF,French Guiana,AMRO,27,436,0,1
2020-05-31,GF,French Guiana,AMRO,0,436,0,1
2020-06-01,GF,French Guiana,AMRO,41,477,0,1
2020-06-02,GF,French Guiana,AMRO,22,499,0,1
2020-06-03,GF,French Guiana,AMRO,18,517,0,1
2020-06-04,GF,French Guiana,AMRO,16,533,0,1
2020-06-05,GF,French Guiana,AMRO,23,556,0,1
2020-06-06,GF,French Guiana,AMRO,33,589,0,1
2020-06-07,GF,French Guiana,AMRO,50,639,0,1
2020-06-08,GF,French Guiana,AMRO,50,689,0,1
2020-03-29,PF,French Polynesia,WPRO,1,35,0,0
2020-03-30,PF,French Polynesia,WPRO,0,35,0,0
2020-03-31,PF,French Polynesia,WPRO,1,36,0,0
2020-04-01,PF,French Polynesia,WPRO,1,37,0,0
2020-04-02,PF,French Polynesia,WPRO,0,37,0,0
2020-04-03,PF,French Polynesia,WPRO,0,37,0,0
2020-04-04,PF,French Polynesia,WPRO,2,39,0,0
2020-04-05,PF,French Polynesia,WPRO,1,40,0,0
2020-04-06,PF,French Polynesia,WPRO,1,41,0,0
2020-04-07,PF,French Polynesia,WPRO,1,42,0,0
2020-04-08,PF,French Polynesia,WPRO,5,47,0,0
2020-04-09,PF,French Polynesia,WPRO,4,51,0,0
2020-04-10,PF,French Polynesia,WPRO,0,51,0,0
2020-04-11,PF,French Polynesia,WPRO,0,51,0,0
2020-04-12,PF,French Polynesia,WPRO,0,51,0,0
2020-04-13,PF,French Polynesia,WPRO,2,53,0,0
2020-04-14,PF,French Polynesia,WPRO,2,55,0,0
2020-04-15,PF,French Polynesia,WPRO,0,55,0,0
2020-04-16,PF,French Polynesia,WPRO,0,55,0,0
2020-04-17,PF,French Polynesia,WPRO,0,55,0,0
2020-04-18,PF,French Polynesia,WPRO,0,55,0,0
2020-04-19,PF,French Polynesia,WPRO,0,55,0,0
2020-04-20,PF,French Polynesia,WPRO,0,55,0,0
2020-04-21,PF,French Polynesia,WPRO,1,56,0,0
2020-04-22,PF,French Polynesia,WPRO,1,57,0,0
2020-04-23,PF,French Polynesia,WPRO,0,57,0,0
2020-04-24,PF,French Polynesia,WPRO,0,57,0,0
2020-04-25,PF,French Polynesia,WPRO,0,57,0,0
2020-04-26,PF,French Polynesia,WPRO,0,57,0,0
2020-04-27,PF,French Polynesia,WPRO,0,57,0,0
2020-04-28,PF,French Polynesia,WPRO,1,58,0,0
2020-04-29,PF,French Polynesia,WPRO,0,58,0,0
2020-04-30,PF,French Polynesia,WPRO,0,58,0,0
2020-05-01,PF,French Polynesia,WPRO,0,58,0,0
2020-05-02,PF,French Polynesia,WPRO,0,58,0,0
2020-05-03,PF,French Polynesia,WPRO,0,58,0,0
2020-05-04,PF,French Polynesia,WPRO,0,58,0,0
2020-05-05,PF,French Polynesia,WPRO,0,58,0,0
2020-05-06,PF,French Polynesia,WPRO,2,60,0,0
2020-05-07,PF,French Polynesia,WPRO,0,60,0,0
2020-05-08,PF,French Polynesia,WPRO,0,60,0,0
2020-05-09,PF,French Polynesia,WPRO,0,60,0,0
2020-05-10,PF,French Polynesia,WPRO,0,60,0,0
2020-05-11,PF,French Polynesia,WPRO,0,60,0,0
2020-05-12,PF,French Polynesia,WPRO,0,60,0,0
2020-05-13,PF,French Polynesia,WPRO,0,60,0,0
2020-05-14,PF,French Polynesia,WPRO,0,60,0,0
2020-05-15,PF,French Polynesia,WPRO,0,60,0,0
2020-05-16,PF,French Polynesia,WPRO,0,60,0,0
2020-05-17,PF,French Polynesia,WPRO,0,60,0,0
2020-05-18,PF,French Polynesia,WPRO,0,60,0,0
2020-05-19,PF,French Polynesia,WPRO,0,60,0,0
2020-05-20,PF,French Polynesia,WPRO,0,60,0,0
2020-05-21,PF,French Polynesia,WPRO,0,60,0,0
2020-05-22,PF,French Polynesia,WPRO,0,60,0,0
2020-05-23,PF,French Polynesia,WPRO,0,60,0,0
2020-05-24,PF,French Polynesia,WPRO,0,60,0,0
2020-05-25,PF,French Polynesia,WPRO,0,60,0,0
2020-05-26,PF,French Polynesia,WPRO,0,60,0,0
2020-05-27,PF,French Polynesia,WPRO,0,60,0,0
2020-05-28,PF,French Polynesia,WPRO,0,60,0,0
2020-05-29,PF,French Polynesia,WPRO,0,60,0,0
2020-05-30,PF,French Polynesia,WPRO,0,60,0,0
2020-05-31,PF,French Polynesia,WPRO,0,60,0,0
2020-06-01,PF,French Polynesia,WPRO,0,60,0,0
2020-06-02,PF,French Polynesia,WPRO,0,60,0,0
2020-06-03,PF,French Polynesia,WPRO,0,60,0,0
2020-06-04,PF,French Polynesia,WPRO,0,60,0,0
2020-06-05,PF,French Polynesia,WPRO,0,60,0,0
2020-06-06,PF,French Polynesia,WPRO,0,60,0,0
2020-06-07,PF,French Polynesia,WPRO,0,60,0,0
2020-06-08,PF,French Polynesia,WPRO,0,60,0,0
2020-03-29,GA,Gabon,AFRO,0,7,0,3
2020-03-30,GA,Gabon,AFRO,0,7,0,3
2020-03-31,GA,Gabon,AFRO,9,16,0,3
2020-04-01,GA,Gabon,AFRO,2,18,0,3
2020-04-02,GA,Gabon,AFRO,0,18,0,3
2020-04-03,GA,Gabon,AFRO,3,21,0,3
2020-04-04,GA,Gabon,AFRO,0,21,0,3
2020-04-05,GA,Gabon,AFRO,0,21,0,3
2020-04-06,GA,Gabon,AFRO,4,25,0,3
2020-04-07,GA,Gabon,AFRO,0,25,0,3
2020-04-08,GA,Gabon,AFRO,0,25,0,3
2020-04-09,GA,Gabon,AFRO,11,36,0,3
2020-04-10,GA,Gabon,AFRO,9,45,0,3
2020-04-11,GA,Gabon,AFRO,2,47,0,3
2020-04-12,GA,Gabon,AFRO,3,50,0,3
2020-04-13,GA,Gabon,AFRO,8,58,0,3
2020-04-14,GA,Gabon,AFRO,18,76,0,3
2020-04-15,GA,Gabon,AFRO,5,81,0,3
2020-04-16,GA,Gabon,AFRO,7,88,0,3
2020-04-17,GA,Gabon,AFRO,8,96,0,3
2020-04-18,GA,Gabon,AFRO,13,109,0,3
2020-04-19,GA,Gabon,AFRO,1,110,0,3
2020-04-20,GA,Gabon,AFRO,0,110,0,3
2020-04-21,GA,Gabon,AFRO,11,121,0,3
2020-04-22,GA,Gabon,AFRO,36,157,0,3
2020-04-23,GA,Gabon,AFRO,10,167,0,3
2020-04-24,GA,Gabon,AFRO,0,167,1,4
2020-04-25,GA,Gabon,AFRO,6,173,1,5
2020-04-26,GA,Gabon,AFRO,4,177,0,5
2020-04-27,GA,Gabon,AFRO,0,177,0,5
2020-04-28,GA,Gabon,AFRO,35,212,0,5
2020-04-29,GA,Gabon,AFRO,27,239,0,5
2020-04-30,GA,Gabon,AFRO,38,277,0,5
2020-05-01,GA,Gabon,AFRO,0,277,0,5
2020-05-02,GA,Gabon,AFRO,32,309,1,6
2020-05-03,GA,Gabon,AFRO,27,336,1,7
2020-05-04,GA,Gabon,AFRO,0,336,0,7
2020-05-05,GA,Gabon,AFRO,32,368,1,8
2020-05-06,GA,Gabon,AFRO,29,397,0,8
2020-05-07,GA,Gabon,AFRO,0,397,0,8
2020-05-08,GA,Gabon,AFRO,107,504,0,8
2020-05-09,GA,Gabon,AFRO,116,620,0,8
2020-05-10,GA,Gabon,AFRO,41,661,0,8
2020-05-11,GA,Gabon,AFRO,0,661,0,8
2020-05-12,GA,Gabon,AFRO,141,802,1,9
2020-05-13,GA,Gabon,AFRO,61,863,0,9
2020-05-14,GA,Gabon,AFRO,141,1004,0,9
2020-05-15,GA,Gabon,AFRO,100,1104,1,10
2020-05-16,GA,Gabon,AFRO,105,1209,0,10
2020-05-17,GA,Gabon,AFRO,111,1320,1,11
2020-05-18,GA,Gabon,AFRO,0,1320,0,11
2020-05-19,GA,Gabon,AFRO,112,1432,0,11
2020-05-20,GA,Gabon,AFRO,70,1502,1,12
2020-05-21,GA,Gabon,AFRO,65,1567,0,12
2020-05-22,GA,Gabon,AFRO,0,1567,0,12
2020-05-23,GA,Gabon,AFRO,161,1728,0,12
2020-05-24,GA,Gabon,AFRO,206,1934,0,12
2020-05-25,GA,Gabon,AFRO,0,1934,0,12
2020-05-26,GA,Gabon,AFRO,201,2135,2,14
2020-05-27,GA,Gabon,AFRO,103,2238,0,14
2020-05-28,GA,Gabon,AFRO,81,2319,0,14
2020-05-29,GA,Gabon,AFRO,112,2431,0,14
2020-05-30,GA,Gabon,AFRO,182,2613,1,15
2020-05-31,GA,Gabon,AFRO,42,2655,2,17
2020-06-01,GA,Gabon,AFRO,148,2803,3,20
2020-06-02,GA,Gabon,AFRO,0,2803,0,20
2020-06-03,GA,Gabon,AFRO,0,2803,0,20
2020-06-04,GA,Gabon,AFRO,99,2902,0,20
2020-06-05,GA,Gabon,AFRO,53,2955,1,21
2020-06-06,GA,Gabon,AFRO,146,3101,0,21
2020-06-07,GA,Gabon,AFRO,0,3101,0,21
2020-06-08,GA,Gabon,AFRO,0,3101,0,21
2020-03-29,GM,Gambia,AFRO,0,3,0,113
2020-03-30,GM,Gambia,AFRO,1,4,0,113
2020-03-31,GM,Gambia,AFRO,0,4,0,113
2020-04-01,GM,Gambia,AFRO,0,4,0,113
2020-04-02,GM,Gambia,AFRO,0,4,0,113
2020-04-03,GM,Gambia,AFRO,0,4,0,113
2020-04-04,GM,Gambia,AFRO,0,4,0,113
2020-04-05,GM,Gambia,AFRO,0,4,0,113
2020-04-06,GM,Gambia,AFRO,0,4,0,113
2020-04-07,GM,Gambia,AFRO,0,4,0,113
2020-04-08,GM,Gambia,AFRO,0,4,0,113
2020-04-09,GM,Gambia,AFRO,0,4,0,113
2020-04-10,GM,Gambia,AFRO,0,4,0,113
2020-04-11,GM,Gambia,AFRO,0,4,0,113
2020-04-12,GM,Gambia,AFRO,5,9,0,113
2020-04-13,GM,Gambia,AFRO,0,9,0,113
2020-04-14,GM,Gambia,AFRO,0,9,0,113
2020-04-15,GM,Gambia,AFRO,0,9,0,113
2020-04-16,GM,Gambia,AFRO,0,9,0,113
2020-04-17,GM,Gambia,AFRO,0,9,0,113
2020-04-18,GM,Gambia,AFRO,0,9,0,113
2020-04-19,GM,Gambia,AFRO,0,9,0,113
2020-04-20,GM,Gambia,AFRO,1,10,0,113
2020-04-21,GM,Gambia,AFRO,0,10,0,113
2020-04-22,GM,Gambia,AFRO,0,10,0,113
2020-04-23,GM,Gambia,AFRO,0,10,0,113
2020-04-24,GM,Gambia,AFRO,0,10,0,113
2020-04-25,GM,Gambia,AFRO,0,10,0,113
2020-04-26,GM,Gambia,AFRO,0,10,0,113
2020-04-27,GM,Gambia,AFRO,0,10,0,113
2020-04-28,GM,Gambia,AFRO,0,10,0,113
2020-04-29,GM,Gambia,AFRO,1,11,0,113
2020-04-30,GM,Gambia,AFRO,0,11,0,113
2020-05-01,GM,Gambia,AFRO,1,12,0,113
2020-05-02,GM,Gambia,AFRO,5,17,0,113
2020-05-03,GM,Gambia,AFRO,0,17,0,113
2020-05-04,GM,Gambia,AFRO,0,17,0,113
2020-05-05,GM,Gambia,AFRO,0,17,0,113
2020-05-06,GM,Gambia,AFRO,0,17,0,113
2020-05-07,GM,Gambia,AFRO,0,17,0,113
2020-05-08,GM,Gambia,AFRO,1,18,0,113
2020-05-09,GM,Gambia,AFRO,2,20,0,113
2020-05-10,GM,Gambia,AFRO,0,20,0,113
2020-05-11,GM,Gambia,AFRO,0,20,0,113
2020-05-12,GM,Gambia,AFRO,2,22,0,113
2020-05-13,GM,Gambia,AFRO,1,23,0,113
2020-05-14,GM,Gambia,AFRO,0,23,0,113
2020-05-15,GM,Gambia,AFRO,0,23,0,113
2020-05-16,GM,Gambia,AFRO,0,23,0,113
2020-05-17,GM,Gambia,AFRO,1,24,0,113
2020-05-18,GM,Gambia,AFRO,0,24,0,113
2020-05-19,GM,Gambia,AFRO,0,24,0,113
2020-05-20,GM,Gambia,AFRO,0,24,0,113
2020-05-21,GM,Gambia,AFRO,0,24,0,113
2020-05-22,GM,Gambia,AFRO,1,25,0,113
2020-05-23,GM,Gambia,AFRO,0,25,0,113
2020-05-24,GM,Gambia,AFRO,0,25,0,113
2020-05-25,GM,Gambia,AFRO,0,25,0,113
2020-05-26,GM,Gambia,AFRO,0,25,0,113
2020-05-27,GM,Gambia,AFRO,0,25,0,113
2020-05-28,GM,Gambia,AFRO,0,25,0,113
2020-05-29,GM,Gambia,AFRO,0,25,0,113
2020-05-30,GM,Gambia,AFRO,0,25,0,113
2020-05-31,GM,Gambia,AFRO,0,25,0,113
2020-06-01,GM,Gambia,AFRO,0,25,0,113
2020-06-02,GM,Gambia,AFRO,0,25,0,113
2020-06-03,GM,Gambia,AFRO,1,26,0,113
2020-06-04,GM,Gambia,AFRO,0,26,0,113
2020-06-05,GM,Gambia,AFRO,0,26,0,113
2020-06-06,GM,Gambia,AFRO,0,26,0,113
2020-06-07,GM,Gambia,AFRO,0,26,0,113
2020-06-08,GM,Gambia,AFRO,2,28,0,113
2020-03-29,GE,Georgia,EURO,8,98,0,0
2020-03-30,GE,Georgia,EURO,5,103,0,0
2020-03-31,GE,Georgia,EURO,12,115,0,0
2020-04-01,GE,Georgia,EURO,6,121,0,0
2020-04-02,GE,Georgia,EURO,0,121,0,0
2020-04-03,GE,Georgia,EURO,27,148,0,0
2020-04-04,GE,Georgia,EURO,9,157,0,0
2020-04-05,GE,Georgia,EURO,13,170,1,1
2020-04-06,GE,Georgia,EURO,18,188,1,2
2020-04-07,GE,Georgia,EURO,7,195,0,2
2020-04-08,GE,Georgia,EURO,13,208,1,3
2020-04-09,GE,Georgia,EURO,6,214,0,3
2020-04-10,GE,Georgia,EURO,16,230,0,3
2020-04-11,GE,Georgia,EURO,3,233,0,3
2020-04-12,GE,Georgia,EURO,19,252,0,3
2020-04-13,GE,Georgia,EURO,14,266,0,3
2020-04-14,GE,Georgia,EURO,30,296,0,3
2020-04-15,GE,Georgia,EURO,10,306,0,3
2020-04-16,GE,Georgia,EURO,30,336,0,3
2020-04-17,GE,Georgia,EURO,34,370,0,3
2020-04-18,GE,Georgia,EURO,15,385,0,3
2020-04-19,GE,Georgia,EURO,9,394,1,4
2020-04-20,GE,Georgia,EURO,5,399,0,4
2020-04-21,GE,Georgia,EURO,9,408,0,4
2020-04-22,GE,Georgia,EURO,3,411,1,5
2020-04-23,GE,Georgia,EURO,9,420,0,5
2020-04-24,GE,Georgia,EURO,11,431,0,5
2020-04-25,GE,Georgia,EURO,25,456,0,5
2020-04-26,GE,Georgia,EURO,29,485,0,5
2020-04-27,GE,Georgia,EURO,11,496,1,6
2020-04-28,GE,Georgia,EURO,15,511,0,6
2020-04-29,GE,Georgia,EURO,6,517,0,6
2020-04-30,GE,Georgia,EURO,22,539,0,6
2020-05-01,GE,Georgia,EURO,27,566,0,6
2020-05-02,GE,Georgia,EURO,16,582,2,8
2020-05-03,GE,Georgia,EURO,7,589,0,8
2020-05-04,GE,Georgia,EURO,4,593,1,9
2020-05-05,GE,Georgia,EURO,11,604,0,9
2020-05-06,GE,Georgia,EURO,6,610,0,9
2020-05-07,GE,Georgia,EURO,4,614,0,9
2020-05-08,GE,Georgia,EURO,9,623,0,9
2020-05-09,GE,Georgia,EURO,3,626,1,10
2020-05-10,GE,Georgia,EURO,9,635,0,10
2020-05-11,GE,Georgia,EURO,3,638,0,10
2020-05-12,GE,Georgia,EURO,1,639,1,11
2020-05-13,GE,Georgia,EURO,3,642,0,11
2020-05-14,GE,Georgia,EURO,10,652,0,11
2020-05-15,GE,Georgia,EURO,19,671,1,12
2020-05-16,GE,Georgia,EURO,6,677,0,12
2020-05-17,GE,Georgia,EURO,18,695,0,12
2020-05-18,GE,Georgia,EURO,6,701,0,12
2020-05-19,GE,Georgia,EURO,1,702,0,12
2020-05-20,GE,Georgia,EURO,11,713,0,12
2020-05-21,GE,Georgia,EURO,8,721,0,12
2020-05-22,GE,Georgia,EURO,2,723,0,12
2020-05-23,GE,Georgia,EURO,0,723,0,12
2020-05-24,GE,Georgia,EURO,7,730,0,12
2020-05-25,GE,Georgia,EURO,1,731,0,12
2020-05-26,GE,Georgia,EURO,1,732,0,12
2020-05-27,GE,Georgia,EURO,3,735,0,12
2020-05-28,GE,Georgia,EURO,3,738,0,12
2020-05-29,GE,Georgia,EURO,8,746,0,12
2020-05-30,GE,Georgia,EURO,11,757,0,12
2020-05-31,GE,Georgia,EURO,26,783,0,12
2020-06-01,GE,Georgia,EURO,11,794,0,12
2020-06-02,GE,Georgia,EURO,2,796,0,12
2020-06-03,GE,Georgia,EURO,4,800,1,13
2020-06-04,GE,Georgia,EURO,1,801,0,13
2020-06-05,GE,Georgia,EURO,5,806,0,13
2020-06-06,GE,Georgia,EURO,2,808,0,13
2020-06-07,GE,Georgia,EURO,1,809,0,13
2020-06-08,GE,Georgia,EURO,1,810,0,13
2020-03-29,DE,Germany,EURO,4722,60821,247,1869
2020-03-30,DE,Germany,EURO,3080,63901,166,2035
2020-03-31,DE,Germany,EURO,4131,68032,267,2302
2020-04-01,DE,Germany,EURO,6060,74092,384,2686
2020-04-02,DE,Germany,EURO,6263,80355,376,3062
2020-04-03,DE,Germany,EURO,6549,86904,420,3482
2020-04-04,DE,Germany,EURO,6187,93091,398,3880
2020-04-05,DE,Germany,EURO,4341,97432,246,4126
2020-04-06,DE,Germany,EURO,2536,99968,182,4308
2020-04-07,DE,Germany,EURO,3663,103631,291,4599
2020-04-08,DE,Germany,EURO,5188,108819,339,4938
2020-04-09,DE,Germany,EURO,5280,114099,343,5281
2020-04-10,DE,Germany,EURO,4916,119015,326,5607
2020-04-11,DE,Germany,EURO,3351,122366,207,5814
2020-04-12,DE,Germany,EURO,2879,125245,201,6015
2020-04-13,DE,Germany,EURO,1868,127113,170,6185
2020-04-14,DE,Germany,EURO,1600,128713,165,6350
2020-04-15,DE,Germany,EURO,2468,131181,219,6569
2020-04-16,DE,Germany,EURO,3326,134507,233,6802
2020-04-17,DE,Germany,EURO,3419,137926,192,6994
2020-04-18,DE,Germany,EURO,3049,140975,174,7168
2020-04-19,DE,Germany,EURO,2108,143083,126,7294
2020-04-20,DE,Germany,EURO,1376,144459,118,7412
2020-04-21,DE,Germany,EURO,1711,146170,150,7562
2020-04-22,DE,Germany,EURO,2185,148355,141,7703
2020-04-23,DE,Germany,EURO,2489,150844,125,7828
2020-04-24,DE,Germany,EURO,2092,152936,117,7945
2020-04-25,DE,Germany,EURO,1904,154840,84,8029
2020-04-26,DE,Germany,EURO,1272,156112,80,8109
2020-04-27,DE,Germany,EURO,698,156810,30,8139
2020-04-28,DE,Germany,EURO,1115,157925,76,8215
2020-04-29,DE,Germany,EURO,1473,159398,82,8297
2020-04-30,DE,Germany,EURO,1428,160826,58,8355
2020-05-01,DE,Germany,EURO,1464,162290,71,8426
2020-05-02,DE,Germany,EURO,918,163208,49,8475
2020-05-03,DE,Germany,EURO,621,163829,36,8511
2020-05-04,DE,Germany,EURO,423,164252,16,8527
2020-05-05,DE,Germany,EURO,729,164981,41,8568
2020-05-06,DE,Germany,EURO,1094,166075,45,8613
2020-05-07,DE,Germany,EURO,1219,167294,40,8653
2020-05-08,DE,Germany,EURO,1203,168497,49,8702
2020-05-09,DE,Germany,EURO,980,169477,45,8747
2020-05-10,DE,Germany,EURO,677,170154,24,8771
2020-05-11,DE,Germany,EURO,341,170495,14,8785
2020-05-12,DE,Germany,EURO,689,171184,26,8811
2020-05-13,DE,Germany,EURO,853,172037,33,8844
2020-05-14,DE,Germany,EURO,914,172951,27,8871
2020-05-15,DE,Germany,EURO,809,173760,20,8891
2020-05-16,DE,Germany,EURO,731,174491,31,8922
2020-05-17,DE,Germany,EURO,462,174953,20,8942
2020-05-18,DE,Germany,EURO,317,175270,8,8950
2020-05-19,DE,Germany,EURO,542,175812,23,8973
2020-05-20,DE,Germany,EURO,730,176542,26,8999
2020-05-21,DE,Germany,EURO,832,177374,23,9022
2020-05-22,DE,Germany,EURO,418,177792,7,9029
2020-05-23,DE,Germany,EURO,526,178318,16,9045
2020-05-24,DE,Germany,EURO,337,178655,11,9056
2020-05-25,DE,Germany,EURO,219,178874,5,9061
2020-05-26,DE,Germany,EURO,411,179285,13,9074
2020-05-27,DE,Germany,EURO,617,179902,15,9089
2020-05-28,DE,Germany,EURO,653,180555,12,9101
2020-05-29,DE,Germany,EURO,528,181083,10,9111
2020-05-30,DE,Germany,EURO,445,181528,8,9119
2020-05-31,DE,Germany,EURO,374,181902,4,9123
2020-06-01,DE,Germany,EURO,178,182080,3,9126
2020-06-02,DE,Germany,EURO,136,182216,5,9131
2020-06-03,DE,Germany,EURO,307,182523,8,9139
2020-06-04,DE,Germany,EURO,498,183021,10,9149
2020-06-05,DE,Germany,EURO,528,183549,7,9156
2020-06-06,DE,Germany,EURO,436,183985,5,9161
2020-06-07,DE,Germany,EURO,285,184270,5,9166
2020-06-08,DE,Germany,EURO,164,184434,4,9170
2020-03-29,GH,Ghana,AFRO,3,141,0,301
2020-03-30,GH,Ghana,AFRO,11,152,0,301
2020-03-31,GH,Ghana,AFRO,0,152,0,301
2020-04-01,GH,Ghana,AFRO,9,161,0,301
2020-04-02,GH,Ghana,AFRO,34,195,0,301
2020-04-03,GH,Ghana,AFRO,9,204,0,301
2020-04-04,GH,Ghana,AFRO,1,205,0,301
2020-04-05,GH,Ghana,AFRO,9,214,0,301
2020-04-06,GH,Ghana,AFRO,0,214,0,301
2020-04-07,GH,Ghana,AFRO,73,287,0,301
2020-04-08,GH,Ghana,AFRO,26,313,0,301
2020-04-09,GH,Ghana,AFRO,0,313,0,301
2020-04-10,GH,Ghana,AFRO,65,378,0,301
2020-04-11,GH,Ghana,AFRO,0,378,0,301
2020-04-12,GH,Ghana,AFRO,188,566,0,301
2020-04-13,GH,Ghana,AFRO,0,566,0,301
2020-04-14,GH,Ghana,AFRO,70,636,0,301
2020-04-15,GH,Ghana,AFRO,0,636,0,301
2020-04-16,GH,Ghana,AFRO,5,641,0,301
2020-04-17,GH,Ghana,AFRO,0,641,0,301
2020-04-18,GH,Ghana,AFRO,0,641,0,301
2020-04-19,GH,Ghana,AFRO,193,834,0,301
2020-04-20,GH,Ghana,AFRO,208,1042,0,301
2020-04-21,GH,Ghana,AFRO,0,1042,0,301
2020-04-22,GH,Ghana,AFRO,0,1042,0,301
2020-04-23,GH,Ghana,AFRO,112,1154,0,301
2020-04-24,GH,Ghana,AFRO,0,1154,0,301
2020-04-25,GH,Ghana,AFRO,125,1279,0,301
2020-04-26,GH,Ghana,AFRO,0,1279,0,301
2020-04-27,GH,Ghana,AFRO,271,1550,0,301
2020-04-28,GH,Ghana,AFRO,0,1550,0,301
2020-04-29,GH,Ghana,AFRO,121,1671,0,301
2020-04-30,GH,Ghana,AFRO,0,1671,0,301
2020-05-01,GH,Ghana,AFRO,403,2074,0,301
2020-05-02,GH,Ghana,AFRO,0,2074,0,301
2020-05-03,GH,Ghana,AFRO,95,2169,0,301
2020-05-04,GH,Ghana,AFRO,0,2169,0,301
2020-05-05,GH,Ghana,AFRO,550,2719,0,301
2020-05-06,GH,Ghana,AFRO,0,2719,0,301
2020-05-07,GH,Ghana,AFRO,0,2719,0,301
2020-05-08,GH,Ghana,AFRO,372,3091,0,301
2020-05-09,GH,Ghana,AFRO,921,4012,0,301
2020-05-10,GH,Ghana,AFRO,251,4263,0,301
2020-05-11,GH,Ghana,AFRO,437,4700,0,301
2020-05-12,GH,Ghana,AFRO,0,4700,0,301
2020-05-13,GH,Ghana,AFRO,427,5127,0,301
2020-05-14,GH,Ghana,AFRO,281,5408,0,301
2020-05-15,GH,Ghana,AFRO,122,5530,0,301
2020-05-16,GH,Ghana,AFRO,108,5638,0,301
2020-05-17,GH,Ghana,AFRO,97,5735,0,301
2020-05-18,GH,Ghana,AFRO,0,5735,0,301
2020-05-19,GH,Ghana,AFRO,0,5735,0,301
2020-05-20,GH,Ghana,AFRO,361,6096,0,301
2020-05-21,GH,Ghana,AFRO,0,6096,0,301
2020-05-22,GH,Ghana,AFRO,173,6269,0,301
2020-05-23,GH,Ghana,AFRO,217,6486,0,301
2020-05-24,GH,Ghana,AFRO,131,6617,0,301
2020-05-25,GH,Ghana,AFRO,66,6683,0,301
2020-05-26,GH,Ghana,AFRO,125,6808,0,301
2020-05-27,GH,Ghana,AFRO,156,6964,0,301
2020-05-28,GH,Ghana,AFRO,339,7303,0,301
2020-05-29,GH,Ghana,AFRO,0,7303,0,301
2020-05-30,GH,Ghana,AFRO,313,7616,0,301
2020-05-31,GH,Ghana,AFRO,152,7768,0,301
2020-06-01,GH,Ghana,AFRO,113,7881,0,301
2020-06-02,GH,Ghana,AFRO,189,8070,0,301
2020-06-03,GH,Ghana,AFRO,227,8297,0,301
2020-06-04,GH,Ghana,AFRO,251,8548,0,301
2020-06-05,GH,Ghana,AFRO,337,8885,0,301
2020-06-06,GH,Ghana,AFRO,283,9168,0,301
2020-06-07,GH,Ghana,AFRO,294,9462,0,301
2020-06-08,GH,Ghana,AFRO,0,9462,0,301
2020-03-29,GI,Gibraltar,EURO,1,48,0,0
2020-03-30,GI,Gibraltar,EURO,9,57,0,0
2020-03-31,GI,Gibraltar,EURO,4,61,0,0
2020-04-01,GI,Gibraltar,EURO,0,61,0,0
2020-04-02,GI,Gibraltar,EURO,0,61,0,0
2020-04-03,GI,Gibraltar,EURO,12,73,0,0
2020-04-04,GI,Gibraltar,EURO,14,87,0,0
2020-04-05,GI,Gibraltar,EURO,3,90,0,0
2020-04-06,GI,Gibraltar,EURO,5,95,0,0
2020-04-07,GI,Gibraltar,EURO,0,95,0,0
2020-04-08,GI,Gibraltar,EURO,10,105,0,0
2020-04-09,GI,Gibraltar,EURO,0,105,0,0
2020-04-10,GI,Gibraltar,EURO,0,105,0,0
2020-04-11,GI,Gibraltar,EURO,0,105,0,0
2020-04-12,GI,Gibraltar,EURO,0,105,0,0
2020-04-13,GI,Gibraltar,EURO,16,121,0,0
2020-04-14,GI,Gibraltar,EURO,0,121,0,0
2020-04-15,GI,Gibraltar,EURO,0,121,0,0
2020-04-16,GI,Gibraltar,EURO,0,121,0,0
2020-04-17,GI,Gibraltar,EURO,2,123,0,0
2020-04-18,GI,Gibraltar,EURO,2,125,0,0
2020-04-19,GI,Gibraltar,EURO,0,125,0,0
2020-04-20,GI,Gibraltar,EURO,0,125,0,0
2020-04-21,GI,Gibraltar,EURO,0,125,0,0
2020-04-22,GI,Gibraltar,EURO,0,125,0,0
2020-04-23,GI,Gibraltar,EURO,0,125,0,0
2020-04-24,GI,Gibraltar,EURO,0,125,0,0
2020-04-25,GI,Gibraltar,EURO,0,125,0,0
2020-04-26,GI,Gibraltar,EURO,3,128,0,0
2020-04-27,GI,Gibraltar,EURO,5,133,0,0
2020-04-28,GI,Gibraltar,EURO,0,133,0,0
2020-04-29,GI,Gibraltar,EURO,0,133,0,0
2020-04-30,GI,Gibraltar,EURO,0,133,0,0
2020-05-01,GI,Gibraltar,EURO,0,133,0,0
2020-05-02,GI,Gibraltar,EURO,3,136,0,0
2020-05-03,GI,Gibraltar,EURO,0,136,0,0
2020-05-04,GI,Gibraltar,EURO,0,136,0,0
2020-05-05,GI,Gibraltar,EURO,0,136,0,0
2020-05-06,GI,Gibraltar,EURO,0,136,0,0
2020-05-07,GI,Gibraltar,EURO,0,136,0,0
2020-05-08,GI,Gibraltar,EURO,0,136,0,0
2020-05-09,GI,Gibraltar,EURO,0,136,0,0
2020-05-10,GI,Gibraltar,EURO,2,138,0,0
2020-05-11,GI,Gibraltar,EURO,0,138,0,0
2020-05-12,GI,Gibraltar,EURO,0,138,0,0
2020-05-13,GI,Gibraltar,EURO,1,139,0,0
2020-05-14,GI,Gibraltar,EURO,0,139,0,0
2020-05-15,GI,Gibraltar,EURO,0,139,0,0
2020-05-16,GI,Gibraltar,EURO,0,139,0,0
2020-05-17,GI,Gibraltar,EURO,0,139,0,0
2020-05-18,GI,Gibraltar,EURO,0,139,0,0
2020-05-19,GI,Gibraltar,EURO,0,139,0,0
2020-05-20,GI,Gibraltar,EURO,0,139,0,0
2020-05-21,GI,Gibraltar,EURO,0,139,0,0
2020-05-22,GI,Gibraltar,EURO,2,141,0,0
2020-05-23,GI,Gibraltar,EURO,2,143,0,0
2020-05-24,GI,Gibraltar,EURO,0,143,0,0
2020-05-25,GI,Gibraltar,EURO,3,146,0,0
2020-05-26,GI,Gibraltar,EURO,0,146,0,0
2020-05-27,GI,Gibraltar,EURO,0,146,0,0
2020-05-28,GI,Gibraltar,EURO,0,146,0,0
2020-05-29,GI,Gibraltar,EURO,3,149,0,0
2020-05-30,GI,Gibraltar,EURO,1,150,0,0
2020-05-31,GI,Gibraltar,EURO,3,153,0,0
2020-06-01,GI,Gibraltar,EURO,8,161,0,0
2020-06-02,GI,Gibraltar,EURO,1,162,0,0
2020-06-03,GI,Gibraltar,EURO,0,162,0,0
2020-06-04,GI,Gibraltar,EURO,2,164,0,0
2020-06-05,GI,Gibraltar,EURO,1,165,0,0
2020-06-06,GI,Gibraltar,EURO,1,166,0,0
2020-06-07,GI,Gibraltar,EURO,0,166,0,0
2020-06-08,GI,Gibraltar,EURO,1,167,0,0
2020-03-29,GR,Greece,EURO,95,1061,4,32
2020-03-30,GR,Greece,EURO,95,1156,6,38
2020-03-31,GR,Greece,EURO,56,1212,5,43
2020-04-01,GR,Greece,EURO,102,1314,6,49
2020-04-02,GR,Greece,EURO,101,1415,1,50
2020-04-03,GR,Greece,EURO,129,1544,3,53
2020-04-04,GR,Greece,EURO,69,1613,6,59
2020-04-05,GR,Greece,EURO,60,1673,9,68
2020-04-06,GR,Greece,EURO,62,1735,5,73
2020-04-07,GR,Greece,EURO,20,1755,6,79
2020-04-08,GR,Greece,EURO,77,1832,2,81
2020-04-09,GR,Greece,EURO,52,1884,2,83
2020-04-10,GR,Greece,EURO,71,1955,3,86
2020-04-11,GR,Greece,EURO,54,2009,4,90
2020-04-12,GR,Greece,EURO,72,2081,3,93
2020-04-13,GR,Greece,EURO,33,2114,5,98
2020-04-14,GR,Greece,EURO,31,2145,1,99
2020-04-15,GR,Greece,EURO,25,2170,2,101
2020-04-16,GR,Greece,EURO,22,2192,1,102
2020-04-17,GR,Greece,EURO,15,2207,3,105
2020-04-18,GR,Greece,EURO,17,2224,3,108
2020-04-19,GR,Greece,EURO,11,2235,2,110
2020-04-20,GR,Greece,EURO,0,2235,0,110
2020-04-21,GR,Greece,EURO,10,2245,6,116
2020-04-22,GR,Greece,EURO,156,2401,5,121
2020-04-23,GR,Greece,EURO,7,2408,0,121
2020-04-24,GR,Greece,EURO,55,2463,4,125
2020-04-25,GR,Greece,EURO,27,2490,5,130
2020-04-26,GR,Greece,EURO,16,2506,0,130
2020-04-27,GR,Greece,EURO,11,2517,4,134
2020-04-28,GR,Greece,EURO,17,2534,2,136
2020-04-29,GR,Greece,EURO,32,2566,2,138
2020-04-30,GR,Greece,EURO,10,2576,1,139
2020-05-01,GR,Greece,EURO,15,2591,1,140
2020-05-02,GR,Greece,EURO,21,2612,0,140
2020-05-03,GR,Greece,EURO,8,2620,3,143
2020-05-04,GR,Greece,EURO,6,2626,1,144
2020-05-05,GR,Greece,EURO,6,2632,2,146
2020-05-06,GR,Greece,EURO,10,2642,0,146
2020-05-07,GR,Greece,EURO,21,2663,1,147
2020-05-08,GR,Greece,EURO,15,2678,1,148
2020-05-09,GR,Greece,EURO,13,2691,2,150
2020-05-10,GR,Greece,EURO,19,2710,1,151
2020-05-11,GR,Greece,EURO,6,2716,0,151
2020-05-12,GR,Greece,EURO,10,2726,0,151
2020-05-13,GR,Greece,EURO,18,2744,1,152
2020-05-14,GR,Greece,EURO,16,2760,3,155
2020-05-15,GR,Greece,EURO,10,2770,1,156
2020-05-16,GR,Greece,EURO,40,2810,4,160
2020-05-17,GR,Greece,EURO,9,2819,2,162
2020-05-18,GR,Greece,EURO,15,2834,1,163
2020-05-19,GR,Greece,EURO,2,2836,2,165
2020-05-20,GR,Greece,EURO,4,2840,0,165
2020-05-21,GR,Greece,EURO,10,2850,1,166
2020-05-22,GR,Greece,EURO,3,2853,2,168
2020-05-23,GR,Greece,EURO,20,2873,1,169
2020-05-24,GR,Greece,EURO,3,2876,2,171
2020-05-25,GR,Greece,EURO,2,2878,0,171
2020-05-26,GR,Greece,EURO,4,2882,1,172
2020-05-27,GR,Greece,EURO,10,2892,1,173
2020-05-28,GR,Greece,EURO,11,2903,0,173
2020-05-29,GR,Greece,EURO,3,2906,2,175
2020-05-30,GR,Greece,EURO,3,2909,0,175
2020-05-31,GR,Greece,EURO,6,2915,0,175
2020-06-01,GR,Greece,EURO,2,2917,0,175
2020-06-02,GR,Greece,EURO,1,2918,4,179
2020-06-03,GR,Greece,EURO,19,2937,0,179
2020-06-04,GR,Greece,EURO,6,2943,0,179
2020-06-05,GR,Greece,EURO,9,2952,1,180
2020-06-06,GR,Greece,EURO,15,2967,0,180
2020-06-07,GR,Greece,EURO,13,2980,0,180
2020-06-08,GR,Greece,EURO,17,2997,0,180
2020-03-29,GL,Greenland,EURO,1,10,0,0
2020-03-30,GL,Greenland,EURO,0,10,0,0
2020-03-31,GL,Greenland,EURO,0,10,0,0
2020-04-01,GL,Greenland,EURO,0,10,0,0
2020-04-02,GL,Greenland,EURO,0,10,0,0
2020-04-03,GL,Greenland,EURO,0,10,0,0
2020-04-04,GL,Greenland,EURO,0,10,0,0
2020-04-05,GL,Greenland,EURO,0,10,0,0
2020-04-06,GL,Greenland,EURO,1,11,0,0
2020-04-07,GL,Greenland,EURO,0,11,0,0
2020-04-08,GL,Greenland,EURO,0,11,0,0
2020-04-09,GL,Greenland,EURO,0,11,0,0
2020-04-10,GL,Greenland,EURO,0,11,0,0
2020-04-11,GL,Greenland,EURO,0,11,0,0
2020-04-12,GL,Greenland,EURO,0,11,0,0
2020-04-13,GL,Greenland,EURO,0,11,0,0
2020-04-14,GL,Greenland,EURO,0,11,0,0
2020-04-15,GL,Greenland,EURO,0,11,0,0
2020-04-16,GL,Greenland,EURO,0,11,0,0
2020-04-17,GL,Greenland,EURO,0,11,0,0
2020-04-18,GL,Greenland,EURO,0,11,0,0
2020-04-19,GL,Greenland,EURO,0,11,0,0
2020-04-20,GL,Greenland,EURO,0,11,0,0
2020-04-21,GL,Greenland,EURO,0,11,0,0
2020-04-22,GL,Greenland,EURO,0,11,0,0
2020-04-23,GL,Greenland,EURO,0,11,0,0
2020-04-24,GL,Greenland,EURO,0,11,0,0
2020-04-25,GL,Greenland,EURO,0,11,0,0
2020-04-26,GL,Greenland,EURO,0,11,0,0
2020-04-27,GL,Greenland,EURO,0,11,0,0
2020-04-28,GL,Greenland,EURO,0,11,0,0
2020-04-29,GL,Greenland,EURO,0,11,0,0
2020-04-30,GL,Greenland,EURO,0,11,0,0
2020-05-01,GL,Greenland,EURO,0,11,0,0
2020-05-02,GL,Greenland,EURO,0,11,0,0
2020-05-03,GL,Greenland,EURO,0,11,0,0
2020-05-04,GL,Greenland,EURO,0,11,0,0
2020-05-05,GL,Greenland,EURO,0,11,0,0
2020-05-06,GL,Greenland,EURO,0,11,0,0
2020-05-07,GL,Greenland,EURO,0,11,0,0
2020-05-08,GL,Greenland,EURO,0,11,0,0
2020-05-09,GL,Greenland,EURO,0,11,0,0
2020-05-10,GL,Greenland,EURO,0,11,0,0
2020-05-11,GL,Greenland,EURO,0,11,0,0
2020-05-12,GL,Greenland,EURO,0,11,0,0
2020-05-13,GL,Greenland,EURO,0,11,0,0
2020-05-14,GL,Greenland,EURO,0,11,0,0
2020-05-15,GL,Greenland,EURO,0,11,0,0
2020-05-16,GL,Greenland,EURO,0,11,0,0
2020-05-17,GL,Greenland,EURO,0,11,0,0
2020-05-18,GL,Greenland,EURO,0,11,0,0
2020-05-19,GL,Greenland,EURO,0,11,0,0
2020-05-20,GL,Greenland,EURO,0,11,0,0
2020-05-21,GL,Greenland,EURO,0,11,0,0
2020-05-22,GL,Greenland,EURO,0,11,0,0
2020-05-23,GL,Greenland,EURO,0,11,0,0
2020-05-24,GL,Greenland,EURO,0,11,0,0
2020-05-25,GL,Greenland,EURO,0,11,0,0
2020-05-26,GL,Greenland,EURO,1,12,0,0
2020-05-27,GL,Greenland,EURO,0,12,0,0
2020-05-28,GL,Greenland,EURO,0,12,0,0
2020-05-29,GL,Greenland,EURO,1,13,0,0
2020-05-30,GL,Greenland,EURO,0,13,0,0
2020-05-31,GL,Greenland,EURO,0,13,0,0
2020-06-01,GL,Greenland,EURO,0,13,0,0
2020-06-02,GL,Greenland,EURO,0,13,0,0
2020-06-03,GL,Greenland,EURO,0,13,0,0
2020-06-04,GL,Greenland,EURO,0,13,0,0
2020-06-05,GL,Greenland,EURO,0,13,0,0
2020-06-06,GL,Greenland,EURO,0,13,0,0
2020-06-07,GL,Greenland,EURO,0,13,0,0
2020-06-08,GL,Greenland,EURO,0,13,0,0
2020-03-29,GD,Grenada,AMRO,0,7,0,0
2020-03-30,GD,Grenada,AMRO,0,7,0,0
2020-03-31,GD,Grenada,AMRO,2,9,0,0
2020-04-01,GD,Grenada,AMRO,0,9,0,0
2020-04-02,GD,Grenada,AMRO,0,9,0,0
2020-04-03,GD,Grenada,AMRO,1,10,0,0
2020-04-04,GD,Grenada,AMRO,0,10,0,0
2020-04-05,GD,Grenada,AMRO,2,12,0,0
2020-04-06,GD,Grenada,AMRO,0,12,0,0
2020-04-07,GD,Grenada,AMRO,0,12,0,0
2020-04-08,GD,Grenada,AMRO,0,12,0,0
2020-04-09,GD,Grenada,AMRO,0,12,0,0
2020-04-10,GD,Grenada,AMRO,0,12,0,0
2020-04-11,GD,Grenada,AMRO,0,12,0,0
2020-04-12,GD,Grenada,AMRO,1,13,0,0
2020-04-13,GD,Grenada,AMRO,0,13,0,0
2020-04-14,GD,Grenada,AMRO,0,13,0,0
2020-04-15,GD,Grenada,AMRO,0,13,0,0
2020-04-16,GD,Grenada,AMRO,0,13,0,0
2020-04-17,GD,Grenada,AMRO,0,13,0,0
2020-04-18,GD,Grenada,AMRO,0,13,0,0
2020-04-19,GD,Grenada,AMRO,0,13,0,0
2020-04-20,GD,Grenada,AMRO,0,13,0,0
2020-04-21,GD,Grenada,AMRO,0,13,0,0
2020-04-22,GD,Grenada,AMRO,1,14,0,0
2020-04-23,GD,Grenada,AMRO,0,14,0,0
2020-04-24,GD,Grenada,AMRO,1,15,0,0
2020-04-25,GD,Grenada,AMRO,0,15,0,0
2020-04-26,GD,Grenada,AMRO,0,15,0,0
2020-04-27,GD,Grenada,AMRO,3,18,0,0
2020-04-28,GD,Grenada,AMRO,0,18,0,0
2020-04-29,GD,Grenada,AMRO,0,18,0,0
2020-04-30,GD,Grenada,AMRO,1,19,0,0
2020-05-01,GD,Grenada,AMRO,1,20,0,0
2020-05-02,GD,Grenada,AMRO,0,20,0,0
2020-05-03,GD,Grenada,AMRO,0,20,0,0
2020-05-04,GD,Grenada,AMRO,1,21,0,0
2020-05-05,GD,Grenada,AMRO,0,21,0,0
2020-05-06,GD,Grenada,AMRO,0,21,0,0
2020-05-07,GD,Grenada,AMRO,0,21,0,0
2020-05-08,GD,Grenada,AMRO,0,21,0,0
2020-05-09,GD,Grenada,AMRO,0,21,0,0
2020-05-10,GD,Grenada,AMRO,0,21,0,0
2020-05-11,GD,Grenada,AMRO,0,21,0,0
2020-05-12,GD,Grenada,AMRO,0,21,0,0
2020-05-13,GD,Grenada,AMRO,0,21,0,0
2020-05-14,GD,Grenada,AMRO,0,21,0,0
2020-05-15,GD,Grenada,AMRO,0,21,0,0
2020-05-16,GD,Grenada,AMRO,1,22,0,0
2020-05-17,GD,Grenada,AMRO,0,22,0,0
2020-05-18,GD,Grenada,AMRO,0,22,0,0
2020-05-19,GD,Grenada,AMRO,0,22,0,0
2020-05-20,GD,Grenada,AMRO,0,22,0,0
2020-05-21,GD,Grenada,AMRO,0,22,0,0
2020-05-22,GD,Grenada,AMRO,0,22,0,0
2020-05-23,GD,Grenada,AMRO,0,22,0,0
2020-05-24,GD,Grenada,AMRO,0,22,0,0
2020-05-25,GD,Grenada,AMRO,0,22,0,0
2020-05-26,GD,Grenada,AMRO,0,22,0,0
2020-05-27,GD,Grenada,AMRO,1,23,0,0
2020-05-28,GD,Grenada,AMRO,0,23,0,0
2020-05-29,GD,Grenada,AMRO,0,23,0,0
2020-05-30,GD,Grenada,AMRO,0,23,0,0
2020-05-31,GD,Grenada,AMRO,0,23,0,0
2020-06-01,GD,Grenada,AMRO,0,23,0,0
2020-06-02,GD,Grenada,AMRO,0,23,0,0
2020-06-03,GD,Grenada,AMRO,0,23,0,0
2020-06-04,GD,Grenada,AMRO,0,23,0,0
2020-06-05,GD,Grenada,AMRO,0,23,0,0
2020-06-06,GD,Grenada,AMRO,0,23,0,0
2020-06-07,GD,Grenada,AMRO,0,23,0,0
2020-06-08,GD,Grenada,AMRO,0,23,0,0
2020-03-29,GP,Guadeloupe,AMRO,0,96,0,2
2020-03-30,GP,Guadeloupe,AMRO,0,96,0,2
2020-03-31,GP,Guadeloupe,AMRO,10,106,2,4
2020-04-01,GP,Guadeloupe,AMRO,8,114,1,5
2020-04-02,GP,Guadeloupe,AMRO,11,125,1,6
2020-04-03,GP,Guadeloupe,AMRO,3,128,0,6
2020-04-04,GP,Guadeloupe,AMRO,2,130,1,7
2020-04-05,GP,Guadeloupe,AMRO,0,130,0,7
2020-04-06,GP,Guadeloupe,AMRO,4,134,0,7
2020-04-07,GP,Guadeloupe,AMRO,1,135,0,7
2020-04-08,GP,Guadeloupe,AMRO,4,139,0,7
2020-04-09,GP,Guadeloupe,AMRO,0,139,1,8
2020-04-10,GP,Guadeloupe,AMRO,2,141,0,8
2020-04-11,GP,Guadeloupe,AMRO,2,143,0,8
2020-04-12,GP,Guadeloupe,AMRO,0,143,0,8
2020-04-13,GP,Guadeloupe,AMRO,0,143,0,8
2020-04-14,GP,Guadeloupe,AMRO,0,143,0,8
2020-04-15,GP,Guadeloupe,AMRO,2,145,0,8
2020-04-16,GP,Guadeloupe,AMRO,0,145,0,8
2020-04-17,GP,Guadeloupe,AMRO,0,145,0,8
2020-04-18,GP,Guadeloupe,AMRO,0,145,0,8
2020-04-19,GP,Guadeloupe,AMRO,0,145,3,11
2020-04-20,GP,Guadeloupe,AMRO,3,148,0,11
2020-04-21,GP,Guadeloupe,AMRO,0,148,0,11
2020-04-22,GP,Guadeloupe,AMRO,0,148,1,12
2020-04-23,GP,Guadeloupe,AMRO,0,148,0,12
2020-04-24,GP,Guadeloupe,AMRO,0,148,0,12
2020-04-25,GP,Guadeloupe,AMRO,1,149,0,12
2020-04-26,GP,Guadeloupe,AMRO,0,149,0,12
2020-04-27,GP,Guadeloupe,AMRO,0,149,1,13
2020-04-28,GP,Guadeloupe,AMRO,0,149,-3,10
2020-04-29,GP,Guadeloupe,AMRO,0,149,1,11
2020-04-30,GP,Guadeloupe,AMRO,2,151,0,11
2020-05-01,GP,Guadeloupe,AMRO,1,152,1,12
2020-05-02,GP,Guadeloupe,AMRO,0,152,0,12
2020-05-03,GP,Guadeloupe,AMRO,0,152,0,12
2020-05-04,GP,Guadeloupe,AMRO,0,152,0,12
2020-05-05,GP,Guadeloupe,AMRO,0,152,0,12
2020-05-06,GP,Guadeloupe,AMRO,0,152,1,13
2020-05-07,GP,Guadeloupe,AMRO,1,153,0,13
2020-05-08,GP,Guadeloupe,AMRO,0,153,0,13
2020-05-09,GP,Guadeloupe,AMRO,1,154,0,13
2020-05-10,GP,Guadeloupe,AMRO,0,154,0,13
2020-05-11,GP,Guadeloupe,AMRO,0,154,0,13
2020-05-12,GP,Guadeloupe,AMRO,0,154,0,13
2020-05-13,GP,Guadeloupe,AMRO,1,155,0,13
2020-05-14,GP,Guadeloupe,AMRO,0,155,0,13
2020-05-15,GP,Guadeloupe,AMRO,0,155,0,13
2020-05-16,GP,Guadeloupe,AMRO,0,155,0,13
2020-05-17,GP,Guadeloupe,AMRO,0,155,0,13
2020-05-18,GP,Guadeloupe,AMRO,0,155,0,13
2020-05-19,GP,Guadeloupe,AMRO,0,155,0,13
2020-05-20,GP,Guadeloupe,AMRO,0,155,0,13
2020-05-21,GP,Guadeloupe,AMRO,0,155,0,13
2020-05-22,GP,Guadeloupe,AMRO,0,155,0,13
2020-05-23,GP,Guadeloupe,AMRO,0,155,0,13
2020-05-24,GP,Guadeloupe,AMRO,1,156,0,13
2020-05-25,GP,Guadeloupe,AMRO,0,156,0,13
2020-05-26,GP,Guadeloupe,AMRO,5,161,1,14
2020-05-27,GP,Guadeloupe,AMRO,0,161,0,14
2020-05-28,GP,Guadeloupe,AMRO,0,161,0,14
2020-05-29,GP,Guadeloupe,AMRO,0,161,0,14
2020-05-30,GP,Guadeloupe,AMRO,1,162,0,14
2020-05-31,GP,Guadeloupe,AMRO,0,162,0,14
2020-06-01,GP,Guadeloupe,AMRO,0,162,0,14
2020-06-02,GP,Guadeloupe,AMRO,0,162,0,14
2020-06-03,GP,Guadeloupe,AMRO,0,162,0,14
2020-06-04,GP,Guadeloupe,AMRO,0,162,0,14
2020-06-05,GP,Guadeloupe,AMRO,0,162,0,14
2020-06-06,GP,Guadeloupe,AMRO,2,164,0,14
2020-06-07,GP,Guadeloupe,AMRO,0,164,0,14
2020-06-08,GP,Guadeloupe,AMRO,0,164,0,14
2020-03-29,GU,Guam,WPRO,4,55,0,1
2020-03-30,GU,Guam,WPRO,1,56,0,1
2020-03-31,GU,Guam,WPRO,2,58,0,1
2020-04-01,GU,Guam,WPRO,11,69,1,2
2020-04-02,GU,Guam,WPRO,8,77,1,3
2020-04-03,GU,Guam,WPRO,5,82,0,3
2020-04-04,GU,Guam,WPRO,2,84,0,3
2020-04-05,GU,Guam,WPRO,9,93,1,4
2020-04-06,GU,Guam,WPRO,19,112,0,4
2020-04-07,GU,Guam,WPRO,1,113,0,4
2020-04-08,GU,Guam,WPRO,8,121,0,4
2020-04-09,GU,Guam,WPRO,4,125,0,4
2020-04-10,GU,Guam,WPRO,3,128,0,4
2020-04-11,GU,Guam,WPRO,2,130,0,4
2020-04-12,GU,Guam,WPRO,3,133,1,5
2020-04-13,GU,Guam,WPRO,0,133,0,5
2020-04-14,GU,Guam,WPRO,0,133,0,5
2020-04-15,GU,Guam,WPRO,0,133,0,5
2020-04-16,GU,Guam,WPRO,0,133,0,5
2020-04-17,GU,Guam,WPRO,0,133,0,5
2020-04-18,GU,Guam,WPRO,0,133,0,5
2020-04-19,GU,Guam,WPRO,0,133,0,5
2020-04-20,GU,Guam,WPRO,0,133,0,5
2020-04-21,GU,Guam,WPRO,0,133,0,5
2020-04-22,GU,Guam,WPRO,0,133,0,5
2020-04-23,GU,Guam,WPRO,1,134,0,5
2020-04-24,GU,Guam,WPRO,1,135,0,5
2020-04-25,GU,Guam,WPRO,2,137,0,5
2020-04-26,GU,Guam,WPRO,0,137,0,5
2020-04-27,GU,Guam,WPRO,0,137,0,5
2020-04-28,GU,Guam,WPRO,1,138,0,5
2020-04-29,GU,Guam,WPRO,2,140,0,5
2020-04-30,GU,Guam,WPRO,1,141,0,5
2020-05-01,GU,Guam,WPRO,1,142,0,5
2020-05-02,GU,Guam,WPRO,0,142,0,5
2020-05-03,GU,Guam,WPRO,2,144,0,5
2020-05-04,GU,Guam,WPRO,1,145,0,5
2020-05-05,GU,Guam,WPRO,0,145,0,5
2020-05-06,GU,Guam,WPRO,0,145,0,5
2020-05-07,GU,Guam,WPRO,2,147,0,5
2020-05-08,GU,Guam,WPRO,0,147,0,5
2020-05-09,GU,Guam,WPRO,0,147,0,5
2020-05-10,GU,Guam,WPRO,0,147,0,5
2020-05-11,GU,Guam,WPRO,0,147,0,5
2020-05-12,GU,Guam,WPRO,0,147,0,5
2020-05-13,GU,Guam,WPRO,1,148,0,5
2020-05-14,GU,Guam,WPRO,0,148,0,5
2020-05-15,GU,Guam,WPRO,1,149,0,5
2020-05-16,GU,Guam,WPRO,0,149,0,5
2020-05-17,GU,Guam,WPRO,0,149,0,5
2020-05-18,GU,Guam,WPRO,0,149,0,5
2020-05-19,GU,Guam,WPRO,0,149,0,5
2020-05-20,GU,Guam,WPRO,0,149,0,5
2020-05-21,GU,Guam,WPRO,11,160,0,5
2020-05-22,GU,Guam,WPRO,0,160,0,5
2020-05-23,GU,Guam,WPRO,0,160,0,5
2020-05-24,GU,Guam,WPRO,1,161,0,5
2020-05-25,GU,Guam,WPRO,0,161,0,5
2020-05-26,GU,Guam,WPRO,0,161,0,5
2020-05-27,GU,Guam,WPRO,2,163,0,5
2020-05-28,GU,Guam,WPRO,1,164,0,5
2020-05-29,GU,Guam,WPRO,1,165,0,5
2020-05-30,GU,Guam,WPRO,0,165,0,5
2020-05-31,GU,Guam,WPRO,1,166,0,5
2020-06-01,GU,Guam,WPRO,0,166,0,5
2020-06-02,GU,Guam,WPRO,1,167,0,5
2020-06-03,GU,Guam,WPRO,2,169,0,5
2020-06-04,GU,Guam,WPRO,1,170,0,5
2020-06-05,GU,Guam,WPRO,1,171,0,5
2020-06-06,GU,Guam,WPRO,0,171,0,5
2020-06-07,GU,Guam,WPRO,0,171,0,5
2020-06-08,GU,Guam,WPRO,0,171,0,5
2020-03-29,GT,Guatemala,AMRO,52,77,0,1
2020-03-30,GT,Guatemala,AMRO,2,79,0,1
2020-03-31,GT,Guatemala,AMRO,-43,36,0,1
2020-04-01,GT,Guatemala,AMRO,0,36,0,1
2020-04-02,GT,Guatemala,AMRO,3,39,0,1
2020-04-03,GT,Guatemala,AMRO,8,47,0,1
2020-04-04,GT,Guatemala,AMRO,3,50,0,1
2020-04-05,GT,Guatemala,AMRO,0,50,0,1
2020-04-06,GT,Guatemala,AMRO,11,61,1,2
2020-04-07,GT,Guatemala,AMRO,9,70,1,3
2020-04-08,GT,Guatemala,AMRO,7,77,0,3
2020-04-09,GT,Guatemala,AMRO,10,87,0,3
2020-04-10,GT,Guatemala,AMRO,8,95,0,3
2020-04-11,GT,Guatemala,AMRO,31,126,0,3
2020-04-12,GT,Guatemala,AMRO,11,137,0,3
2020-04-13,GT,Guatemala,AMRO,16,153,0,3
2020-04-14,GT,Guatemala,AMRO,3,156,2,5
2020-04-15,GT,Guatemala,AMRO,11,167,0,5
2020-04-16,GT,Guatemala,AMRO,13,180,0,5
2020-04-17,GT,Guatemala,AMRO,16,196,0,5
2020-04-18,GT,Guatemala,AMRO,18,214,2,7
2020-04-19,GT,Guatemala,AMRO,21,235,0,7
2020-04-20,GT,Guatemala,AMRO,22,257,0,7
2020-04-21,GT,Guatemala,AMRO,32,289,0,7
2020-04-22,GT,Guatemala,AMRO,5,294,2,9
2020-04-23,GT,Guatemala,AMRO,22,316,-1,8
2020-04-24,GT,Guatemala,AMRO,26,342,2,10
2020-04-25,GT,Guatemala,AMRO,42,384,1,11
2020-04-26,GT,Guatemala,AMRO,46,430,2,13
2020-04-27,GT,Guatemala,AMRO,43,473,2,15
2020-04-28,GT,Guatemala,AMRO,27,500,0,15
2020-04-29,GT,Guatemala,AMRO,30,530,0,15
2020-04-30,GT,Guatemala,AMRO,27,557,1,16
2020-05-01,GT,Guatemala,AMRO,28,585,0,16
2020-05-02,GT,Guatemala,AMRO,14,599,0,16
2020-05-03,GT,Guatemala,AMRO,45,644,2,18
2020-05-04,GT,Guatemala,AMRO,44,688,-1,17
2020-05-05,GT,Guatemala,AMRO,15,703,0,17
2020-05-06,GT,Guatemala,AMRO,27,730,2,19
2020-05-07,GT,Guatemala,AMRO,33,763,0,19
2020-05-08,GT,Guatemala,AMRO,35,798,2,21
2020-05-09,GT,Guatemala,AMRO,34,832,2,23
2020-05-10,GT,Guatemala,AMRO,68,900,1,24
2020-05-11,GT,Guatemala,AMRO,67,967,0,24
2020-05-12,GT,Guatemala,AMRO,85,1052,2,26
2020-05-13,GT,Guatemala,AMRO,62,1114,0,26
2020-05-14,GT,Guatemala,AMRO,85,1199,1,27
2020-05-15,GT,Guatemala,AMRO,143,1342,2,29
2020-05-16,GT,Guatemala,AMRO,176,1518,0,29
2020-05-17,GT,Guatemala,AMRO,125,1643,1,30
2020-05-18,GT,Guatemala,AMRO,120,1763,3,33
2020-05-19,GT,Guatemala,AMRO,149,1912,2,35
2020-05-20,GT,Guatemala,AMRO,89,2001,3,38
2020-05-21,GT,Guatemala,AMRO,132,2133,5,43
2020-05-22,GT,Guatemala,AMRO,132,2265,2,45
2020-05-23,GT,Guatemala,AMRO,247,2512,3,48
2020-05-24,GT,Guatemala,AMRO,231,2743,5,53
2020-05-25,GT,Guatemala,AMRO,311,3054,4,57
2020-05-26,GT,Guatemala,AMRO,370,3424,1,58
2020-05-27,GT,Guatemala,AMRO,336,3760,1,59
2020-05-28,GT,Guatemala,AMRO,194,3954,4,63
2020-05-29,GT,Guatemala,AMRO,191,4145,5,68
2020-05-30,GT,Guatemala,AMRO,203,4348,12,80
2020-05-31,GT,Guatemala,AMRO,259,4607,10,90
2020-06-01,GT,Guatemala,AMRO,132,4739,12,102
2020-06-02,GT,Guatemala,AMRO,348,5087,6,108
2020-06-03,GT,Guatemala,AMRO,249,5336,8,116
2020-06-04,GT,Guatemala,AMRO,250,5586,7,123
2020-06-05,GT,Guatemala,AMRO,174,5760,20,143
2020-06-06,GT,Guatemala,AMRO,394,6154,15,158
2020-06-07,GT,Guatemala,AMRO,331,6485,58,216
2020-06-08,GT,Guatemala,AMRO,307,6792,14,230
2020-03-29,GG,Guernsey,EURO,4,46,0,0
2020-03-30,GG,Guernsey,EURO,6,52,1,1
2020-03-31,GG,Guernsey,EURO,3,55,0,1
2020-04-01,GG,Guernsey,EURO,24,79,0,1
2020-04-02,GG,Guernsey,EURO,13,92,0,1
2020-04-03,GG,Guernsey,EURO,9,101,1,2
2020-04-04,GG,Guernsey,EURO,14,115,1,3
2020-04-05,GG,Guernsey,EURO,12,127,1,4
2020-04-06,GG,Guernsey,EURO,22,149,0,4
2020-04-07,GG,Guernsey,EURO,10,159,2,6
2020-04-08,GG,Guernsey,EURO,8,167,0,6
2020-04-09,GG,Guernsey,EURO,16,183,2,8
2020-04-10,GG,Guernsey,EURO,9,192,1,9
2020-04-11,GG,Guernsey,EURO,11,203,0,9
2020-04-12,GG,Guernsey,EURO,6,209,0,9
2020-04-13,GG,Guernsey,EURO,9,218,1,10
2020-04-14,GG,Guernsey,EURO,0,218,1,11
2020-04-15,GG,Guernsey,EURO,5,223,0,11
2020-04-16,GG,Guernsey,EURO,5,228,2,13
2020-04-17,GG,Guernsey,EURO,6,234,0,13
2020-04-18,GG,Guernsey,EURO,5,239,0,13
2020-04-19,GG,Guernsey,EURO,0,239,0,13
2020-04-20,GG,Guernsey,EURO,0,239,0,13
2020-04-21,GG,Guernsey,EURO,0,239,0,13
2020-04-22,GG,Guernsey,EURO,2,241,1,14
2020-04-23,GG,Guernsey,EURO,3,244,0,14
2020-04-24,GG,Guernsey,EURO,1,245,1,15
2020-04-25,GG,Guernsey,EURO,0,245,1,16
2020-04-26,GG,Guernsey,EURO,0,245,0,16
2020-04-27,GG,Guernsey,EURO,1,246,0,16
2020-04-28,GG,Guernsey,EURO,1,247,0,16
2020-04-29,GG,Guernsey,EURO,0,247,0,16
2020-04-30,GG,Guernsey,EURO,4,251,0,16
2020-05-01,GG,Guernsey,EURO,0,251,0,16
2020-05-02,GG,Guernsey,EURO,1,252,0,16
2020-05-03,GG,Guernsey,EURO,0,252,0,16
2020-05-04,GG,Guernsey,EURO,0,252,0,16
2020-05-05,GG,Guernsey,EURO,0,252,0,16
2020-05-06,GG,Guernsey,EURO,0,252,0,16
2020-05-07,GG,Guernsey,EURO,0,252,0,16
2020-05-08,GG,Guernsey,EURO,0,252,0,16
2020-05-09,GG,Guernsey,EURO,0,252,0,16
2020-05-10,GG,Guernsey,EURO,0,252,0,16
2020-05-11,GG,Guernsey,EURO,0,252,0,16
2020-05-12,GG,Guernsey,EURO,0,252,0,16
2020-05-13,GG,Guernsey,EURO,0,252,0,16
2020-05-14,GG,Guernsey,EURO,0,252,0,16
2020-05-15,GG,Guernsey,EURO,0,252,0,16
2020-05-16,GG,Guernsey,EURO,0,252,0,16
2020-05-17,GG,Guernsey,EURO,0,252,0,16
2020-05-18,GG,Guernsey,EURO,0,252,0,16
2020-05-19,GG,Guernsey,EURO,0,252,0,16
2020-05-20,GG,Guernsey,EURO,0,252,0,16
2020-05-21,GG,Guernsey,EURO,0,252,0,16
2020-05-22,GG,Guernsey,EURO,0,252,0,16
2020-05-23,GG,Guernsey,EURO,0,252,0,16
2020-05-24,GG,Guernsey,EURO,0,252,0,16
2020-05-25,GG,Guernsey,EURO,0,252,0,16
2020-05-26,GG,Guernsey,EURO,0,252,0,16
2020-05-27,GG,Guernsey,EURO,0,252,0,16
2020-05-28,GG,Guernsey,EURO,0,252,0,16
2020-05-29,GG,Guernsey,EURO,0,252,0,16
2020-05-30,GG,Guernsey,EURO,0,252,0,16
2020-05-31,GG,Guernsey,EURO,0,252,0,16
2020-06-01,GG,Guernsey,EURO,0,252,0,16
2020-06-02,GG,Guernsey,EURO,0,252,0,16
2020-06-03,GG,Guernsey,EURO,0,252,0,16
2020-06-04,GG,Guernsey,EURO,0,252,0,16
2020-06-05,GG,Guernsey,EURO,0,252,0,16
2020-06-06,GG,Guernsey,EURO,0,252,0,16
2020-06-07,GG,Guernsey,EURO,0,252,0,16
2020-06-08,GG,Guernsey,EURO,0,252,0,16
2020-03-29,GN,Guinea,AFRO,1,9,0,2
2020-03-30,GN,Guinea,AFRO,7,16,0,2
2020-03-31,GN,Guinea,AFRO,0,16,0,2
2020-04-01,GN,Guinea,AFRO,6,22,0,2
2020-04-02,GN,Guinea,AFRO,30,52,0,2
2020-04-03,GN,Guinea,AFRO,53,105,0,2
2020-04-04,GN,Guinea,AFRO,6,111,0,2
2020-04-05,GN,Guinea,AFRO,10,121,0,2
2020-04-06,GN,Guinea,AFRO,3,124,0,2
2020-04-07,GN,Guinea,AFRO,20,144,0,2
2020-04-08,GN,Guinea,AFRO,12,156,0,2
2020-04-09,GN,Guinea,AFRO,13,169,0,2
2020-04-10,GN,Guinea,AFRO,25,194,0,2
2020-04-11,GN,Guinea,AFRO,18,212,0,2
2020-04-12,GN,Guinea,AFRO,38,250,0,2
2020-04-13,GN,Guinea,AFRO,49,299,0,2
2020-04-14,GN,Guinea,AFRO,20,319,0,2
2020-04-15,GN,Guinea,AFRO,44,363,0,2
2020-04-16,GN,Guinea,AFRO,41,404,0,2
2020-04-17,GN,Guinea,AFRO,34,438,0,2
2020-04-18,GN,Guinea,AFRO,39,477,2,4
2020-04-19,GN,Guinea,AFRO,0,477,0,4
2020-04-20,GN,Guinea,AFRO,102,579,0,4
2020-04-21,GN,Guinea,AFRO,109,688,3,7
2020-04-22,GN,Guinea,AFRO,73,761,0,7
2020-04-23,GN,Guinea,AFRO,0,761,0,7
2020-04-24,GN,Guinea,AFRO,101,862,0,7
2020-04-25,GN,Guinea,AFRO,92,954,0,7
2020-04-26,GN,Guinea,AFRO,140,1094,1,8
2020-04-27,GN,Guinea,AFRO,0,1094,0,8
2020-04-28,GN,Guinea,AFRO,69,1163,0,8
2020-04-29,GN,Guinea,AFRO,77,1240,0,8
2020-04-30,GN,Guinea,AFRO,111,1351,0,8
2020-05-01,GN,Guinea,AFRO,144,1495,0,8
2020-05-02,GN,Guinea,AFRO,42,1537,0,8
2020-05-03,GN,Guinea,AFRO,49,1586,0,8
2020-05-04,GN,Guinea,AFRO,64,1650,0,8
2020-05-05,GN,Guinea,AFRO,60,1710,2,10
2020-05-06,GN,Guinea,AFRO,101,1811,1,11
2020-05-07,GN,Guinea,AFRO,45,1856,1,12
2020-05-08,GN,Guinea,AFRO,71,1927,0,12
2020-05-09,GN,Guinea,AFRO,82,2009,0,12
2020-05-10,GN,Guinea,AFRO,33,2042,0,12
2020-05-11,GN,Guinea,AFRO,104,2146,0,12
2020-05-12,GN,Guinea,AFRO,67,2213,0,12
2020-05-13,GN,Guinea,AFRO,90,2303,0,12
2020-05-14,GN,Guinea,AFRO,74,2377,3,15
2020-05-15,GN,Guinea,AFRO,101,2478,0,15
2020-05-16,GN,Guinea,AFRO,58,2536,0,15
2020-05-17,GN,Guinea,AFRO,127,2663,1,16
2020-05-18,GN,Guinea,AFRO,69,2732,0,16
2020-05-19,GN,Guinea,AFRO,69,2801,0,16
2020-05-20,GN,Guinea,AFRO,62,2863,2,18
2020-05-21,GN,Guinea,AFRO,64,2927,1,19
2020-05-22,GN,Guinea,AFRO,140,3067,0,19
2020-05-23,GN,Guinea,AFRO,47,3114,0,19
2020-05-24,GN,Guinea,AFRO,62,3176,1,20
2020-05-25,GN,Guinea,AFRO,99,3275,0,20
2020-05-26,GN,Guinea,AFRO,47,3322,0,20
2020-05-27,GN,Guinea,AFRO,36,3358,0,20
2020-05-28,GN,Guinea,AFRO,88,3446,1,21
2020-05-29,GN,Guinea,AFRO,107,3553,1,22
2020-05-30,GN,Guinea,AFRO,103,3656,0,22
2020-05-31,GN,Guinea,AFRO,50,3706,1,23
2020-06-01,GN,Guinea,AFRO,65,3771,0,23
2020-06-02,GN,Guinea,AFRO,73,3844,0,23
2020-06-03,GN,Guinea,AFRO,42,3886,0,23
2020-06-04,GN,Guinea,AFRO,47,3933,0,23
2020-06-05,GN,Guinea,AFRO,58,3991,0,23
2020-06-06,GN,Guinea,AFRO,69,4060,0,23
2020-06-07,GN,Guinea,AFRO,57,4117,0,23
2020-06-08,GN,Guinea,AFRO,48,4165,0,23
2020-03-29,GW,Guinea-Bissau,AFRO,0,2,0,1
2020-03-30,GW,Guinea-Bissau,AFRO,0,2,0,1
2020-03-31,GW,Guinea-Bissau,AFRO,6,8,0,1
2020-04-01,GW,Guinea-Bissau,AFRO,1,9,0,1
2020-04-02,GW,Guinea-Bissau,AFRO,0,9,0,1
2020-04-03,GW,Guinea-Bissau,AFRO,0,9,0,1
2020-04-04,GW,Guinea-Bissau,AFRO,6,15,0,1
2020-04-05,GW,Guinea-Bissau,AFRO,3,18,0,1
2020-04-06,GW,Guinea-Bissau,AFRO,0,18,0,1
2020-04-07,GW,Guinea-Bissau,AFRO,15,33,0,1
2020-04-08,GW,Guinea-Bissau,AFRO,0,33,0,1
2020-04-09,GW,Guinea-Bissau,AFRO,0,33,0,1
2020-04-10,GW,Guinea-Bissau,AFRO,2,35,0,1
2020-04-11,GW,Guinea-Bissau,AFRO,3,38,0,1
2020-04-12,GW,Guinea-Bissau,AFRO,1,39,0,1
2020-04-13,GW,Guinea-Bissau,AFRO,1,40,0,1
2020-04-14,GW,Guinea-Bissau,AFRO,0,40,0,1
2020-04-15,GW,Guinea-Bissau,AFRO,6,46,0,1
2020-04-16,GW,Guinea-Bissau,AFRO,0,46,0,1
2020-04-17,GW,Guinea-Bissau,AFRO,4,50,0,1
2020-04-18,GW,Guinea-Bissau,AFRO,0,50,0,1
2020-04-19,GW,Guinea-Bissau,AFRO,0,50,0,1
2020-04-20,GW,Guinea-Bissau,AFRO,0,50,0,1
2020-04-21,GW,Guinea-Bissau,AFRO,0,50,0,1
2020-04-22,GW,Guinea-Bissau,AFRO,0,50,0,1
2020-04-23,GW,Guinea-Bissau,AFRO,2,52,0,1
2020-04-24,GW,Guinea-Bissau,AFRO,0,52,0,1
2020-04-25,GW,Guinea-Bissau,AFRO,0,52,0,1
2020-04-26,GW,Guinea-Bissau,AFRO,0,52,0,1
2020-04-27,GW,Guinea-Bissau,AFRO,1,53,0,1
2020-04-28,GW,Guinea-Bissau,AFRO,20,73,0,1
2020-04-29,GW,Guinea-Bissau,AFRO,0,73,0,1
2020-04-30,GW,Guinea-Bissau,AFRO,128,201,0,1
2020-05-01,GW,Guinea-Bissau,AFRO,59,260,1,2
2020-05-02,GW,Guinea-Bissau,AFRO,0,260,0,2
2020-05-03,GW,Guinea-Bissau,AFRO,0,260,0,2
2020-05-04,GW,Guinea-Bissau,AFRO,32,292,0,2
2020-05-05,GW,Guinea-Bissau,AFRO,0,292,0,2
2020-05-06,GW,Guinea-Bissau,AFRO,0,292,0,2
2020-05-07,GW,Guinea-Bissau,AFRO,216,508,0,2
2020-05-08,GW,Guinea-Bissau,AFRO,0,508,0,2
2020-05-09,GW,Guinea-Bissau,AFRO,134,642,1,3
2020-05-10,GW,Guinea-Bissau,AFRO,0,642,0,3
2020-05-11,GW,Guinea-Bissau,AFRO,119,761,0,3
2020-05-12,GW,Guinea-Bissau,AFRO,59,820,0,3
2020-05-13,GW,Guinea-Bissau,AFRO,16,836,0,3
2020-05-14,GW,Guinea-Bissau,AFRO,0,836,0,3
2020-05-15,GW,Guinea-Bissau,AFRO,77,913,0,3
2020-05-16,GW,Guinea-Bissau,AFRO,0,913,0,3
2020-05-17,GW,Guinea-Bissau,AFRO,0,913,0,3
2020-05-18,GW,Guinea-Bissau,AFRO,77,990,1,4
2020-05-19,GW,Guinea-Bissau,AFRO,48,1038,2,6
2020-05-20,GW,Guinea-Bissau,AFRO,0,1038,0,6
2020-05-21,GW,Guinea-Bissau,AFRO,51,1089,0,6
2020-05-22,GW,Guinea-Bissau,AFRO,25,1114,0,6
2020-05-23,GW,Guinea-Bissau,AFRO,0,1114,0,6
2020-05-24,GW,Guinea-Bissau,AFRO,0,1114,0,6
2020-05-25,GW,Guinea-Bissau,AFRO,59,1173,0,6
2020-05-26,GW,Guinea-Bissau,AFRO,0,1173,0,6
2020-05-27,GW,Guinea-Bissau,AFRO,0,1173,0,6
2020-05-28,GW,Guinea-Bissau,AFRO,0,1173,0,6
2020-05-29,GW,Guinea-Bissau,AFRO,22,1195,2,8
2020-05-30,GW,Guinea-Bissau,AFRO,61,1256,0,8
2020-05-31,GW,Guinea-Bissau,AFRO,0,1256,0,8
2020-06-01,GW,Guinea-Bissau,AFRO,66,1322,0,8
2020-06-02,GW,Guinea-Bissau,AFRO,17,1339,0,8
2020-06-03,GW,Guinea-Bissau,AFRO,7,1346,0,8
2020-06-04,GW,Guinea-Bissau,AFRO,0,1346,1,9
2020-06-05,GW,Guinea-Bissau,AFRO,0,1346,0,9
2020-06-06,GW,Guinea-Bissau,AFRO,22,1368,3,12
2020-06-07,GW,Guinea-Bissau,AFRO,0,1368,0,12
2020-06-08,GW,Guinea-Bissau,AFRO,0,1368,0,12
2020-03-29,GY,Guyana,AMRO,0,5,0,1
2020-03-30,GY,Guyana,AMRO,0,5,0,1
2020-03-31,GY,Guyana,AMRO,3,8,0,1
2020-04-01,GY,Guyana,AMRO,4,12,1,2
2020-04-02,GY,Guyana,AMRO,7,19,0,2
2020-04-03,GY,Guyana,AMRO,0,19,2,4
2020-04-04,GY,Guyana,AMRO,0,19,0,4
2020-04-05,GY,Guyana,AMRO,4,23,0,4
2020-04-06,GY,Guyana,AMRO,1,24,0,4
2020-04-07,GY,Guyana,AMRO,5,29,0,4
2020-04-08,GY,Guyana,AMRO,2,31,1,5
2020-04-09,GY,Guyana,AMRO,2,33,0,5
2020-04-10,GY,Guyana,AMRO,4,37,1,6
2020-04-11,GY,Guyana,AMRO,0,37,0,6
2020-04-12,GY,Guyana,AMRO,0,37,0,6
2020-04-13,GY,Guyana,AMRO,0,37,0,6
2020-04-14,GY,Guyana,AMRO,10,47,0,6
2020-04-15,GY,Guyana,AMRO,0,47,0,6
2020-04-16,GY,Guyana,AMRO,1,48,0,6
2020-04-17,GY,Guyana,AMRO,7,55,0,6
2020-04-18,GY,Guyana,AMRO,2,57,0,6
2020-04-19,GY,Guyana,AMRO,6,63,0,6
2020-04-20,GY,Guyana,AMRO,0,63,1,7
2020-04-21,GY,Guyana,AMRO,2,65,0,7
2020-04-22,GY,Guyana,AMRO,1,66,0,7
2020-04-23,GY,Guyana,AMRO,1,67,0,7
2020-04-24,GY,Guyana,AMRO,0,67,0,7
2020-04-25,GY,Guyana,AMRO,3,70,0,7
2020-04-26,GY,Guyana,AMRO,3,73,0,7
2020-04-27,GY,Guyana,AMRO,1,74,1,8
2020-04-28,GY,Guyana,AMRO,0,74,0,8
2020-04-29,GY,Guyana,AMRO,0,74,0,8
2020-04-30,GY,Guyana,AMRO,1,75,0,8
2020-05-01,GY,Guyana,AMRO,3,78,0,8
2020-05-02,GY,Guyana,AMRO,4,82,1,9
2020-05-03,GY,Guyana,AMRO,0,82,0,9
2020-05-04,GY,Guyana,AMRO,0,82,0,9
2020-05-05,GY,Guyana,AMRO,0,82,0,9
2020-05-06,GY,Guyana,AMRO,10,92,0,9
2020-05-07,GY,Guyana,AMRO,1,93,1,10
2020-05-08,GY,Guyana,AMRO,0,93,0,10
2020-05-09,GY,Guyana,AMRO,0,93,0,10
2020-05-10,GY,Guyana,AMRO,0,93,0,10
2020-05-11,GY,Guyana,AMRO,4,97,0,10
2020-05-12,GY,Guyana,AMRO,7,104,0,10
2020-05-13,GY,Guyana,AMRO,5,109,0,10
2020-05-14,GY,Guyana,AMRO,4,113,0,10
2020-05-15,GY,Guyana,AMRO,0,113,0,10
2020-05-16,GY,Guyana,AMRO,0,113,0,10
2020-05-17,GY,Guyana,AMRO,3,116,0,10
2020-05-18,GY,Guyana,AMRO,1,117,0,10
2020-05-19,GY,Guyana,AMRO,0,117,0,10
2020-05-20,GY,Guyana,AMRO,7,124,0,10
2020-05-21,GY,Guyana,AMRO,1,125,0,10
2020-05-22,GY,Guyana,AMRO,0,125,0,10
2020-05-23,GY,Guyana,AMRO,2,127,0,10
2020-05-24,GY,Guyana,AMRO,0,127,0,10
2020-05-25,GY,Guyana,AMRO,0,127,0,10
2020-05-26,GY,Guyana,AMRO,8,135,0,10
2020-05-27,GY,Guyana,AMRO,2,137,1,11
2020-05-28,GY,Guyana,AMRO,2,139,0,11
2020-05-29,GY,Guyana,AMRO,0,139,0,11
2020-05-30,GY,Guyana,AMRO,11,150,0,11
2020-05-31,GY,Guyana,AMRO,0,150,0,11
2020-06-01,GY,Guyana,AMRO,2,152,1,12
2020-06-02,GY,Guyana,AMRO,1,153,0,12
2020-06-03,GY,Guyana,AMRO,0,153,0,12
2020-06-04,GY,Guyana,AMRO,0,153,0,12
2020-06-05,GY,Guyana,AMRO,0,153,0,12
2020-06-06,GY,Guyana,AMRO,0,153,0,12
2020-06-07,GY,Guyana,AMRO,0,153,0,12
2020-06-08,GY,Guyana,AMRO,1,154,0,12
2020-03-29,HT,Haiti,AMRO,0,8,0,0
2020-03-30,HT,Haiti,AMRO,7,15,0,0
2020-03-31,HT,Haiti,AMRO,0,15,0,0
2020-04-01,HT,Haiti,AMRO,0,15,0,0
2020-04-02,HT,Haiti,AMRO,1,16,0,0
2020-04-03,HT,Haiti,AMRO,0,16,0,0
2020-04-04,HT,Haiti,AMRO,2,18,0,0
2020-04-05,HT,Haiti,AMRO,0,18,0,0
2020-04-06,HT,Haiti,AMRO,3,21,0,0
2020-04-07,HT,Haiti,AMRO,3,24,1,1
2020-04-08,HT,Haiti,AMRO,1,25,0,1
2020-04-09,HT,Haiti,AMRO,2,27,0,1
2020-04-10,HT,Haiti,AMRO,3,30,1,2
2020-04-11,HT,Haiti,AMRO,0,30,0,2
2020-04-12,HT,Haiti,AMRO,1,31,0,2
2020-04-13,HT,Haiti,AMRO,0,31,0,2
2020-04-14,HT,Haiti,AMRO,9,40,1,3
2020-04-15,HT,Haiti,AMRO,0,40,0,3
2020-04-16,HT,Haiti,AMRO,1,41,0,3
2020-04-17,HT,Haiti,AMRO,0,41,0,3
2020-04-18,HT,Haiti,AMRO,2,43,0,3
2020-04-19,HT,Haiti,AMRO,1,44,0,3
2020-04-20,HT,Haiti,AMRO,0,44,0,3
2020-04-21,HT,Haiti,AMRO,3,47,0,3
2020-04-22,HT,Haiti,AMRO,10,57,0,3
2020-04-23,HT,Haiti,AMRO,1,58,1,4
2020-04-24,HT,Haiti,AMRO,4,62,0,4
2020-04-25,HT,Haiti,AMRO,10,72,1,5
2020-04-26,HT,Haiti,AMRO,0,72,1,6
2020-04-27,HT,Haiti,AMRO,0,72,0,6
2020-04-28,HT,Haiti,AMRO,2,74,0,6
2020-04-29,HT,Haiti,AMRO,2,76,0,6
2020-04-30,HT,Haiti,AMRO,0,76,0,6
2020-05-01,HT,Haiti,AMRO,0,76,1,7
2020-05-02,HT,Haiti,AMRO,5,81,1,8
2020-05-03,HT,Haiti,AMRO,4,85,0,8
2020-05-04,HT,Haiti,AMRO,0,85,0,8
2020-05-05,HT,Haiti,AMRO,3,88,1,9
2020-05-06,HT,Haiti,AMRO,12,100,2,11
2020-05-07,HT,Haiti,AMRO,1,101,1,12
2020-05-08,HT,Haiti,AMRO,7,108,0,12
2020-05-09,HT,Haiti,AMRO,21,129,0,12
2020-05-10,HT,Haiti,AMRO,17,146,0,12
2020-05-11,HT,Haiti,AMRO,5,151,0,12
2020-05-12,HT,Haiti,AMRO,31,182,3,15
2020-05-13,HT,Haiti,AMRO,27,209,1,16
2020-05-14,HT,Haiti,AMRO,10,219,2,18
2020-05-15,HT,Haiti,AMRO,15,234,0,18
2020-05-16,HT,Haiti,AMRO,39,273,2,20
2020-05-17,HT,Haiti,AMRO,37,310,0,20
2020-05-18,HT,Haiti,AMRO,48,358,0,20
2020-05-19,HT,Haiti,AMRO,98,456,0,20
2020-05-20,HT,Haiti,AMRO,77,533,1,21
2020-05-21,HT,Haiti,AMRO,63,596,1,22
2020-05-22,HT,Haiti,AMRO,67,663,0,22
2020-05-23,HT,Haiti,AMRO,71,734,3,25
2020-05-24,HT,Haiti,AMRO,78,812,0,25
2020-05-25,HT,Haiti,AMRO,53,865,1,26
2020-05-26,HT,Haiti,AMRO,93,958,1,27
2020-05-27,HT,Haiti,AMRO,105,1063,4,31
2020-05-28,HT,Haiti,AMRO,111,1174,2,33
2020-05-29,HT,Haiti,AMRO,146,1320,1,34
2020-05-30,HT,Haiti,AMRO,123,1443,1,35
2020-05-31,HT,Haiti,AMRO,141,1584,0,35
2020-06-01,HT,Haiti,AMRO,281,1865,6,41
2020-06-02,HT,Haiti,AMRO,259,2124,3,44
2020-06-03,HT,Haiti,AMRO,102,2226,1,45
2020-06-04,HT,Haiti,AMRO,281,2507,3,48
2020-06-05,HT,Haiti,AMRO,97,2604,2,50
2020-06-06,HT,Haiti,AMRO,36,2640,0,50
2020-06-07,HT,Haiti,AMRO,284,2924,0,50
2020-06-08,HT,Haiti,AMRO,148,3072,0,50
2020-03-29,VA,Holy See,EURO,0,4,0,0
2020-03-30,VA,Holy See,EURO,2,6,0,0
2020-03-31,VA,Holy See,EURO,0,6,0,0
2020-04-01,VA,Holy See,EURO,0,6,0,0
2020-04-02,VA,Holy See,EURO,0,6,0,0
2020-04-03,VA,Holy See,EURO,1,7,0,0
2020-04-04,VA,Holy See,EURO,0,7,0,0
2020-04-05,VA,Holy See,EURO,0,7,0,0
2020-04-06,VA,Holy See,EURO,0,7,0,0
2020-04-07,VA,Holy See,EURO,0,7,0,0
2020-04-08,VA,Holy See,EURO,0,7,0,0
2020-04-09,VA,Holy See,EURO,1,8,0,0
2020-04-10,VA,Holy See,EURO,0,8,0,0
2020-04-11,VA,Holy See,EURO,0,8,0,0
2020-04-12,VA,Holy See,EURO,0,8,0,0
2020-04-13,VA,Holy See,EURO,0,8,0,0
2020-04-14,VA,Holy See,EURO,0,8,0,0
2020-04-15,VA,Holy See,EURO,0,8,0,0
2020-04-16,VA,Holy See,EURO,0,8,0,0
2020-04-17,VA,Holy See,EURO,0,8,0,0
2020-04-18,VA,Holy See,EURO,0,8,0,0
2020-04-19,VA,Holy See,EURO,0,8,0,0
2020-04-20,VA,Holy See,EURO,0,8,0,0
2020-04-21,VA,Holy See,EURO,1,9,0,0
2020-04-22,VA,Holy See,EURO,0,9,0,0
2020-04-23,VA,Holy See,EURO,0,9,0,0
2020-04-24,VA,Holy See,EURO,0,9,0,0
2020-04-25,VA,Holy See,EURO,0,9,0,0
2020-04-26,VA,Holy See,EURO,0,9,0,0
2020-04-27,VA,Holy See,EURO,0,9,0,0
2020-04-28,VA,Holy See,EURO,0,9,0,0
2020-04-29,VA,Holy See,EURO,1,10,0,0
2020-04-30,VA,Holy See,EURO,0,10,0,0
2020-05-01,VA,Holy See,EURO,1,11,0,0
2020-05-02,VA,Holy See,EURO,0,11,0,0
2020-05-03,VA,Holy See,EURO,0,11,0,0
2020-05-04,VA,Holy See,EURO,0,11,0,0
2020-05-05,VA,Holy See,EURO,0,11,0,0
2020-05-06,VA,Holy See,EURO,0,11,0,0
2020-05-07,VA,Holy See,EURO,1,12,0,0
2020-05-08,VA,Holy See,EURO,0,12,0,0
2020-05-09,VA,Holy See,EURO,0,12,0,0
2020-05-10,VA,Holy See,EURO,0,12,0,0
2020-05-11,VA,Holy See,EURO,0,12,0,0
2020-05-12,VA,Holy See,EURO,0,12,0,0
2020-05-13,VA,Holy See,EURO,0,12,0,0
2020-05-14,VA,Holy See,EURO,0,12,0,0
2020-05-15,VA,Holy See,EURO,0,12,0,0
2020-05-16,VA,Holy See,EURO,0,12,0,0
2020-05-17,VA,Holy See,EURO,0,12,0,0
2020-05-18,VA,Holy See,EURO,0,12,0,0
2020-05-19,VA,Holy See,EURO,0,12,0,0
2020-05-20,VA,Holy See,EURO,0,12,0,0
2020-05-21,VA,Holy See,EURO,0,12,0,0
2020-05-22,VA,Holy See,EURO,0,12,0,0
2020-05-23,VA,Holy See,EURO,0,12,0,0
2020-05-24,VA,Holy See,EURO,0,12,0,0
2020-05-25,VA,Holy See,EURO,0,12,0,0
2020-05-26,VA,Holy See,EURO,0,12,0,0
2020-05-27,VA,Holy See,EURO,0,12,0,0
2020-05-28,VA,Holy See,EURO,0,12,0,0
2020-05-29,VA,Holy See,EURO,0,12,0,0
2020-05-30,VA,Holy See,EURO,0,12,0,0
2020-05-31,VA,Holy See,EURO,0,12,0,0
2020-06-01,VA,Holy See,EURO,0,12,0,0
2020-06-02,VA,Holy See,EURO,0,12,0,0
2020-06-03,VA,Holy See,EURO,0,12,0,0
2020-06-04,VA,Holy See,EURO,0,12,0,0
2020-06-05,VA,Holy See,EURO,0,12,0,0
2020-06-06,VA,Holy See,EURO,0,12,0,0
2020-06-07,VA,Holy See,EURO,0,12,0,0
2020-06-08,VA,Holy See,EURO,0,12,0,0
2020-03-29,HN,Honduras,AMRO,0,67,0,1
2020-03-30,HN,Honduras,AMRO,43,110,1,2
2020-03-31,HN,Honduras,AMRO,29,139,0,2
2020-04-01,HN,Honduras,AMRO,2,141,5,7
2020-04-02,HN,Honduras,AMRO,31,172,3,10
2020-04-03,HN,Honduras,AMRO,47,219,4,14
2020-04-04,HN,Honduras,AMRO,3,222,1,15
2020-04-05,HN,Honduras,AMRO,42,264,0,15
2020-04-06,HN,Honduras,AMRO,4,268,7,22
2020-04-07,HN,Honduras,AMRO,30,298,0,22
2020-04-08,HN,Honduras,AMRO,7,305,0,22
2020-04-09,HN,Honduras,AMRO,7,312,0,22
2020-04-10,HN,Honduras,AMRO,31,343,1,23
2020-04-11,HN,Honduras,AMRO,39,382,0,23
2020-04-12,HN,Honduras,AMRO,10,392,1,24
2020-04-13,HN,Honduras,AMRO,1,393,1,25
2020-04-14,HN,Honduras,AMRO,4,397,0,25
2020-04-15,HN,Honduras,AMRO,10,407,1,26
2020-04-16,HN,Honduras,AMRO,12,419,5,31
2020-04-17,HN,Honduras,AMRO,7,426,4,35
2020-04-18,HN,Honduras,AMRO,16,442,6,41
2020-04-19,HN,Honduras,AMRO,15,457,5,46
2020-04-20,HN,Honduras,AMRO,15,472,0,46
2020-04-21,HN,Honduras,AMRO,5,477,0,46
2020-04-22,HN,Honduras,AMRO,17,494,0,46
2020-04-23,HN,Honduras,AMRO,16,510,0,46
2020-04-24,HN,Honduras,AMRO,9,519,1,47
2020-04-25,HN,Honduras,AMRO,43,562,0,47
2020-04-26,HN,Honduras,AMRO,29,591,8,55
2020-04-27,HN,Honduras,AMRO,36,627,4,59
2020-04-28,HN,Honduras,AMRO,34,661,2,61
2020-04-29,HN,Honduras,AMRO,41,702,3,64
2020-04-30,HN,Honduras,AMRO,36,738,2,66
2020-05-01,HN,Honduras,AMRO,33,771,5,71
2020-05-02,HN,Honduras,AMRO,33,804,4,75
2020-05-03,HN,Honduras,AMRO,95,899,0,75
2020-05-04,HN,Honduras,AMRO,111,1010,1,76
2020-05-05,HN,Honduras,AMRO,45,1055,6,82
2020-05-06,HN,Honduras,AMRO,123,1178,7,89
2020-05-07,HN,Honduras,AMRO,92,1270,4,93
2020-05-08,HN,Honduras,AMRO,191,1461,6,99
2020-05-09,HN,Honduras,AMRO,224,1685,6,105
2020-05-10,HN,Honduras,AMRO,86,1771,2,107
2020-05-11,HN,Honduras,AMRO,59,1830,1,108
2020-05-12,HN,Honduras,AMRO,142,1972,0,108
2020-05-13,HN,Honduras,AMRO,128,2100,8,116
2020-05-14,HN,Honduras,AMRO,-20,2080,5,121
2020-05-15,HN,Honduras,AMRO,175,2255,2,123
2020-05-16,HN,Honduras,AMRO,63,2318,10,133
2020-05-17,HN,Honduras,AMRO,142,2460,1,134
2020-05-18,HN,Honduras,AMRO,105,2565,4,138
2020-05-19,HN,Honduras,AMRO,81,2646,4,142
2020-05-20,HN,Honduras,AMRO,152,2798,4,146
2020-05-21,HN,Honduras,AMRO,157,2955,1,147
2020-05-22,HN,Honduras,AMRO,145,3100,4,151
2020-05-23,HN,Honduras,AMRO,104,3204,5,156
2020-05-24,HN,Honduras,AMRO,273,3477,11,167
2020-05-25,HN,Honduras,AMRO,266,3743,7,174
2020-05-26,HN,Honduras,AMRO,207,3950,6,180
2020-05-27,HN,Honduras,AMRO,239,4189,2,182
2020-05-28,HN,Honduras,AMRO,212,4401,6,188
2020-05-29,HN,Honduras,AMRO,239,4640,6,194
2020-05-30,HN,Honduras,AMRO,112,4752,2,196
2020-05-31,HN,Honduras,AMRO,134,4886,3,199
2020-06-01,HN,Honduras,AMRO,208,5094,2,201
2020-06-02,HN,Honduras,AMRO,108,5202,11,212
2020-06-03,HN,Honduras,AMRO,160,5362,5,217
2020-06-04,HN,Honduras,AMRO,165,5527,8,225
2020-06-05,HN,Honduras,AMRO,163,5690,9,234
2020-06-06,HN,Honduras,AMRO,190,5880,9,243
2020-06-07,HN,Honduras,AMRO,91,5971,5,248
2020-06-08,HN,Honduras,AMRO,184,6155,2,250
2020-03-29,HU,Hungary,EURO,65,408,2,13
2020-03-30,HU,Hungary,EURO,39,447,2,15
2020-03-31,HU,Hungary,EURO,45,492,1,16
2020-04-01,HU,Hungary,EURO,33,525,4,20
2020-04-02,HU,Hungary,EURO,60,585,1,21
2020-04-03,HU,Hungary,EURO,38,623,5,26
2020-04-04,HU,Hungary,EURO,55,678,6,32
2020-04-05,HU,Hungary,EURO,55,733,2,34
2020-04-06,HU,Hungary,EURO,11,744,4,38
2020-04-07,HU,Hungary,EURO,73,817,9,47
2020-04-08,HU,Hungary,EURO,78,895,11,58
2020-04-09,HU,Hungary,EURO,85,980,8,66
2020-04-10,HU,Hungary,EURO,210,1190,11,77
2020-04-11,HU,Hungary,EURO,120,1310,8,85
2020-04-12,HU,Hungary,EURO,100,1410,14,99
2020-04-13,HU,Hungary,EURO,48,1458,10,109
2020-04-14,HU,Hungary,EURO,54,1512,13,122
2020-04-15,HU,Hungary,EURO,67,1579,12,134
2020-04-16,HU,Hungary,EURO,73,1652,8,142
2020-04-17,HU,Hungary,EURO,111,1763,14,156
2020-04-18,HU,Hungary,EURO,71,1834,16,172
2020-04-19,HU,Hungary,EURO,82,1916,17,189
2020-04-20,HU,Hungary,EURO,68,1984,10,199
2020-04-21,HU,Hungary,EURO,114,2098,14,213
2020-04-22,HU,Hungary,EURO,70,2168,12,225
2020-04-23,HU,Hungary,EURO,116,2284,0,225
2020-04-24,HU,Hungary,EURO,99,2383,25,250
2020-04-25,HU,Hungary,EURO,60,2443,12,262
2020-04-26,HU,Hungary,EURO,57,2500,10,272
2020-04-27,HU,Hungary,EURO,83,2583,8,280
2020-04-28,HU,Hungary,EURO,66,2649,11,291
2020-04-29,HU,Hungary,EURO,78,2727,9,300
2020-04-30,HU,Hungary,EURO,48,2775,12,312
2020-05-01,HU,Hungary,EURO,88,2863,11,323
2020-05-02,HU,Hungary,EURO,79,2942,12,335
2020-05-03,HU,Hungary,EURO,56,2998,5,340
2020-05-04,HU,Hungary,EURO,37,3035,11,351
2020-05-05,HU,Hungary,EURO,30,3065,12,363
2020-05-06,HU,Hungary,EURO,46,3111,10,373
2020-05-07,HU,Hungary,EURO,39,3150,10,383
2020-05-08,HU,Hungary,EURO,28,3178,9,392
2020-05-09,HU,Hungary,EURO,35,3213,13,405
2020-05-10,HU,Hungary,EURO,50,3263,8,413
2020-05-11,HU,Hungary,EURO,21,3284,8,421
2020-05-12,HU,Hungary,EURO,29,3313,4,425
2020-05-13,HU,Hungary,EURO,28,3341,5,430
2020-05-14,HU,Hungary,EURO,39,3380,6,436
2020-05-15,HU,Hungary,EURO,37,3417,6,442
2020-05-16,HU,Hungary,EURO,56,3473,6,448
2020-05-17,HU,Hungary,EURO,36,3509,3,451
2020-05-18,HU,Hungary,EURO,26,3535,11,462
2020-05-19,HU,Hungary,EURO,21,3556,5,467
2020-05-20,HU,Hungary,EURO,42,3598,3,470
2020-05-21,HU,Hungary,EURO,43,3641,3,473
2020-05-22,HU,Hungary,EURO,37,3678,3,476
2020-05-23,HU,Hungary,EURO,35,3713,6,482
2020-05-24,HU,Hungary,EURO,28,3741,4,486
2020-05-25,HU,Hungary,EURO,15,3756,5,491
2020-05-26,HU,Hungary,EURO,15,3771,8,499
2020-05-27,HU,Hungary,EURO,22,3793,6,505
2020-05-28,HU,Hungary,EURO,23,3816,4,509
2020-05-29,HU,Hungary,EURO,25,3841,8,517
2020-05-30,HU,Hungary,EURO,0,3841,0,517
2020-05-31,HU,Hungary,EURO,26,3867,7,524
2020-06-01,HU,Hungary,EURO,9,3876,2,526
2020-06-02,HU,Hungary,EURO,45,3921,6,532
2020-06-03,HU,Hungary,EURO,10,3931,2,534
2020-06-04,HU,Hungary,EURO,0,3931,0,534
2020-06-05,HU,Hungary,EURO,23,3954,5,539
2020-06-06,HU,Hungary,EURO,16,3970,3,542
2020-06-07,HU,Hungary,EURO,0,3970,0,542
2020-06-08,HU,Hungary,EURO,0,3970,0,542
2020-03-29,IS,Iceland,EURO,56,1020,0,2
2020-03-30,IS,Iceland,EURO,66,1086,0,2
2020-03-31,IS,Iceland,EURO,51,1137,0,2
2020-04-01,IS,Iceland,EURO,83,1220,0,2
2020-04-02,IS,Iceland,EURO,99,1319,0,2
2020-04-03,IS,Iceland,EURO,45,1364,2,4
2020-04-04,IS,Iceland,EURO,54,1418,0,4
2020-04-05,IS,Iceland,EURO,70,1488,0,4
2020-04-06,IS,Iceland,EURO,74,1562,0,4
2020-04-07,IS,Iceland,EURO,24,1586,2,6
2020-04-08,IS,Iceland,EURO,30,1616,0,6
2020-04-09,IS,Iceland,EURO,32,1648,0,6
2020-04-10,IS,Iceland,EURO,27,1675,0,6
2020-04-11,IS,Iceland,EURO,14,1689,1,7
2020-04-12,IS,Iceland,EURO,12,1701,1,8
2020-04-13,IS,Iceland,EURO,10,1711,0,8
2020-04-14,IS,Iceland,EURO,9,1720,0,8
2020-04-15,IS,Iceland,EURO,7,1727,0,8
2020-04-16,IS,Iceland,EURO,12,1739,0,8
2020-04-17,IS,Iceland,EURO,15,1754,0,8
2020-04-18,IS,Iceland,EURO,6,1760,0,8
2020-04-19,IS,Iceland,EURO,11,1771,1,9
2020-04-20,IS,Iceland,EURO,2,1773,0,9
2020-04-21,IS,Iceland,EURO,5,1778,1,10
2020-04-22,IS,Iceland,EURO,7,1785,0,10
2020-04-23,IS,Iceland,EURO,4,1789,0,10
2020-04-24,IS,Iceland,EURO,0,1789,0,10
2020-04-25,IS,Iceland,EURO,1,1790,0,10
2020-04-26,IS,Iceland,EURO,2,1792,0,10
2020-04-27,IS,Iceland,EURO,0,1792,0,10
2020-04-28,IS,Iceland,EURO,3,1795,0,10
2020-04-29,IS,Iceland,EURO,2,1797,0,10
2020-04-30,IS,Iceland,EURO,0,1797,0,10
2020-05-01,IS,Iceland,EURO,1,1798,0,10
2020-05-02,IS,Iceland,EURO,0,1798,0,10
2020-05-03,IS,Iceland,EURO,1,1799,0,10
2020-05-04,IS,Iceland,EURO,0,1799,0,10
2020-05-05,IS,Iceland,EURO,0,1799,0,10
2020-05-06,IS,Iceland,EURO,0,1799,0,10
2020-05-07,IS,Iceland,EURO,2,1801,0,10
2020-05-08,IS,Iceland,EURO,0,1801,0,10
2020-05-09,IS,Iceland,EURO,0,1801,0,10
2020-05-10,IS,Iceland,EURO,0,1801,0,10
2020-05-11,IS,Iceland,EURO,0,1801,0,10
2020-05-12,IS,Iceland,EURO,0,1801,0,10
2020-05-13,IS,Iceland,EURO,1,1802,0,10
2020-05-14,IS,Iceland,EURO,0,1802,0,10
2020-05-15,IS,Iceland,EURO,0,1802,0,10
2020-05-16,IS,Iceland,EURO,0,1802,0,10
2020-05-17,IS,Iceland,EURO,0,1802,0,10
2020-05-18,IS,Iceland,EURO,0,1802,0,10
2020-05-19,IS,Iceland,EURO,0,1802,0,10
2020-05-20,IS,Iceland,EURO,1,1803,0,10
2020-05-21,IS,Iceland,EURO,0,1803,0,10
2020-05-22,IS,Iceland,EURO,0,1803,0,10
2020-05-23,IS,Iceland,EURO,1,1804,0,10
2020-05-24,IS,Iceland,EURO,0,1804,0,10
2020-05-25,IS,Iceland,EURO,0,1804,0,10
2020-05-26,IS,Iceland,EURO,0,1804,0,10
2020-05-27,IS,Iceland,EURO,1,1805,0,10
2020-05-28,IS,Iceland,EURO,0,1805,0,10
2020-05-29,IS,Iceland,EURO,0,1805,0,10
2020-05-30,IS,Iceland,EURO,1,1806,0,10
2020-05-31,IS,Iceland,EURO,0,1806,0,10
2020-06-01,IS,Iceland,EURO,0,1806,0,10
2020-06-02,IS,Iceland,EURO,0,1806,0,10
2020-06-03,IS,Iceland,EURO,0,1806,0,10
2020-06-04,IS,Iceland,EURO,0,1806,0,10
2020-06-05,IS,Iceland,EURO,0,1806,0,10
2020-06-06,IS,Iceland,EURO,1,1807,0,10
2020-06-07,IS,Iceland,EURO,0,1807,0,10
2020-06-08,IS,Iceland,EURO,0,1807,0,10
2020-03-29,IN,India,SEARO,70,979,6,25
2020-03-30,IN,India,SEARO,92,1071,4,29
2020-03-31,IN,India,SEARO,180,1251,3,32
2020-04-01,IN,India,SEARO,386,1637,6,38
2020-04-02,IN,India,SEARO,328,1965,12,50
2020-04-03,IN,India,SEARO,336,2301,6,56
2020-04-04,IN,India,SEARO,601,2902,12,68
2020-04-05,IN,India,SEARO,472,3374,9,77
2020-04-06,IN,India,SEARO,693,4067,32,109
2020-04-07,IN,India,SEARO,354,4421,5,114
2020-04-08,IN,India,SEARO,853,5274,35,149
2020-04-09,IN,India,SEARO,591,5865,20,169
2020-04-10,IN,India,SEARO,547,6412,30,199
2020-04-11,IN,India,SEARO,1035,7447,40,239
2020-04-12,IN,India,SEARO,909,8356,34,273
2020-04-13,IN,India,SEARO,796,9152,35,308
2020-04-14,IN,India,SEARO,1211,10363,31,339
2020-04-15,IN,India,SEARO,1076,11439,38,377
2020-04-16,IN,India,SEARO,941,12380,37,414
2020-04-17,IN,India,SEARO,1007,13387,23,437
2020-04-18,IN,India,SEARO,991,14378,43,480
2020-04-19,IN,India,SEARO,1334,15712,27,507
2020-04-20,IN,India,SEARO,1553,17265,36,543
2020-04-21,IN,India,SEARO,1336,18601,47,590
2020-04-22,IN,India,SEARO,1383,19984,50,640
2020-04-23,IN,India,SEARO,1409,21393,41,681
2020-04-24,IN,India,SEARO,1684,23077,37,718
2020-04-25,IN,India,SEARO,1429,24506,57,775
2020-04-26,IN,India,SEARO,1990,26496,49,824
2020-04-27,IN,India,SEARO,1396,27892,48,872
2020-04-28,IN,India,SEARO,1543,29435,62,934
2020-04-29,IN,India,SEARO,1897,31332,73,1007
2020-04-30,IN,India,SEARO,1718,33050,67,1074
2020-05-01,IN,India,SEARO,1993,35043,73,1147
2020-05-02,IN,India,SEARO,2293,37336,71,1218
2020-05-03,IN,India,SEARO,2644,39980,83,1301
2020-05-04,IN,India,SEARO,2553,42533,72,1373
2020-05-05,IN,India,SEARO,3900,46433,195,1568
2020-05-06,IN,India,SEARO,2958,49391,126,1694
2020-05-07,IN,India,SEARO,3561,52952,89,1783
2020-05-08,IN,India,SEARO,3390,56342,103,1886
2020-05-09,IN,India,SEARO,3320,59662,95,1981
2020-05-10,IN,India,SEARO,3277,62939,128,2109
2020-05-11,IN,India,SEARO,4213,67152,97,2206
2020-05-12,IN,India,SEARO,3604,70756,87,2293
2020-05-13,IN,India,SEARO,3525,74281,122,2415
2020-05-14,IN,India,SEARO,3722,78003,134,2549
2020-05-15,IN,India,SEARO,3967,81970,100,2649
2020-05-16,IN,India,SEARO,3970,85940,103,2752
2020-05-17,IN,India,SEARO,4987,90927,120,2872
2020-05-18,IN,India,SEARO,5242,96169,157,3029
2020-05-19,IN,India,SEARO,4970,101139,134,3163
2020-05-20,IN,India,SEARO,5611,106750,140,3303
2020-05-21,IN,India,SEARO,5609,112359,132,3435
2020-05-22,IN,India,SEARO,6088,118447,148,3583
2020-05-23,IN,India,SEARO,6654,125101,137,3720
2020-05-24,IN,India,SEARO,6767,131868,147,3867
2020-05-25,IN,India,SEARO,6977,138845,154,4021
2020-05-26,IN,India,SEARO,6535,145380,146,4167
2020-05-27,IN,India,SEARO,6387,151767,170,4337
2020-05-28,IN,India,SEARO,6566,158333,194,4531
2020-05-29,IN,India,SEARO,7466,165799,175,4706
2020-05-30,IN,India,SEARO,7964,173763,265,4971
2020-05-31,IN,India,SEARO,8380,182143,193,5164
2020-06-01,IN,India,SEARO,8392,190535,230,5394
2020-06-02,IN,India,SEARO,8171,198706,204,5598
2020-06-03,IN,India,SEARO,8909,207615,217,5815
2020-06-04,IN,India,SEARO,9304,216919,260,6075
2020-06-05,IN,India,SEARO,9851,226770,273,6348
2020-06-06,IN,India,SEARO,9887,236657,294,6642
2020-06-07,IN,India,SEARO,9971,246628,287,6929
2020-06-08,IN,India,SEARO,9983,256611,271,7200
2020-03-29,ID,Indonesia,SEARO,130,1285,12,114
2020-03-30,ID,Indonesia,SEARO,129,1414,8,122
2020-03-31,ID,Indonesia,SEARO,114,1528,14,136
2020-04-01,ID,Indonesia,SEARO,149,1677,21,157
2020-04-02,ID,Indonesia,SEARO,113,1790,13,170
2020-04-03,ID,Indonesia,SEARO,196,1986,11,181
2020-04-04,ID,Indonesia,SEARO,106,2092,10,191
2020-04-05,ID,Indonesia,SEARO,181,2273,7,198
2020-04-06,ID,Indonesia,SEARO,218,2491,11,209
2020-04-07,ID,Indonesia,SEARO,247,2738,12,221
2020-04-08,ID,Indonesia,SEARO,218,2956,19,240
2020-04-09,ID,Indonesia,SEARO,337,3293,40,280
2020-04-10,ID,Indonesia,SEARO,219,3512,26,306
2020-04-11,ID,Indonesia,SEARO,330,3842,21,327
2020-04-12,ID,Indonesia,SEARO,399,4241,46,373
2020-04-13,ID,Indonesia,SEARO,316,4557,26,399
2020-04-14,ID,Indonesia,SEARO,282,4839,60,459
2020-04-15,ID,Indonesia,SEARO,297,5136,10,469
2020-04-16,ID,Indonesia,SEARO,380,5516,27,496
2020-04-17,ID,Indonesia,SEARO,407,5923,24,520
2020-04-18,ID,Indonesia,SEARO,325,6248,15,535
2020-04-19,ID,Indonesia,SEARO,327,6575,47,582
2020-04-20,ID,Indonesia,SEARO,185,6760,8,590
2020-04-21,ID,Indonesia,SEARO,375,7135,26,616
2020-04-22,ID,Indonesia,SEARO,283,7418,19,635
2020-04-23,ID,Indonesia,SEARO,357,7775,12,647
2020-04-24,ID,Indonesia,SEARO,436,8211,42,689
2020-04-25,ID,Indonesia,SEARO,396,8607,31,720
2020-04-26,ID,Indonesia,SEARO,275,8882,23,743
2020-04-27,ID,Indonesia,SEARO,214,9096,22,765
2020-04-28,ID,Indonesia,SEARO,415,9511,8,773
2020-04-29,ID,Indonesia,SEARO,260,9771,11,784
2020-04-30,ID,Indonesia,SEARO,347,10118,8,792
2020-05-01,ID,Indonesia,SEARO,433,10551,8,800
2020-05-02,ID,Indonesia,SEARO,292,10843,31,831
2020-05-03,ID,Indonesia,SEARO,349,11192,14,845
2020-05-04,ID,Indonesia,SEARO,395,11587,19,864
2020-05-05,ID,Indonesia,SEARO,484,12071,8,872
2020-05-06,ID,Indonesia,SEARO,367,12438,23,895
2020-05-07,ID,Indonesia,SEARO,338,12776,35,930
2020-05-08,ID,Indonesia,SEARO,336,13112,13,943
2020-05-09,ID,Indonesia,SEARO,533,13645,16,959
2020-05-10,ID,Indonesia,SEARO,387,14032,14,973
2020-05-11,ID,Indonesia,SEARO,233,14265,18,991
2020-05-12,ID,Indonesia,SEARO,484,14749,16,1007
2020-05-13,ID,Indonesia,SEARO,689,15438,21,1028
2020-05-14,ID,Indonesia,SEARO,568,16006,15,1043
2020-05-15,ID,Indonesia,SEARO,490,16496,33,1076
2020-05-16,ID,Indonesia,SEARO,529,17025,13,1089
2020-05-17,ID,Indonesia,SEARO,489,17514,59,1148
2020-05-18,ID,Indonesia,SEARO,496,18010,43,1191
2020-05-19,ID,Indonesia,SEARO,486,18496,30,1221
2020-05-20,ID,Indonesia,SEARO,693,19189,21,1242
2020-05-21,ID,Indonesia,SEARO,973,20162,36,1278
2020-05-22,ID,Indonesia,SEARO,634,20796,48,1326
2020-05-23,ID,Indonesia,SEARO,949,21745,25,1351
2020-05-24,ID,Indonesia,SEARO,526,22271,21,1372
2020-05-25,ID,Indonesia,SEARO,479,22750,19,1391
2020-05-26,ID,Indonesia,SEARO,415,23165,27,1418
2020-05-27,ID,Indonesia,SEARO,686,23851,55,1473
2020-05-28,ID,Indonesia,SEARO,687,24538,23,1496
2020-05-29,ID,Indonesia,SEARO,678,25216,24,1520
2020-05-30,ID,Indonesia,SEARO,557,25773,53,1573
2020-05-31,ID,Indonesia,SEARO,700,26473,40,1613
2020-06-01,ID,Indonesia,SEARO,467,26940,28,1641
2020-06-02,ID,Indonesia,SEARO,609,27549,22,1663
2020-06-03,ID,Indonesia,SEARO,684,28233,35,1698
2020-06-04,ID,Indonesia,SEARO,585,28818,23,1721
2020-06-05,ID,Indonesia,SEARO,703,29521,49,1770
2020-06-06,ID,Indonesia,SEARO,993,30514,31,1801
2020-06-07,ID,Indonesia,SEARO,672,31186,50,1851
2020-06-08,ID,Indonesia,SEARO,847,32033,32,1883
2020-03-29,IR,Iran (Islamic Republic of),EMRO,3076,35408,139,2517
2020-03-30,IR,Iran (Islamic Republic of),EMRO,2901,38309,123,2640
2020-03-31,IR,Iran (Islamic Republic of),EMRO,3186,41495,117,2757
2020-04-01,IR,Iran (Islamic Republic of),EMRO,3111,44606,141,2898
2020-04-02,IR,Iran (Islamic Republic of),EMRO,2987,47593,138,3036
2020-04-03,IR,Iran (Islamic Republic of),EMRO,2875,50468,124,3160
2020-04-04,IR,Iran (Islamic Republic of),EMRO,2715,53183,134,3294
2020-04-05,IR,Iran (Islamic Republic of),EMRO,2560,55743,158,3452
2020-04-06,IR,Iran (Islamic Republic of),EMRO,2483,58226,151,3603
2020-04-07,IR,Iran (Islamic Republic of),EMRO,2274,60500,136,3739
2020-04-08,IR,Iran (Islamic Republic of),EMRO,2089,62589,133,3872
2020-04-09,IR,Iran (Islamic Republic of),EMRO,1997,64586,121,3993
2020-04-10,IR,Iran (Islamic Republic of),EMRO,1634,66220,117,4110
2020-04-11,IR,Iran (Islamic Republic of),EMRO,1972,68192,122,4232
2020-04-12,IR,Iran (Islamic Republic of),EMRO,1837,70029,125,4357
2020-04-13,IR,Iran (Islamic Republic of),EMRO,1657,71686,117,4474
2020-04-14,IR,Iran (Islamic Republic of),EMRO,1617,73303,111,4585
2020-04-15,IR,Iran (Islamic Republic of),EMRO,1574,74877,98,4683
2020-04-16,IR,Iran (Islamic Republic of),EMRO,1512,76389,94,4777
2020-04-17,IR,Iran (Islamic Republic of),EMRO,1606,77995,92,4869
2020-04-18,IR,Iran (Islamic Republic of),EMRO,1499,79494,89,4958
2020-04-19,IR,Iran (Islamic Republic of),EMRO,1374,80868,73,5031
2020-04-20,IR,Iran (Islamic Republic of),EMRO,1343,82211,87,5118
2020-04-21,IR,Iran (Islamic Republic of),EMRO,1294,83505,91,5209
2020-04-22,IR,Iran (Islamic Republic of),EMRO,1297,84802,88,5297
2020-04-23,IR,Iran (Islamic Republic of),EMRO,1194,85996,94,5391
2020-04-24,IR,Iran (Islamic Republic of),EMRO,1030,87026,90,5481
2020-04-25,IR,Iran (Islamic Republic of),EMRO,1168,88194,93,5574
2020-04-26,IR,Iran (Islamic Republic of),EMRO,1134,89328,76,5650
2020-04-27,IR,Iran (Islamic Republic of),EMRO,1153,90481,60,5710
2020-04-28,IR,Iran (Islamic Republic of),EMRO,991,91472,96,5806
2020-04-29,IR,Iran (Islamic Republic of),EMRO,1112,92584,71,5877
2020-04-30,IR,Iran (Islamic Republic of),EMRO,1073,93657,80,5957
2020-05-01,IR,Iran (Islamic Republic of),EMRO,983,94640,71,6028
2020-05-02,IR,Iran (Islamic Republic of),EMRO,1006,95646,63,6091
2020-05-03,IR,Iran (Islamic Republic of),EMRO,802,96448,65,6156
2020-05-04,IR,Iran (Islamic Republic of),EMRO,976,97424,47,6203
2020-05-05,IR,Iran (Islamic Republic of),EMRO,1223,98647,74,6277
2020-05-06,IR,Iran (Islamic Republic of),EMRO,1323,99970,63,6340
2020-05-07,IR,Iran (Islamic Republic of),EMRO,1680,101650,78,6418
2020-05-08,IR,Iran (Islamic Republic of),EMRO,1485,103135,68,6486
2020-05-09,IR,Iran (Islamic Republic of),EMRO,1556,104691,55,6541
2020-05-10,IR,Iran (Islamic Republic of),EMRO,1529,106220,48,6589
2020-05-11,IR,Iran (Islamic Republic of),EMRO,1383,107603,51,6640
2020-05-12,IR,Iran (Islamic Republic of),EMRO,1683,109286,45,6685
2020-05-13,IR,Iran (Islamic Republic of),EMRO,1481,110767,48,6733
2020-05-14,IR,Iran (Islamic Republic of),EMRO,1958,112725,50,6783
2020-05-15,IR,Iran (Islamic Republic of),EMRO,1808,114533,71,6854
2020-05-16,IR,Iran (Islamic Republic of),EMRO,2102,116635,48,6902
2020-05-17,IR,Iran (Islamic Republic of),EMRO,1757,118392,35,6937
2020-05-18,IR,Iran (Islamic Republic of),EMRO,1806,120198,51,6988
2020-05-19,IR,Iran (Islamic Republic of),EMRO,2294,122492,69,7057
2020-05-20,IR,Iran (Islamic Republic of),EMRO,2111,124603,62,7119
2020-05-21,IR,Iran (Islamic Republic of),EMRO,2346,126949,64,7183
2020-05-22,IR,Iran (Islamic Republic of),EMRO,2392,129341,66,7249
2020-05-23,IR,Iran (Islamic Republic of),EMRO,2311,131652,51,7300
2020-05-24,IR,Iran (Islamic Republic of),EMRO,1869,133521,59,7359
2020-05-25,IR,Iran (Islamic Republic of),EMRO,2180,135701,58,7417
2020-05-26,IR,Iran (Islamic Republic of),EMRO,2023,137724,34,7451
2020-05-27,IR,Iran (Islamic Republic of),EMRO,1787,139511,57,7508
2020-05-28,IR,Iran (Islamic Republic of),EMRO,2080,141591,56,7564
2020-05-29,IR,Iran (Islamic Republic of),EMRO,2258,143849,63,7627
2020-05-30,IR,Iran (Islamic Republic of),EMRO,2819,146668,50,7677
2020-05-31,IR,Iran (Islamic Republic of),EMRO,2282,148950,57,7734
2020-06-01,IR,Iran (Islamic Republic of),EMRO,2516,151466,63,7797
2020-06-02,IR,Iran (Islamic Republic of),EMRO,2979,154445,81,7878
2020-06-03,IR,Iran (Islamic Republic of),EMRO,3117,157562,64,7942
2020-06-04,IR,Iran (Islamic Republic of),EMRO,3134,160696,70,8012
2020-06-05,IR,Iran (Islamic Republic of),EMRO,3574,164270,59,8071
2020-06-06,IR,Iran (Islamic Republic of),EMRO,2886,167156,63,8134
2020-06-07,IR,Iran (Islamic Republic of),EMRO,2269,169425,75,8209
2020-06-08,IR,Iran (Islamic Republic of),EMRO,2364,171789,72,8281
2020-03-29,IQ,Iraq,EMRO,48,506,2,42
2020-03-30,IQ,Iraq,EMRO,41,547,0,42
2020-03-31,IQ,Iraq,EMRO,82,629,4,46
2020-04-01,IQ,Iraq,EMRO,65,694,4,50
2020-04-02,IQ,Iraq,EMRO,34,728,2,52
2020-04-03,IQ,Iraq,EMRO,44,772,2,54
2020-04-04,IQ,Iraq,EMRO,48,820,0,54
2020-04-05,IQ,Iraq,EMRO,58,878,2,56
2020-04-06,IQ,Iraq,EMRO,83,961,5,61
2020-04-07,IQ,Iraq,EMRO,70,1031,3,64
2020-04-08,IQ,Iraq,EMRO,91,1122,1,65
2020-04-09,IQ,Iraq,EMRO,80,1202,4,69
2020-04-10,IQ,Iraq,EMRO,30,1232,0,69
2020-04-11,IQ,Iraq,EMRO,47,1279,1,70
2020-04-12,IQ,Iraq,EMRO,39,1318,2,72
2020-04-13,IQ,Iraq,EMRO,34,1352,4,76
2020-04-14,IQ,Iraq,EMRO,26,1378,2,78
2020-04-15,IQ,Iraq,EMRO,22,1400,0,78
2020-04-16,IQ,Iraq,EMRO,15,1415,1,79
2020-04-17,IQ,Iraq,EMRO,19,1434,1,80
2020-04-18,IQ,Iraq,EMRO,48,1482,1,81
2020-04-19,IQ,Iraq,EMRO,31,1513,1,82
2020-04-20,IQ,Iraq,EMRO,26,1539,0,82
2020-04-21,IQ,Iraq,EMRO,35,1574,0,82
2020-04-22,IQ,Iraq,EMRO,28,1602,1,83
2020-04-23,IQ,Iraq,EMRO,29,1631,0,83
2020-04-24,IQ,Iraq,EMRO,46,1677,0,83
2020-04-25,IQ,Iraq,EMRO,31,1708,3,86
2020-04-26,IQ,Iraq,EMRO,55,1763,0,86
2020-04-27,IQ,Iraq,EMRO,57,1820,1,87
2020-04-28,IQ,Iraq,EMRO,27,1847,1,88
2020-04-29,IQ,Iraq,EMRO,81,1928,2,90
2020-04-30,IQ,Iraq,EMRO,75,2003,2,92
2020-05-01,IQ,Iraq,EMRO,82,2085,1,93
2020-05-02,IQ,Iraq,EMRO,68,2153,1,94
2020-05-03,IQ,Iraq,EMRO,66,2219,1,95
2020-05-04,IQ,Iraq,EMRO,77,2296,2,97
2020-05-05,IQ,Iraq,EMRO,50,2346,1,98
2020-05-06,IQ,Iraq,EMRO,85,2431,4,102
2020-05-07,IQ,Iraq,EMRO,49,2480,0,102
2020-05-08,IQ,Iraq,EMRO,63,2543,0,102
2020-05-09,IQ,Iraq,EMRO,60,2603,2,104
2020-05-10,IQ,Iraq,EMRO,76,2679,3,107
2020-05-11,IQ,Iraq,EMRO,88,2767,2,109
2020-05-12,IQ,Iraq,EMRO,51,2818,1,110
2020-05-13,IQ,Iraq,EMRO,95,2913,2,112
2020-05-14,IQ,Iraq,EMRO,119,3032,3,115
2020-05-15,IQ,Iraq,EMRO,111,3143,0,115
2020-05-16,IQ,Iraq,EMRO,50,3193,2,117
2020-05-17,IQ,Iraq,EMRO,67,3260,4,121
2020-05-18,IQ,Iraq,EMRO,144,3404,2,123
2020-05-19,IQ,Iraq,EMRO,150,3554,4,127
2020-05-20,IQ,Iraq,EMRO,57,3611,4,131
2020-05-21,IQ,Iraq,EMRO,113,3724,3,134
2020-05-22,IQ,Iraq,EMRO,153,3877,6,140
2020-05-23,IQ,Iraq,EMRO,87,3964,7,147
2020-05-24,IQ,Iraq,EMRO,308,4272,5,152
2020-05-25,IQ,Iraq,EMRO,197,4469,8,160
2020-05-26,IQ,Iraq,EMRO,163,4632,3,163
2020-05-27,IQ,Iraq,EMRO,216,4848,6,169
2020-05-28,IQ,Iraq,EMRO,287,5135,6,175
2020-05-29,IQ,Iraq,EMRO,322,5457,4,179
2020-05-30,IQ,Iraq,EMRO,416,5873,6,185
2020-05-31,IQ,Iraq,EMRO,306,6179,10,195
2020-06-01,IQ,Iraq,EMRO,260,6439,10,205
2020-06-02,IQ,Iraq,EMRO,429,6868,10,215
2020-06-03,IQ,Iraq,EMRO,519,7387,20,235
2020-06-04,IQ,Iraq,EMRO,781,8168,21,256
2020-06-05,IQ,Iraq,EMRO,672,8840,15,271
2020-06-06,IQ,Iraq,EMRO,1006,9846,14,285
2020-06-07,IQ,Iraq,EMRO,1252,11098,33,318
2020-06-08,IQ,Iraq,EMRO,1268,12366,28,346
2020-03-29,IE,Ireland,EURO,302,2121,15,54
2020-03-30,IE,Ireland,EURO,294,2415,4,58
2020-03-31,IE,Ireland,EURO,210,2625,14,72
2020-04-01,IE,Ireland,EURO,285,2910,21,93
2020-04-02,IE,Ireland,EURO,325,3235,16,109
2020-04-03,IE,Ireland,EURO,212,3447,20,129
2020-04-04,IE,Ireland,EURO,402,3849,22,151
2020-04-05,IE,Ireland,EURO,424,4273,24,175
2020-04-06,IE,Ireland,EURO,331,4604,36,211
2020-04-07,IE,Ireland,EURO,390,4994,42,253
2020-04-08,IE,Ireland,EURO,865,5859,36,289
2020-04-09,IE,Ireland,EURO,365,6224,34,323
2020-04-10,IE,Ireland,EURO,464,6688,51,374
2020-04-11,IE,Ireland,EURO,705,7393,34,408
2020-04-12,IE,Ireland,EURO,696,8089,46,454
2020-04-13,IE,Ireland,EURO,839,8928,48,502
2020-04-14,IE,Ireland,EURO,727,9655,46,548
2020-04-15,IE,Ireland,EURO,992,10647,57,605
2020-04-16,IE,Ireland,EURO,831,11478,47,652
2020-04-17,IE,Ireland,EURO,1069,12547,50,702
2020-04-18,IE,Ireland,EURO,724,13271,51,753
2020-04-19,IE,Ireland,EURO,709,13980,43,796
2020-04-20,IE,Ireland,EURO,778,14758,54,850
2020-04-21,IE,Ireland,EURO,493,15251,45,895
2020-04-22,IE,Ireland,EURO,401,15652,39,934
2020-04-23,IE,Ireland,EURO,388,16040,39,973
2020-04-24,IE,Ireland,EURO,631,16671,44,1017
2020-04-25,IE,Ireland,EURO,936,17607,35,1052
2020-04-26,IE,Ireland,EURO,577,18184,34,1086
2020-04-27,IE,Ireland,EURO,377,18561,48,1134
2020-04-28,IE,Ireland,EURO,701,19262,18,1152
2020-04-29,IE,Ireland,EURO,386,19648,39,1191
2020-04-30,IE,Ireland,EURO,229,19877,21,1212
2020-05-01,IE,Ireland,EURO,376,20253,19,1231
2020-05-02,IE,Ireland,EURO,359,20612,28,1259
2020-05-03,IE,Ireland,EURO,221,20833,28,1287
2020-05-04,IE,Ireland,EURO,343,21176,24,1311
2020-05-05,IE,Ireland,EURO,330,21506,27,1338
2020-05-06,IE,Ireland,EURO,266,21772,25,1363
2020-05-07,IE,Ireland,EURO,211,21983,18,1381
2020-05-08,IE,Ireland,EURO,265,22248,24,1405
2020-05-09,IE,Ireland,EURO,137,22385,29,1434
2020-05-10,IE,Ireland,EURO,156,22541,18,1452
2020-05-11,IE,Ireland,EURO,219,22760,18,1470
2020-05-12,IE,Ireland,EURO,236,22996,14,1484
2020-05-13,IE,Ireland,EURO,139,23135,11,1495
2020-05-14,IE,Ireland,EURO,107,23242,12,1507
2020-05-15,IE,Ireland,EURO,159,23401,6,1513
2020-05-16,IE,Ireland,EURO,426,23827,15,1528
2020-05-17,IE,Ireland,EURO,129,23956,7,1535
2020-05-18,IE,Ireland,EURO,92,24048,14,1549
2020-05-19,IE,Ireland,EURO,64,24112,8,1557
2020-05-20,IE,Ireland,EURO,88,24200,12,1569
2020-05-21,IE,Ireland,EURO,51,24251,9,1578
2020-05-22,IE,Ireland,EURO,64,24315,8,1586
2020-05-23,IE,Ireland,EURO,76,24391,5,1591
2020-05-24,IE,Ireland,EURO,115,24506,5,1596
2020-05-25,IE,Ireland,EURO,76,24582,3,1599
2020-05-26,IE,Ireland,EURO,57,24639,6,1605
2020-05-27,IE,Ireland,EURO,59,24698,6,1611
2020-05-28,IE,Ireland,EURO,37,24735,8,1619
2020-05-29,IE,Ireland,EURO,68,24803,6,1625
2020-05-30,IE,Ireland,EURO,38,24841,4,1629
2020-05-31,IE,Ireland,EURO,35,24876,7,1636
2020-06-01,IE,Ireland,EURO,53,24929,5,1641
2020-06-02,IE,Ireland,EURO,61,24990,5,1646
2020-06-03,IE,Ireland,EURO,72,25062,4,1650
2020-06-04,IE,Ireland,EURO,4,25066,2,1652
2020-06-05,IE,Ireland,EURO,45,25111,2,1654
2020-06-06,IE,Ireland,EURO,31,25142,5,1659
2020-06-07,IE,Ireland,EURO,21,25163,4,1663
2020-06-08,IE,Ireland,EURO,20,25183,3,1666
2020-03-29,IM,Isle of Man,EURO,3,32,0,0
2020-03-30,IM,Isle of Man,EURO,4,36,0,0
2020-03-31,IM,Isle of Man,EURO,8,44,0,0
2020-04-01,IM,Isle of Man,EURO,9,53,0,0
2020-04-02,IM,Isle of Man,EURO,11,64,0,0
2020-04-03,IM,Isle of Man,EURO,8,72,1,1
2020-04-04,IM,Isle of Man,EURO,21,93,0,1
2020-04-05,IM,Isle of Man,EURO,27,120,0,1
2020-04-06,IM,Isle of Man,EURO,6,126,0,1
2020-04-07,IM,Isle of Man,EURO,3,129,0,1
2020-04-08,IM,Isle of Man,EURO,22,151,0,1
2020-04-09,IM,Isle of Man,EURO,1,152,0,1
2020-04-10,IM,Isle of Man,EURO,13,165,5,6
2020-04-11,IM,Isle of Man,EURO,27,192,0,6
2020-04-12,IM,Isle of Man,EURO,14,206,0,6
2020-04-13,IM,Isle of Man,EURO,22,228,0,6
2020-04-14,IM,Isle of Man,EURO,5,233,1,7
2020-04-15,IM,Isle of Man,EURO,11,244,0,7
2020-04-16,IM,Isle of Man,EURO,14,258,0,7
2020-04-17,IM,Isle of Man,EURO,2,260,2,9
2020-04-18,IM,Isle of Man,EURO,31,291,0,9
2020-04-19,IM,Isle of Man,EURO,2,293,0,9
2020-04-20,IM,Isle of Man,EURO,6,299,0,9
2020-04-21,IM,Isle of Man,EURO,2,301,0,9
2020-04-22,IM,Isle of Man,EURO,8,309,6,15
2020-04-23,IM,Isle of Man,EURO,0,309,0,15
2020-04-24,IM,Isle of Man,EURO,0,309,6,21
2020-04-25,IM,Isle of Man,EURO,1,310,1,22
2020-04-26,IM,Isle of Man,EURO,0,310,1,23
2020-04-27,IM,Isle of Man,EURO,0,310,0,23
2020-04-28,IM,Isle of Man,EURO,0,310,0,23
2020-04-29,IM,Isle of Man,EURO,0,310,2,25
2020-04-30,IM,Isle of Man,EURO,1,311,1,26
2020-05-01,IM,Isle of Man,EURO,6,317,1,27
2020-05-02,IM,Isle of Man,EURO,1,318,0,27
2020-05-03,IM,Isle of Man,EURO,3,321,1,28
2020-05-04,IM,Isle of Man,EURO,1,322,0,28
2020-05-05,IM,Isle of Man,EURO,1,323,0,28
2020-05-06,IM,Isle of Man,EURO,4,327,0,28
2020-05-07,IM,Isle of Man,EURO,1,328,0,28
2020-05-08,IM,Isle of Man,EURO,1,329,0,28
2020-05-09,IM,Isle of Man,EURO,2,331,0,28
2020-05-10,IM,Isle of Man,EURO,0,331,5,33
2020-05-11,IM,Isle of Man,EURO,1,332,0,33
2020-05-12,IM,Isle of Man,EURO,0,332,0,33
2020-05-13,IM,Isle of Man,EURO,1,333,0,33
2020-05-14,IM,Isle of Man,EURO,0,333,1,34
2020-05-15,IM,Isle of Man,EURO,1,334,0,34
2020-05-16,IM,Isle of Man,EURO,1,335,0,34
2020-05-17,IM,Isle of Man,EURO,2,337,0,34
2020-05-18,IM,Isle of Man,EURO,0,337,0,34
2020-05-19,IM,Isle of Man,EURO,0,337,0,34
2020-05-20,IM,Isle of Man,EURO,0,337,0,34
2020-05-21,IM,Isle of Man,EURO,1,338,0,34
2020-05-22,IM,Isle of Man,EURO,0,338,0,34
2020-05-23,IM,Isle of Man,EURO,0,338,0,34
2020-05-24,IM,Isle of Man,EURO,0,338,0,34
2020-05-25,IM,Isle of Man,EURO,0,338,0,34
2020-05-26,IM,Isle of Man,EURO,0,338,0,34
2020-05-27,IM,Isle of Man,EURO,0,338,0,34
2020-05-28,IM,Isle of Man,EURO,0,338,0,34
2020-05-29,IM,Isle of Man,EURO,0,338,0,34
2020-05-30,IM,Isle of Man,EURO,0,338,0,34
2020-05-31,IM,Isle of Man,EURO,0,338,0,34
2020-06-01,IM,Isle of Man,EURO,0,338,0,34
2020-06-02,IM,Isle of Man,EURO,0,338,0,34
2020-06-03,IM,Isle of Man,EURO,0,338,0,34
2020-06-04,IM,Isle of Man,EURO,0,338,0,34
2020-06-05,IM,Isle of Man,EURO,0,338,0,34
2020-06-06,IM,Isle of Man,EURO,0,338,0,34
2020-06-07,IM,Isle of Man,EURO,0,338,0,34
2020-06-08,IM,Isle of Man,EURO,0,338,0,34
2020-03-29,IL,Israel,EURO,476,3904,1,13
2020-03-30,IL,Israel,EURO,529,4433,3,16
2020-03-31,IL,Israel,EURO,549,4982,1,17
2020-04-01,IL,Israel,EURO,737,5719,4,21
2020-04-02,IL,Israel,EURO,693,6412,8,29
2020-04-03,IL,Israel,EURO,724,7136,9,38
2020-04-04,IL,Israel,EURO,600,7736,5,43
2020-04-05,IL,Israel,EURO,427,8163,6,49
2020-04-06,IL,Israel,EURO,584,8747,7,56
2020-04-07,IL,Israel,EURO,449,9196,8,64
2020-04-08,IL,Israel,EURO,376,9572,8,72
2020-04-09,IL,Israel,EURO,340,9912,8,80
2020-04-10,IL,Israel,EURO,340,10252,9,89
2020-04-11,IL,Israel,EURO,355,10607,8,97
2020-04-12,IL,Israel,EURO,342,10949,6,103
2020-04-13,IL,Israel,EURO,551,11500,6,109
2020-04-14,IL,Israel,EURO,437,11937,9,118
2020-04-15,IL,Israel,EURO,393,12330,8,126
2020-04-16,IL,Israel,EURO,305,12635,13,139
2020-04-17,IL,Israel,EURO,296,12931,7,146
2020-04-18,IL,Israel,EURO,297,13228,9,155
2020-04-19,IL,Israel,EURO,288,13516,11,166
2020-04-20,IL,Israel,EURO,274,13790,8,174
2020-04-21,IL,Israel,EURO,297,14087,6,180
2020-04-22,IL,Israel,EURO,279,14366,10,190
2020-04-23,IL,Israel,EURO,226,14592,3,193
2020-04-24,IL,Israel,EURO,274,14866,4,197
2020-04-25,IL,Israel,EURO,250,15116,3,200
2020-04-26,IL,Israel,EURO,159,15275,3,203
2020-04-27,IL,Israel,EURO,82,15357,2,205
2020-04-28,IL,Israel,EURO,127,15484,4,209
2020-04-29,IL,Israel,EURO,161,15645,5,214
2020-04-30,IL,Israel,EURO,82,15727,6,220
2020-05-01,IL,Israel,EURO,143,15870,6,226
2020-05-02,IL,Israel,EURO,116,15986,4,230
2020-05-03,IL,Israel,EURO,57,16043,3,233
2020-05-04,IL,Israel,EURO,26,16069,3,236
2020-05-05,IL,Israel,EURO,55,16124,3,239
2020-05-06,IL,Israel,EURO,33,16157,2,241
2020-05-07,IL,Israel,EURO,65,16222,1,242
2020-05-08,IL,Israel,EURO,61,16283,1,243
2020-05-09,IL,Israel,EURO,33,16316,6,249
2020-05-10,IL,Israel,EURO,20,16336,3,252
2020-05-11,IL,Israel,EURO,29,16365,4,256
2020-05-12,IL,Israel,EURO,39,16404,5,261
2020-05-13,IL,Israel,EURO,23,16427,3,264
2020-05-14,IL,Israel,EURO,39,16466,3,267
2020-05-15,IL,Israel,EURO,22,16488,3,270
2020-05-16,IL,Israel,EURO,12,16500,0,270
2020-05-17,IL,Israel,EURO,5,16505,3,273
2020-05-18,IL,Israel,EURO,15,16520,4,277
2020-05-19,IL,Israel,EURO,27,16547,3,280
2020-05-20,IL,Israel,EURO,22,16569,2,282
2020-05-21,IL,Israel,EURO,15,16584,1,283
2020-05-22,IL,Israel,EURO,18,16602,0,283
2020-05-23,IL,Israel,EURO,19,16621,0,283
2020-05-24,IL,Israel,EURO,5,16626,0,283
2020-05-25,IL,Israel,EURO,13,16639,1,284
2020-05-26,IL,Israel,EURO,22,16661,2,286
2020-05-27,IL,Israel,EURO,50,16711,0,286
2020-05-28,IL,Israel,EURO,40,16751,2,288
2020-05-29,IL,Israel,EURO,77,16828,1,289
2020-05-30,IL,Israel,EURO,113,16941,0,289
2020-05-31,IL,Israel,EURO,29,16970,0,289
2020-06-01,IL,Israel,EURO,87,17057,0,289
2020-06-02,IL,Israel,EURO,100,17157,3,292
2020-06-03,IL,Israel,EURO,122,17279,2,294
2020-06-04,IL,Israel,EURO,96,17375,1,295
2020-06-05,IL,Israel,EURO,142,17517,0,295
2020-06-06,IL,Israel,EURO,127,17644,1,296
2020-06-07,IL,Israel,EURO,78,17722,4,300
2020-06-08,IL,Israel,EURO,140,17862,2,302
2020-03-29,IT,Italy,EURO,5974,92472,889,10023
2020-03-30,IT,Italy,EURO,5217,97689,756,10779
2020-03-31,IT,Italy,EURO,4050,101739,812,11591
2020-04-01,IT,Italy,EURO,4053,105792,837,12428
2020-04-02,IT,Italy,EURO,4782,110574,727,13155
2020-04-03,IT,Italy,EURO,4668,115242,760,13915
2020-04-04,IT,Italy,EURO,4585,119827,766,14681
2020-04-05,IT,Italy,EURO,4805,124632,681,15362
2020-04-06,IT,Italy,EURO,4316,128948,525,15887
2020-04-07,IT,Italy,EURO,3599,132547,636,16523
2020-04-08,IT,Italy,EURO,3039,135586,604,17127
2020-04-09,IT,Italy,EURO,3836,139422,542,17669
2020-04-10,IT,Italy,EURO,4204,143626,610,18279
2020-04-11,IT,Italy,EURO,3951,147577,570,18849
2020-04-12,IT,Italy,EURO,4694,152271,619,19468
2020-04-13,IT,Italy,EURO,4092,156363,431,19899
2020-04-14,IT,Italy,EURO,3153,159516,566,20465
2020-04-15,IT,Italy,EURO,2972,162488,602,21067
2020-04-16,IT,Italy,EURO,2667,165155,578,21645
2020-04-17,IT,Italy,EURO,3786,168941,525,22170
2020-04-18,IT,Italy,EURO,3493,172434,575,22745
2020-04-19,IT,Italy,EURO,3491,175925,482,23227
2020-04-20,IT,Italy,EURO,3047,178972,433,23660
2020-04-21,IT,Italy,EURO,2256,181228,454,24114
2020-04-22,IT,Italy,EURO,2729,183957,534,24648
2020-04-23,IT,Italy,EURO,3370,187327,437,25085
2020-04-24,IT,Italy,EURO,2646,189973,464,25549
2020-04-25,IT,Italy,EURO,3021,192994,420,25969
2020-04-26,IT,Italy,EURO,2357,195351,415,26384
2020-04-27,IT,Italy,EURO,2324,197675,260,26644
2020-04-28,IT,Italy,EURO,1739,199414,333,26977
2020-04-29,IT,Italy,EURO,2091,201505,382,27359
2020-04-30,IT,Italy,EURO,2086,203591,323,27682
2020-05-01,IT,Italy,EURO,1872,205463,285,27967
2020-05-02,IT,Italy,EURO,1965,207428,269,28236
2020-05-03,IT,Italy,EURO,1900,209328,474,28710
2020-05-04,IT,Italy,EURO,1389,210717,174,28884
2020-05-05,IT,Italy,EURO,1221,211938,195,29079
2020-05-06,IT,Italy,EURO,1075,213013,236,29315
2020-05-07,IT,Italy,EURO,1444,214457,369,29684
2020-05-08,IT,Italy,EURO,1401,215858,274,29958
2020-05-09,IT,Italy,EURO,1327,217185,243,30201
2020-05-10,IT,Italy,EURO,1083,218268,194,30395
2020-05-11,IT,Italy,EURO,802,219070,165,30560
2020-05-12,IT,Italy,EURO,744,219814,179,30739
2020-05-13,IT,Italy,EURO,1402,221216,172,30911
2020-05-14,IT,Italy,EURO,888,222104,195,31106
2020-05-15,IT,Italy,EURO,992,223096,262,31368
2020-05-16,IT,Italy,EURO,789,223885,242,31610
2020-05-17,IT,Italy,EURO,875,224760,153,31763
2020-05-18,IT,Italy,EURO,675,225435,145,31908
2020-05-19,IT,Italy,EURO,451,225886,99,32007
2020-05-20,IT,Italy,EURO,813,226699,162,32169
2020-05-21,IT,Italy,EURO,665,227364,161,32330
2020-05-22,IT,Italy,EURO,642,228006,156,32486
2020-05-23,IT,Italy,EURO,652,228658,130,32616
2020-05-24,IT,Italy,EURO,669,229327,119,32735
2020-05-25,IT,Italy,EURO,531,229858,50,32785
2020-05-26,IT,Italy,EURO,300,230158,92,32877
2020-05-27,IT,Italy,EURO,397,230555,78,32955
2020-05-28,IT,Italy,EURO,584,231139,117,33072
2020-05-29,IT,Italy,EURO,593,231732,70,33142
2020-05-30,IT,Italy,EURO,516,232248,87,33229
2020-05-31,IT,Italy,EURO,416,232664,111,33340
2020-06-01,IT,Italy,EURO,355,233019,75,33415
2020-06-02,IT,Italy,EURO,178,233197,60,33475
2020-06-03,IT,Italy,EURO,318,233515,55,33530
2020-06-04,IT,Italy,EURO,321,233836,71,33601
2020-06-05,IT,Italy,EURO,177,234013,88,33689
2020-06-06,IT,Italy,EURO,518,234531,85,33774
2020-06-07,IT,Italy,EURO,270,234801,72,33846
2020-06-08,IT,Italy,EURO,197,234998,53,33899
2020-03-29,JM,Jamaica,AMRO,4,30,0,1
2020-03-30,JM,Jamaica,AMRO,2,32,0,1
2020-03-31,JM,Jamaica,AMRO,4,36,0,1
2020-04-01,JM,Jamaica,AMRO,0,36,0,1
2020-04-02,JM,Jamaica,AMRO,2,38,0,1
2020-04-03,JM,Jamaica,AMRO,6,44,2,3
2020-04-04,JM,Jamaica,AMRO,3,47,0,3
2020-04-05,JM,Jamaica,AMRO,6,53,0,3
2020-04-06,JM,Jamaica,AMRO,2,55,0,3
2020-04-07,JM,Jamaica,AMRO,3,58,0,3
2020-04-08,JM,Jamaica,AMRO,1,59,0,3
2020-04-09,JM,Jamaica,AMRO,4,63,0,3
2020-04-10,JM,Jamaica,AMRO,0,63,1,4
2020-04-11,JM,Jamaica,AMRO,0,63,0,4
2020-04-12,JM,Jamaica,AMRO,2,65,0,4
2020-04-13,JM,Jamaica,AMRO,4,69,0,4
2020-04-14,JM,Jamaica,AMRO,3,72,0,4
2020-04-15,JM,Jamaica,AMRO,1,73,0,4
2020-04-16,JM,Jamaica,AMRO,32,105,1,5
2020-04-17,JM,Jamaica,AMRO,20,125,0,5
2020-04-18,JM,Jamaica,AMRO,18,143,0,5
2020-04-19,JM,Jamaica,AMRO,20,163,0,5
2020-04-20,JM,Jamaica,AMRO,10,173,0,5
2020-04-21,JM,Jamaica,AMRO,23,196,0,5
2020-04-22,JM,Jamaica,AMRO,27,223,1,6
2020-04-23,JM,Jamaica,AMRO,10,233,0,6
2020-04-24,JM,Jamaica,AMRO,10,243,0,6
2020-04-25,JM,Jamaica,AMRO,14,257,1,7
2020-04-26,JM,Jamaica,AMRO,31,288,0,7
2020-04-27,JM,Jamaica,AMRO,17,305,0,7
2020-04-28,JM,Jamaica,AMRO,0,305,0,7
2020-04-29,JM,Jamaica,AMRO,59,364,0,7
2020-04-30,JM,Jamaica,AMRO,17,381,0,7
2020-05-01,JM,Jamaica,AMRO,15,396,0,7
2020-05-02,JM,Jamaica,AMRO,26,422,1,8
2020-05-03,JM,Jamaica,AMRO,10,432,0,8
2020-05-04,JM,Jamaica,AMRO,31,463,0,8
2020-05-05,JM,Jamaica,AMRO,6,469,1,9
2020-05-06,JM,Jamaica,AMRO,2,471,0,9
2020-05-07,JM,Jamaica,AMRO,2,473,0,9
2020-05-08,JM,Jamaica,AMRO,5,478,0,9
2020-05-09,JM,Jamaica,AMRO,10,488,0,9
2020-05-10,JM,Jamaica,AMRO,2,490,0,9
2020-05-11,JM,Jamaica,AMRO,8,498,0,9
2020-05-12,JM,Jamaica,AMRO,4,502,0,9
2020-05-13,JM,Jamaica,AMRO,3,505,0,9
2020-05-14,JM,Jamaica,AMRO,2,507,0,9
2020-05-15,JM,Jamaica,AMRO,2,509,0,9
2020-05-16,JM,Jamaica,AMRO,0,509,0,9
2020-05-17,JM,Jamaica,AMRO,2,511,0,9
2020-05-18,JM,Jamaica,AMRO,6,517,0,9
2020-05-19,JM,Jamaica,AMRO,3,520,0,9
2020-05-20,JM,Jamaica,AMRO,0,520,0,9
2020-05-21,JM,Jamaica,AMRO,0,520,0,9
2020-05-22,JM,Jamaica,AMRO,9,529,0,9
2020-05-23,JM,Jamaica,AMRO,5,534,0,9
2020-05-24,JM,Jamaica,AMRO,10,544,0,9
2020-05-25,JM,Jamaica,AMRO,6,550,0,9
2020-05-26,JM,Jamaica,AMRO,2,552,0,9
2020-05-27,JM,Jamaica,AMRO,4,556,0,9
2020-05-28,JM,Jamaica,AMRO,8,564,0,9
2020-05-29,JM,Jamaica,AMRO,4,568,0,9
2020-05-30,JM,Jamaica,AMRO,0,568,0,9
2020-05-31,JM,Jamaica,AMRO,7,575,0,9
2020-06-01,JM,Jamaica,AMRO,6,581,0,9
2020-06-02,JM,Jamaica,AMRO,0,581,0,9
2020-06-03,JM,Jamaica,AMRO,7,588,0,9
2020-06-04,JM,Jamaica,AMRO,2,590,0,9
2020-06-05,JM,Jamaica,AMRO,0,590,0,9
2020-06-06,JM,Jamaica,AMRO,1,591,1,10
2020-06-07,JM,Jamaica,AMRO,4,595,0,10
2020-06-08,JM,Jamaica,AMRO,1,596,0,10
2020-03-29,JP,Japan,WPRO,194,1693,3,52
2020-03-30,JP,Japan,WPRO,173,1866,2,54
2020-03-31,JP,Japan,WPRO,87,1953,2,56
2020-04-01,JP,Japan,WPRO,225,2178,1,57
2020-04-02,JP,Japan,WPRO,378,2556,3,60
2020-04-03,JP,Japan,WPRO,61,2617,3,63
2020-04-04,JP,Japan,WPRO,318,2935,6,69
2020-04-05,JP,Japan,WPRO,336,3271,1,70
2020-04-06,JP,Japan,WPRO,383,3654,3,73
2020-04-07,JP,Japan,WPRO,252,3906,7,80
2020-04-08,JP,Japan,WPRO,351,4257,1,81
2020-04-09,JP,Japan,WPRO,511,4768,4,85
2020-04-10,JP,Japan,WPRO,579,5347,3,88
2020-04-11,JP,Japan,WPRO,658,6005,6,94
2020-04-12,JP,Japan,WPRO,743,6748,4,98
2020-04-13,JP,Japan,WPRO,507,7255,4,102
2020-04-14,JP,Japan,WPRO,390,7645,7,109
2020-04-15,JP,Japan,WPRO,455,8100,10,119
2020-04-16,JP,Japan,WPRO,482,8582,17,136
2020-04-17,JP,Japan,WPRO,585,9167,12,148
2020-04-18,JP,Japan,WPRO,628,9795,6,154
2020-04-19,JP,Japan,WPRO,566,10361,7,161
2020-04-20,JP,Japan,WPRO,390,10751,10,171
2020-04-21,JP,Japan,WPRO,368,11119,15,186
2020-04-22,JP,Japan,WPRO,377,11496,91,277
2020-04-23,JP,Japan,WPRO,423,11919,10,287
2020-04-24,JP,Japan,WPRO,469,12388,30,317
2020-04-25,JP,Japan,WPRO,441,12829,17,334
2020-04-26,JP,Japan,WPRO,353,13182,14,348
2020-04-27,JP,Japan,WPRO,203,13385,3,351
2020-04-28,JP,Japan,WPRO,191,13576,25,376
2020-04-29,JP,Japan,WPRO,276,13852,13,389
2020-04-30,JP,Japan,WPRO,236,14088,26,415
2020-05-01,JP,Japan,WPRO,193,14281,17,432
2020-05-02,JP,Japan,WPRO,264,14545,26,458
2020-05-03,JP,Japan,WPRO,294,14839,34,492
2020-05-04,JP,Japan,WPRO,218,15057,18,510
2020-05-05,JP,Japan,WPRO,174,15231,11,521
2020-05-06,JP,Japan,WPRO,123,15354,22,543
2020-05-07,JP,Japan,WPRO,109,15463,8,551
2020-05-08,JP,Japan,WPRO,84,15547,6,557
2020-05-09,JP,Japan,WPRO,102,15649,43,600
2020-05-10,JP,Japan,WPRO,98,15747,13,613
2020-05-11,JP,Japan,WPRO,51,15798,8,621
2020-05-12,JP,Japan,WPRO,76,15874,22,643
2020-05-13,JP,Japan,WPRO,150,16024,25,668
2020-05-14,JP,Japan,WPRO,55,16079,19,687
2020-05-15,JP,Japan,WPRO,114,16193,23,710
2020-05-16,JP,Japan,WPRO,44,16237,15,725
2020-05-17,JP,Japan,WPRO,48,16285,19,744
2020-05-18,JP,Japan,WPRO,20,16305,5,749
2020-05-19,JP,Japan,WPRO,60,16365,0,749
2020-05-20,JP,Japan,WPRO,20,16385,22,771
2020-05-21,JP,Japan,WPRO,39,16424,6,777
2020-05-22,JP,Japan,WPRO,89,16513,19,796
2020-05-23,JP,Japan,WPRO,23,16536,12,808
2020-05-24,JP,Japan,WPRO,14,16550,12,820
2020-05-25,JP,Japan,WPRO,31,16581,10,830
2020-05-26,JP,Japan,WPRO,42,16623,16,846
2020-05-27,JP,Japan,WPRO,28,16651,12,858
2020-05-28,JP,Japan,WPRO,32,16683,9,867
2020-05-29,JP,Japan,WPRO,36,16719,7,874
2020-05-30,JP,Japan,WPRO,85,16804,12,886
2020-05-31,JP,Japan,WPRO,47,16851,5,891
2020-06-01,JP,Japan,WPRO,33,16884,1,892
2020-06-02,JP,Japan,WPRO,46,16930,2,894
2020-06-03,JP,Japan,WPRO,56,16986,6,900
2020-06-04,JP,Japan,WPRO,32,17018,3,903
2020-06-05,JP,Japan,WPRO,46,17064,4,907
2020-06-06,JP,Japan,WPRO,39,17103,7,914
2020-06-07,JP,Japan,WPRO,38,17141,2,916
2020-06-08,JP,Japan,WPRO,33,17174,0,916
2020-03-29,JE,Jersey,EURO,2,45,1,2
2020-03-30,JE,Jersey,EURO,4,49,0,2
2020-03-31,JE,Jersey,EURO,9,58,0,2
2020-04-01,JE,Jersey,EURO,18,76,0,2
2020-04-02,JE,Jersey,EURO,10,86,0,2
2020-04-03,JE,Jersey,EURO,24,110,0,2
2020-04-04,JE,Jersey,EURO,5,115,1,3
2020-04-05,JE,Jersey,EURO,32,147,0,3
2020-04-06,JE,Jersey,EURO,8,155,0,3
2020-04-07,JE,Jersey,EURO,15,170,0,3
2020-04-08,JE,Jersey,EURO,0,170,0,3
2020-04-09,JE,Jersey,EURO,0,170,0,3
2020-04-10,JE,Jersey,EURO,13,183,1,4
2020-04-11,JE,Jersey,EURO,15,198,0,4
2020-04-12,JE,Jersey,EURO,0,198,0,4
2020-04-13,JE,Jersey,EURO,15,213,0,4
2020-04-14,JE,Jersey,EURO,4,217,0,4
2020-04-15,JE,Jersey,EURO,0,217,2,6
2020-04-16,JE,Jersey,EURO,2,219,1,7
2020-04-17,JE,Jersey,EURO,4,223,3,10
2020-04-18,JE,Jersey,EURO,11,234,1,11
2020-04-19,JE,Jersey,EURO,11,245,1,12
2020-04-20,JE,Jersey,EURO,4,249,0,12
2020-04-21,JE,Jersey,EURO,1,250,2,14
2020-04-22,JE,Jersey,EURO,5,255,0,14
2020-04-23,JE,Jersey,EURO,0,255,4,18
2020-04-24,JE,Jersey,EURO,5,260,1,19
2020-04-25,JE,Jersey,EURO,2,262,0,19
2020-04-26,JE,Jersey,EURO,2,264,0,19
2020-04-27,JE,Jersey,EURO,1,265,0,19
2020-04-28,JE,Jersey,EURO,2,267,0,19
2020-04-29,JE,Jersey,EURO,1,268,1,20
2020-04-30,JE,Jersey,EURO,6,274,0,20
2020-05-01,JE,Jersey,EURO,0,274,2,22
2020-05-02,JE,Jersey,EURO,0,274,1,23
2020-05-03,JE,Jersey,EURO,1,275,1,24
2020-05-04,JE,Jersey,EURO,1,276,0,24
2020-05-05,JE,Jersey,EURO,1,277,0,24
2020-05-06,JE,Jersey,EURO,0,277,0,24
2020-05-07,JE,Jersey,EURO,0,277,1,25
2020-05-08,JE,Jersey,EURO,0,277,0,25
2020-05-09,JE,Jersey,EURO,0,277,0,25
2020-05-10,JE,Jersey,EURO,0,277,0,25
2020-05-11,JE,Jersey,EURO,3,280,1,26
2020-05-12,JE,Jersey,EURO,0,280,0,26
2020-05-13,JE,Jersey,EURO,1,281,1,27
2020-05-14,JE,Jersey,EURO,0,281,0,27
2020-05-15,JE,Jersey,EURO,0,281,0,27
2020-05-16,JE,Jersey,EURO,0,281,0,27
2020-05-17,JE,Jersey,EURO,0,281,0,27
2020-05-18,JE,Jersey,EURO,5,286,0,27
2020-05-19,JE,Jersey,EURO,1,287,0,27
2020-05-20,JE,Jersey,EURO,0,287,1,28
2020-05-21,JE,Jersey,EURO,3,290,1,29
2020-05-22,JE,Jersey,EURO,0,290,0,29
2020-05-23,JE,Jersey,EURO,0,290,0,29
2020-05-24,JE,Jersey,EURO,0,290,0,29
2020-05-25,JE,Jersey,EURO,0,290,0,29
2020-05-26,JE,Jersey,EURO,1,291,0,29
2020-05-27,JE,Jersey,EURO,0,291,0,29
2020-05-28,JE,Jersey,EURO,1,292,0,29
2020-05-29,JE,Jersey,EURO,0,292,0,29
2020-05-30,JE,Jersey,EURO,0,292,0,29
2020-05-31,JE,Jersey,EURO,0,292,0,29
2020-06-01,JE,Jersey,EURO,0,292,0,29
2020-06-02,JE,Jersey,EURO,0,292,0,29
2020-06-03,JE,Jersey,EURO,0,292,1,30
2020-06-04,JE,Jersey,EURO,1,293,0,30
2020-06-05,JE,Jersey,EURO,0,293,0,30
2020-06-06,JE,Jersey,EURO,0,293,0,30
2020-06-07,JE,Jersey,EURO,2,295,0,30
2020-06-08,JE,Jersey,EURO,0,295,0,30
2020-03-29,JO,Jordan,EMRO,11,246,1,1
2020-03-30,JO,Jordan,EMRO,13,259,2,3
2020-03-31,JO,Jordan,EMRO,9,268,2,5
2020-04-01,JO,Jordan,EMRO,6,274,0,5
2020-04-02,JO,Jordan,EMRO,4,278,0,5
2020-04-03,JO,Jordan,EMRO,21,299,0,5
2020-04-04,JO,Jordan,EMRO,11,310,0,5
2020-04-05,JO,Jordan,EMRO,13,323,0,5
2020-04-06,JO,Jordan,EMRO,22,345,0,5
2020-04-07,JO,Jordan,EMRO,4,349,1,6
2020-04-08,JO,Jordan,EMRO,4,353,0,6
2020-04-09,JO,Jordan,EMRO,5,358,0,6
2020-04-10,JO,Jordan,EMRO,14,372,1,7
2020-04-11,JO,Jordan,EMRO,0,372,0,7
2020-04-12,JO,Jordan,EMRO,9,381,0,7
2020-04-13,JO,Jordan,EMRO,8,389,0,7
2020-04-14,JO,Jordan,EMRO,2,391,0,7
2020-04-15,JO,Jordan,EMRO,6,397,0,7
2020-04-16,JO,Jordan,EMRO,4,401,0,7
2020-04-17,JO,Jordan,EMRO,1,402,0,7
2020-04-18,JO,Jordan,EMRO,5,407,0,7
2020-04-19,JO,Jordan,EMRO,6,413,0,7
2020-04-20,JO,Jordan,EMRO,0,413,0,7
2020-04-21,JO,Jordan,EMRO,5,418,0,7
2020-04-22,JO,Jordan,EMRO,2,420,0,7
2020-04-23,JO,Jordan,EMRO,7,427,0,7
2020-04-24,JO,Jordan,EMRO,1,428,0,7
2020-04-25,JO,Jordan,EMRO,3,431,0,7
2020-04-26,JO,Jordan,EMRO,2,433,0,7
2020-04-27,JO,Jordan,EMRO,2,435,0,7
2020-04-28,JO,Jordan,EMRO,2,437,0,7
2020-04-29,JO,Jordan,EMRO,0,437,1,8
2020-04-30,JO,Jordan,EMRO,0,437,0,8
2020-05-01,JO,Jordan,EMRO,0,437,0,8
2020-05-02,JO,Jordan,EMRO,2,439,0,8
2020-05-03,JO,Jordan,EMRO,1,440,1,9
2020-05-04,JO,Jordan,EMRO,0,440,0,9
2020-05-05,JO,Jordan,EMRO,1,441,0,9
2020-05-06,JO,Jordan,EMRO,3,444,0,9
2020-05-07,JO,Jordan,EMRO,2,446,0,9
2020-05-08,JO,Jordan,EMRO,21,467,0,9
2020-05-09,JO,Jordan,EMRO,7,474,0,9
2020-05-10,JO,Jordan,EMRO,14,488,0,9
2020-05-11,JO,Jordan,EMRO,6,494,0,9
2020-05-12,JO,Jordan,EMRO,22,516,0,9
2020-05-13,JO,Jordan,EMRO,11,527,0,9
2020-05-14,JO,Jordan,EMRO,2,529,0,9
2020-05-15,JO,Jordan,EMRO,2,531,0,9
2020-05-16,JO,Jordan,EMRO,8,539,0,9
2020-05-17,JO,Jordan,EMRO,10,549,0,9
2020-05-18,JO,Jordan,EMRO,1,550,0,9
2020-05-19,JO,Jordan,EMRO,15,565,0,9
2020-05-20,JO,Jordan,EMRO,19,584,0,9
2020-05-21,JO,Jordan,EMRO,22,606,0,9
2020-05-22,JO,Jordan,EMRO,10,616,0,9
2020-05-23,JO,Jordan,EMRO,16,632,0,9
2020-05-24,JO,Jordan,EMRO,2,634,0,9
2020-05-25,JO,Jordan,EMRO,4,638,0,9
2020-05-26,JO,Jordan,EMRO,3,641,0,9
2020-05-27,JO,Jordan,EMRO,7,648,0,9
2020-05-28,JO,Jordan,EMRO,2,650,0,9
2020-05-29,JO,Jordan,EMRO,7,657,0,9
2020-05-30,JO,Jordan,EMRO,1,658,0,9
2020-05-31,JO,Jordan,EMRO,4,662,0,9
2020-06-01,JO,Jordan,EMRO,3,665,0,9
2020-06-02,JO,Jordan,EMRO,7,672,0,9
2020-06-03,JO,Jordan,EMRO,5,677,0,9
2020-06-04,JO,Jordan,EMRO,0,677,0,9
2020-06-05,JO,Jordan,EMRO,2,679,0,9
2020-06-06,JO,Jordan,EMRO,8,687,0,9
2020-06-07,JO,Jordan,EMRO,6,693,0,9
2020-06-08,JO,Jordan,EMRO,8,701,0,9
2020-03-29,KZ,Kazakhstan,EURO,56,284,0,1
2020-03-30,KZ,Kazakhstan,EURO,0,284,0,1
2020-03-31,KZ,Kazakhstan,EURO,28,312,0,1
2020-04-01,KZ,Kazakhstan,EURO,36,348,1,2
2020-04-02,KZ,Kazakhstan,EURO,38,386,1,3
2020-04-03,KZ,Kazakhstan,EURO,49,435,0,3
2020-04-04,KZ,Kazakhstan,EURO,25,460,0,3
2020-04-05,KZ,Kazakhstan,EURO,71,531,2,5
2020-04-06,KZ,Kazakhstan,EURO,73,604,0,5
2020-04-07,KZ,Kazakhstan,EURO,66,670,1,6
2020-04-08,KZ,Kazakhstan,EURO,39,709,0,6
2020-04-09,KZ,Kazakhstan,EURO,18,727,1,7
2020-04-10,KZ,Kazakhstan,EURO,75,802,2,9
2020-04-11,KZ,Kazakhstan,EURO,57,859,1,10
2020-04-12,KZ,Kazakhstan,EURO,38,897,0,10
2020-04-13,KZ,Kazakhstan,EURO,82,979,2,12
2020-04-14,KZ,Kazakhstan,EURO,112,1091,0,12
2020-04-15,KZ,Kazakhstan,EURO,184,1275,0,12
2020-04-16,KZ,Kazakhstan,EURO,20,1295,4,16
2020-04-17,KZ,Kazakhstan,EURO,185,1480,0,16
2020-04-18,KZ,Kazakhstan,EURO,66,1546,1,17
2020-04-19,KZ,Kazakhstan,EURO,81,1627,2,19
2020-04-20,KZ,Kazakhstan,EURO,141,1768,0,19
2020-04-21,KZ,Kazakhstan,EURO,84,1852,0,19
2020-04-22,KZ,Kazakhstan,EURO,143,1995,0,19
2020-04-23,KZ,Kazakhstan,EURO,0,1995,0,19
2020-04-24,KZ,Kazakhstan,EURO,30,2025,0,19
2020-04-25,KZ,Kazakhstan,EURO,391,2416,6,25
2020-04-26,KZ,Kazakhstan,EURO,185,2601,0,25
2020-04-27,KZ,Kazakhstan,EURO,190,2791,0,25
2020-04-28,KZ,Kazakhstan,EURO,191,2982,0,25
2020-04-29,KZ,Kazakhstan,EURO,96,3078,0,25
2020-04-30,KZ,Kazakhstan,EURO,255,3333,0,25
2020-05-01,KZ,Kazakhstan,EURO,218,3551,0,25
2020-05-02,KZ,Kazakhstan,EURO,234,3785,0,25
2020-05-03,KZ,Kazakhstan,EURO,92,3877,1,26
2020-05-04,KZ,Kazakhstan,EURO,111,3988,1,27
2020-05-05,KZ,Kazakhstan,EURO,172,4160,2,29
2020-05-06,KZ,Kazakhstan,EURO,138,4298,0,29
2020-05-07,KZ,Kazakhstan,EURO,211,4509,1,30
2020-05-08,KZ,Kazakhstan,EURO,69,4578,0,30
2020-05-09,KZ,Kazakhstan,EURO,344,4922,1,31
2020-05-10,KZ,Kazakhstan,EURO,134,5056,0,31
2020-05-11,KZ,Kazakhstan,EURO,82,5138,0,31
2020-05-12,KZ,Kazakhstan,EURO,69,5207,1,32
2020-05-13,KZ,Kazakhstan,EURO,210,5417,0,32
2020-05-14,KZ,Kazakhstan,EURO,154,5571,1,33
2020-05-15,KZ,Kazakhstan,EURO,118,5689,1,34
2020-05-16,KZ,Kazakhstan,EURO,161,5850,0,34
2020-05-17,KZ,Kazakhstan,EURO,307,6157,0,34
2020-05-18,KZ,Kazakhstan,EURO,283,6440,0,34
2020-05-19,KZ,Kazakhstan,EURO,311,6751,1,35
2020-05-20,KZ,Kazakhstan,EURO,218,6969,0,35
2020-05-21,KZ,Kazakhstan,EURO,265,7234,0,35
2020-05-22,KZ,Kazakhstan,EURO,363,7597,0,35
2020-05-23,KZ,Kazakhstan,EURO,322,7919,0,35
2020-05-24,KZ,Kazakhstan,EURO,403,8322,0,35
2020-05-25,KZ,Kazakhstan,EURO,209,8531,0,35
2020-05-26,KZ,Kazakhstan,EURO,438,8969,0,35
2020-05-27,KZ,Kazakhstan,EURO,335,9304,2,37
2020-05-28,KZ,Kazakhstan,EURO,272,9576,0,37
2020-05-29,KZ,Kazakhstan,EURO,356,9932,0,37
2020-05-30,KZ,Kazakhstan,EURO,450,10382,0,37
2020-05-31,KZ,Kazakhstan,EURO,476,10858,1,38
2020-06-01,KZ,Kazakhstan,EURO,450,11308,3,41
2020-06-02,KZ,Kazakhstan,EURO,263,11571,0,41
2020-06-03,KZ,Kazakhstan,EURO,225,11796,3,44
2020-06-04,KZ,Kazakhstan,EURO,271,12067,4,48
2020-06-05,KZ,Kazakhstan,EURO,245,12312,0,48
2020-06-06,KZ,Kazakhstan,EURO,199,12511,4,52
2020-06-07,KZ,Kazakhstan,EURO,183,12694,2,54
2020-06-08,KZ,Kazakhstan,EURO,165,12859,2,56
2020-03-29,KE,Kenya,AFRO,7,38,0,4
2020-03-30,KE,Kenya,AFRO,4,42,0,4
2020-03-31,KE,Kenya,AFRO,8,50,0,4
2020-04-01,KE,Kenya,AFRO,9,59,0,4
2020-04-02,KE,Kenya,AFRO,22,81,2,6
2020-04-03,KE,Kenya,AFRO,41,122,0,6
2020-04-04,KE,Kenya,AFRO,0,122,1,7
2020-04-05,KE,Kenya,AFRO,4,126,0,7
2020-04-06,KE,Kenya,AFRO,16,142,0,7
2020-04-07,KE,Kenya,AFRO,0,142,0,7
2020-04-08,KE,Kenya,AFRO,30,172,0,7
2020-04-09,KE,Kenya,AFRO,7,179,0,7
2020-04-10,KE,Kenya,AFRO,5,184,0,7
2020-04-11,KE,Kenya,AFRO,5,189,0,7
2020-04-12,KE,Kenya,AFRO,2,191,0,7
2020-04-13,KE,Kenya,AFRO,6,197,1,8
2020-04-14,KE,Kenya,AFRO,11,208,1,9
2020-04-15,KE,Kenya,AFRO,8,216,0,9
2020-04-16,KE,Kenya,AFRO,9,225,0,9
2020-04-17,KE,Kenya,AFRO,9,234,1,10
2020-04-18,KE,Kenya,AFRO,12,246,0,10
2020-04-19,KE,Kenya,AFRO,16,262,1,11
2020-04-20,KE,Kenya,AFRO,8,270,2,13
2020-04-21,KE,Kenya,AFRO,11,281,0,13
2020-04-22,KE,Kenya,AFRO,15,296,0,13
2020-04-23,KE,Kenya,AFRO,7,303,0,13
2020-04-24,KE,Kenya,AFRO,17,320,0,13
2020-04-25,KE,Kenya,AFRO,16,336,0,13
2020-04-26,KE,Kenya,AFRO,7,343,0,13
2020-04-27,KE,Kenya,AFRO,12,355,0,13
2020-04-28,KE,Kenya,AFRO,8,363,0,13
2020-04-29,KE,Kenya,AFRO,11,374,0,13
2020-04-30,KE,Kenya,AFRO,10,384,1,14
2020-05-01,KE,Kenya,AFRO,12,396,2,16
2020-05-02,KE,Kenya,AFRO,15,411,4,20
2020-05-03,KE,Kenya,AFRO,24,435,1,21
2020-05-04,KE,Kenya,AFRO,30,465,2,23
2020-05-05,KE,Kenya,AFRO,25,490,0,23
2020-05-06,KE,Kenya,AFRO,45,535,0,23
2020-05-07,KE,Kenya,AFRO,47,582,3,26
2020-05-08,KE,Kenya,AFRO,25,607,3,29
2020-05-09,KE,Kenya,AFRO,14,621,0,29
2020-05-10,KE,Kenya,AFRO,28,649,1,30
2020-05-11,KE,Kenya,AFRO,23,672,2,32
2020-05-12,KE,Kenya,AFRO,28,700,1,33
2020-05-13,KE,Kenya,AFRO,15,715,3,36
2020-05-14,KE,Kenya,AFRO,22,737,4,40
2020-05-15,KE,Kenya,AFRO,21,758,2,42
2020-05-16,KE,Kenya,AFRO,23,781,3,45
2020-05-17,KE,Kenya,AFRO,49,830,5,50
2020-05-18,KE,Kenya,AFRO,57,887,0,50
2020-05-19,KE,Kenya,AFRO,25,912,0,50
2020-05-20,KE,Kenya,AFRO,51,963,0,50
2020-05-21,KE,Kenya,AFRO,66,1029,0,50
2020-05-22,KE,Kenya,AFRO,80,1109,0,50
2020-05-23,KE,Kenya,AFRO,52,1161,0,50
2020-05-24,KE,Kenya,AFRO,31,1192,0,50
2020-05-25,KE,Kenya,AFRO,22,1214,1,51
2020-05-26,KE,Kenya,AFRO,72,1286,1,52
2020-05-27,KE,Kenya,AFRO,62,1348,0,52
2020-05-28,KE,Kenya,AFRO,123,1471,3,55
2020-05-29,KE,Kenya,AFRO,147,1618,3,58
2020-05-30,KE,Kenya,AFRO,127,1745,4,62
2020-05-31,KE,Kenya,AFRO,143,1888,1,63
2020-06-01,KE,Kenya,AFRO,74,1962,1,64
2020-06-02,KE,Kenya,AFRO,59,2021,5,69
2020-06-03,KE,Kenya,AFRO,72,2093,2,71
2020-06-04,KE,Kenya,AFRO,123,2216,3,74
2020-06-05,KE,Kenya,AFRO,124,2340,4,78
2020-06-06,KE,Kenya,AFRO,134,2474,1,79
2020-06-07,KE,Kenya,AFRO,126,2600,4,83
2020-06-08,KE,Kenya,AFRO,167,2767,1,84
2020-03-29,KI,Kiribati,WPRO,0,0,0,0
2020-03-30,KI,Kiribati,WPRO,0,0,0,0
2020-03-31,KI,Kiribati,WPRO,0,0,0,0
2020-04-01,KI,Kiribati,WPRO,0,0,0,0
2020-04-02,KI,Kiribati,WPRO,0,0,0,0
2020-04-03,KI,Kiribati,WPRO,0,0,0,0
2020-04-04,KI,Kiribati,WPRO,0,0,0,0
2020-04-05,KI,Kiribati,WPRO,0,0,0,0
2020-04-06,KI,Kiribati,WPRO,0,0,0,0
2020-04-07,KI,Kiribati,WPRO,0,0,0,0
2020-04-08,KI,Kiribati,WPRO,0,0,0,0
2020-04-09,KI,Kiribati,WPRO,0,0,0,0
2020-04-10,KI,Kiribati,WPRO,0,0,0,0
2020-04-11,KI,Kiribati,WPRO,0,0,0,0
2020-04-12,KI,Kiribati,WPRO,0,0,0,0
2020-04-13,KI,Kiribati,WPRO,0,0,0,0
2020-04-14,KI,Kiribati,WPRO,0,0,0,0
2020-04-15,KI,Kiribati,WPRO,0,0,0,0
2020-04-16,KI,Kiribati,WPRO,0,0,0,0
2020-04-17,KI,Kiribati,WPRO,0,0,0,0
2020-04-18,KI,Kiribati,WPRO,0,0,0,0
2020-04-19,KI,Kiribati,WPRO,0,0,0,0
2020-04-20,KI,Kiribati,WPRO,0,0,0,0
2020-04-21,KI,Kiribati,WPRO,0,0,0,0
2020-04-22,KI,Kiribati,WPRO,0,0,0,0
2020-04-23,KI,Kiribati,WPRO,0,0,0,0
2020-04-24,KI,Kiribati,WPRO,0,0,0,0
2020-04-25,KI,Kiribati,WPRO,0,0,0,0
2020-04-26,KI,Kiribati,WPRO,0,0,0,0
2020-04-27,KI,Kiribati,WPRO,0,0,0,0
2020-04-28,KI,Kiribati,WPRO,0,0,0,0
2020-04-29,KI,Kiribati,WPRO,0,0,0,0
2020-04-30,KI,Kiribati,WPRO,0,0,0,0
2020-05-01,KI,Kiribati,WPRO,0,0,0,0
2020-05-02,KI,Kiribati,WPRO,0,0,0,0
2020-05-03,KI,Kiribati,WPRO,0,0,0,0
2020-05-04,KI,Kiribati,WPRO,0,0,0,0
2020-05-05,KI,Kiribati,WPRO,0,0,0,0
2020-05-06,KI,Kiribati,WPRO,0,0,0,0
2020-05-07,KI,Kiribati,WPRO,0,0,0,0
2020-05-08,KI,Kiribati,WPRO,0,0,0,0
2020-05-09,KI,Kiribati,WPRO,0,0,0,0
2020-05-10,KI,Kiribati,WPRO,0,0,0,0
2020-05-11,KI,Kiribati,WPRO,0,0,0,0
2020-05-12,KI,Kiribati,WPRO,0,0,0,0
2020-05-13,KI,Kiribati,WPRO,0,0,0,0
2020-05-14,KI,Kiribati,WPRO,0,0,0,0
2020-05-15,KI,Kiribati,WPRO,0,0,0,0
2020-05-16,KI,Kiribati,WPRO,0,0,0,0
2020-05-17,KI,Kiribati,WPRO,0,0,0,0
2020-05-18,KI,Kiribati,WPRO,0,0,0,0
2020-05-19,KI,Kiribati,WPRO,0,0,0,0
2020-05-20,KI,Kiribati,WPRO,0,0,0,0
2020-05-21,KI,Kiribati,WPRO,0,0,0,0
2020-05-22,KI,Kiribati,WPRO,0,0,0,0
2020-05-23,KI,Kiribati,WPRO,0,0,0,0
2020-05-24,KI,Kiribati,WPRO,0,0,0,0
2020-05-25,KI,Kiribati,WPRO,0,0,0,0
2020-05-26,KI,Kiribati,WPRO,0,0,0,0
2020-05-27,KI,Kiribati,WPRO,0,0,0,0
2020-05-28,KI,Kiribati,WPRO,0,0,0,0
2020-05-29,KI,Kiribati,WPRO,0,0,0,0
2020-05-30,KI,Kiribati,WPRO,0,0,0,0
2020-05-31,KI,Kiribati,WPRO,0,0,0,0
2020-06-01,KI,Kiribati,WPRO,0,0,0,0
2020-06-02,KI,Kiribati,WPRO,0,0,0,0
2020-06-03,KI,Kiribati,WPRO,0,0,0,0
2020-06-04,KI,Kiribati,WPRO,0,0,0,0
2020-06-05,KI,Kiribati,WPRO,0,0,0,0
2020-06-06,KI,Kiribati,WPRO,0,0,0,0
2020-06-07,KI,Kiribati,WPRO,0,0,0,0
2020-06-08,KI,Kiribati,WPRO,0,0,0,0
2020-03-29,XK,Kosovo[1],EURO,0,91,0,1
2020-03-30,XK,Kosovo[1],EURO,15,106,0,1
2020-03-31,XK,Kosovo[1],EURO,6,112,0,1
2020-04-01,XK,Kosovo[1],EURO,13,125,0,1
2020-04-02,XK,Kosovo[1],EURO,0,125,0,1
2020-04-03,XK,Kosovo[1],EURO,1,126,0,1
2020-04-04,XK,Kosovo[1],EURO,6,132,0,1
2020-04-05,XK,Kosovo[1],EURO,8,140,0,1
2020-04-06,XK,Kosovo[1],EURO,5,145,0,1
2020-04-07,XK,Kosovo[1],EURO,20,165,2,3
2020-04-08,XK,Kosovo[1],EURO,19,184,3,6
2020-04-09,XK,Kosovo[1],EURO,40,224,1,7
2020-04-10,XK,Kosovo[1],EURO,3,227,0,7
2020-04-11,XK,Kosovo[1],EURO,23,250,0,7
2020-04-12,XK,Kosovo[1],EURO,33,283,0,7
2020-04-13,XK,Kosovo[1],EURO,79,362,1,8
2020-04-14,XK,Kosovo[1],EURO,15,377,1,9
2020-04-15,XK,Kosovo[1],EURO,10,387,1,10
2020-04-16,XK,Kosovo[1],EURO,10,397,2,12
2020-04-17,XK,Kosovo[1],EURO,52,449,1,13
2020-04-18,XK,Kosovo[1],EURO,31,480,0,13
2020-04-19,XK,Kosovo[1],EURO,30,510,0,13
2020-04-20,XK,Kosovo[1],EURO,25,535,0,13
2020-04-21,XK,Kosovo[1],EURO,37,572,1,14
2020-04-22,XK,Kosovo[1],EURO,32,604,0,14
2020-04-23,XK,Kosovo[1],EURO,26,630,1,15
2020-04-24,XK,Kosovo[1],EURO,39,669,0,15
2020-04-25,XK,Kosovo[1],EURO,34,703,1,16
2020-04-26,XK,Kosovo[1],EURO,28,731,0,16
2020-04-27,XK,Kosovo[1],EURO,32,763,1,17
2020-04-28,XK,Kosovo[1],EURO,17,780,0,17
2020-04-29,XK,Kosovo[1],EURO,10,790,0,17
2020-04-30,XK,Kosovo[1],EURO,9,799,0,17
2020-05-01,XK,Kosovo[1],EURO,0,799,0,17
2020-05-02,XK,Kosovo[1],EURO,14,813,0,17
2020-05-03,XK,Kosovo[1],EURO,10,823,0,17
2020-05-04,XK,Kosovo[1],EURO,28,851,0,17
2020-05-05,XK,Kosovo[1],EURO,4,855,0,17
2020-05-06,XK,Kosovo[1],EURO,1,856,0,17
2020-05-07,XK,Kosovo[1],EURO,4,860,1,18
2020-05-08,XK,Kosovo[1],EURO,1,861,1,19
2020-05-09,XK,Kosovo[1],EURO,1,862,0,19
2020-05-10,XK,Kosovo[1],EURO,8,870,0,19
2020-05-11,XK,Kosovo[1],EURO,0,870,0,19
2020-05-12,XK,Kosovo[1],EURO,14,884,1,20
2020-05-13,XK,Kosovo[1],EURO,35,919,0,20
2020-05-14,XK,Kosovo[1],EURO,0,919,0,20
2020-05-15,XK,Kosovo[1],EURO,25,944,0,20
2020-05-16,XK,Kosovo[1],EURO,0,944,0,20
2020-05-17,XK,Kosovo[1],EURO,0,944,0,20
2020-05-18,XK,Kosovo[1],EURO,11,955,0,20
2020-05-19,XK,Kosovo[1],EURO,0,955,0,20
2020-05-20,XK,Kosovo[1],EURO,34,989,0,20
2020-05-21,XK,Kosovo[1],EURO,0,989,0,20
2020-05-22,XK,Kosovo[1],EURO,14,1003,0,20
2020-05-23,XK,Kosovo[1],EURO,1,1004,0,20
2020-05-24,XK,Kosovo[1],EURO,21,1025,0,20
2020-05-25,XK,Kosovo[1],EURO,7,1032,1,21
2020-05-26,XK,Kosovo[1],EURO,6,1038,0,21
2020-05-27,XK,Kosovo[1],EURO,0,1038,0,21
2020-05-28,XK,Kosovo[1],EURO,9,1047,0,21
2020-05-29,XK,Kosovo[1],EURO,1,1048,0,21
2020-05-30,XK,Kosovo[1],EURO,0,1048,0,21
2020-05-31,XK,Kosovo[1],EURO,16,1064,0,21
2020-06-01,XK,Kosovo[1],EURO,0,1064,0,21
2020-06-02,XK,Kosovo[1],EURO,3,1067,0,21
2020-06-03,XK,Kosovo[1],EURO,13,1080,0,21
2020-06-04,XK,Kosovo[1],EURO,62,1142,0,21
2020-06-05,XK,Kosovo[1],EURO,0,1142,0,21
2020-06-06,XK,Kosovo[1],EURO,0,1142,0,21
2020-06-07,XK,Kosovo[1],EURO,9,1151,0,21
2020-06-08,XK,Kosovo[1],EURO,40,1191,0,21
2020-03-29,KW,Kuwait,EMRO,10,235,0,0
2020-03-30,KW,Kuwait,EMRO,20,255,0,0
2020-03-31,KW,Kuwait,EMRO,11,266,0,0
2020-04-01,KW,Kuwait,EMRO,23,289,0,0
2020-04-02,KW,Kuwait,EMRO,28,317,0,0
2020-04-03,KW,Kuwait,EMRO,25,342,0,0
2020-04-04,KW,Kuwait,EMRO,75,417,0,0
2020-04-05,KW,Kuwait,EMRO,62,479,0,0
2020-04-06,KW,Kuwait,EMRO,77,556,1,1
2020-04-07,KW,Kuwait,EMRO,109,665,0,1
2020-04-08,KW,Kuwait,EMRO,78,743,0,1
2020-04-09,KW,Kuwait,EMRO,112,855,0,1
2020-04-10,KW,Kuwait,EMRO,55,910,0,1
2020-04-11,KW,Kuwait,EMRO,83,993,0,1
2020-04-12,KW,Kuwait,EMRO,161,1154,0,1
2020-04-13,KW,Kuwait,EMRO,80,1234,0,1
2020-04-14,KW,Kuwait,EMRO,66,1300,1,2
2020-04-15,KW,Kuwait,EMRO,55,1355,1,3
2020-04-16,KW,Kuwait,EMRO,50,1405,0,3
2020-04-17,KW,Kuwait,EMRO,119,1524,0,3
2020-04-18,KW,Kuwait,EMRO,134,1658,2,5
2020-04-19,KW,Kuwait,EMRO,93,1751,1,6
2020-04-20,KW,Kuwait,EMRO,164,1915,1,7
2020-04-21,KW,Kuwait,EMRO,80,1995,2,9
2020-04-22,KW,Kuwait,EMRO,85,2080,2,11
2020-04-23,KW,Kuwait,EMRO,168,2248,2,13
2020-04-24,KW,Kuwait,EMRO,151,2399,1,14
2020-04-25,KW,Kuwait,EMRO,215,2614,1,15
2020-04-26,KW,Kuwait,EMRO,278,2892,4,19
2020-04-27,KW,Kuwait,EMRO,183,3075,1,20
2020-04-28,KW,Kuwait,EMRO,213,3288,2,22
2020-04-29,KW,Kuwait,EMRO,152,3440,1,23
2020-04-30,KW,Kuwait,EMRO,300,3740,1,24
2020-05-01,KW,Kuwait,EMRO,284,4024,2,26
2020-05-02,KW,Kuwait,EMRO,353,4377,4,30
2020-05-03,KW,Kuwait,EMRO,242,4619,3,33
2020-05-04,KW,Kuwait,EMRO,364,4983,5,38
2020-05-05,KW,Kuwait,EMRO,295,5278,2,40
2020-05-06,KW,Kuwait,EMRO,526,5804,0,40
2020-05-07,KW,Kuwait,EMRO,485,6289,2,42
2020-05-08,KW,Kuwait,EMRO,278,6567,2,44
2020-05-09,KW,Kuwait,EMRO,641,7208,3,47
2020-05-10,KW,Kuwait,EMRO,415,7623,2,49
2020-05-11,KW,Kuwait,EMRO,1065,8688,9,58
2020-05-12,KW,Kuwait,EMRO,598,9286,7,65
2020-05-13,KW,Kuwait,EMRO,991,10277,10,75
2020-05-14,KW,Kuwait,EMRO,751,11028,7,82
2020-05-15,KW,Kuwait,EMRO,947,11975,6,88
2020-05-16,KW,Kuwait,EMRO,885,12860,8,96
2020-05-17,KW,Kuwait,EMRO,942,13802,11,107
2020-05-18,KW,Kuwait,EMRO,1048,14850,5,112
2020-05-19,KW,Kuwait,EMRO,841,15691,6,118
2020-05-20,KW,Kuwait,EMRO,1073,16764,3,121
2020-05-21,KW,Kuwait,EMRO,804,17568,3,124
2020-05-22,KW,Kuwait,EMRO,1041,18609,5,129
2020-05-23,KW,Kuwait,EMRO,955,19564,9,138
2020-05-24,KW,Kuwait,EMRO,900,20464,10,148
2020-05-25,KW,Kuwait,EMRO,838,21302,8,156
2020-05-26,KW,Kuwait,EMRO,665,21967,9,165
2020-05-27,KW,Kuwait,EMRO,608,22575,7,172
2020-05-28,KW,Kuwait,EMRO,692,23267,3,175
2020-05-29,KW,Kuwait,EMRO,845,24112,10,185
2020-05-30,KW,Kuwait,EMRO,1072,25184,9,194
2020-05-31,KW,Kuwait,EMRO,1008,26192,11,205
2020-06-01,KW,Kuwait,EMRO,851,27043,7,212
2020-06-02,KW,Kuwait,EMRO,719,27762,8,220
2020-06-03,KW,Kuwait,EMRO,887,28649,6,226
2020-06-04,KW,Kuwait,EMRO,710,29359,4,230
2020-06-05,KW,Kuwait,EMRO,562,29921,6,236
2020-06-06,KW,Kuwait,EMRO,723,30644,8,244
2020-06-07,KW,Kuwait,EMRO,487,31131,10,254
2020-06-08,KW,Kuwait,EMRO,717,31848,10,264
2020-03-29,KG,Kyrgyzstan,EURO,32,206,0,0
2020-03-30,KG,Kyrgyzstan,EURO,20,226,0,0
2020-03-31,KG,Kyrgyzstan,EURO,29,255,0,0
2020-04-01,KG,Kyrgyzstan,EURO,7,262,0,0
2020-04-02,KG,Kyrgyzstan,EURO,20,282,0,0
2020-04-03,KG,Kyrgyzstan,EURO,25,307,1,1
2020-04-04,KG,Kyrgyzstan,EURO,33,340,0,1
2020-04-05,KG,Kyrgyzstan,EURO,12,352,0,1
2020-04-06,KG,Kyrgyzstan,EURO,78,430,3,4
2020-04-07,KG,Kyrgyzstan,EURO,33,463,0,4
2020-04-08,KG,Kyrgyzstan,EURO,51,514,0,4
2020-04-09,KG,Kyrgyzstan,EURO,18,532,0,4
2020-04-10,KG,Kyrgyzstan,EURO,21,553,1,5
2020-04-11,KG,Kyrgyzstan,EURO,54,607,0,5
2020-04-12,KG,Kyrgyzstan,EURO,49,656,0,5
2020-04-13,KG,Kyrgyzstan,EURO,44,700,0,5
2020-04-14,KG,Kyrgyzstan,EURO,14,714,0,5
2020-04-15,KG,Kyrgyzstan,EURO,24,738,0,5
2020-04-16,KG,Kyrgyzstan,EURO,17,755,0,5
2020-04-17,KG,Kyrgyzstan,EURO,29,784,0,5
2020-04-18,KG,Kyrgyzstan,EURO,23,807,0,5
2020-04-19,KG,Kyrgyzstan,EURO,52,859,0,5
2020-04-20,KG,Kyrgyzstan,EURO,26,885,2,7
2020-04-21,KG,Kyrgyzstan,EURO,23,908,0,7
2020-04-22,KG,Kyrgyzstan,EURO,32,940,0,7
2020-04-23,KG,Kyrgyzstan,EURO,39,979,1,8
2020-04-24,KG,Kyrgyzstan,EURO,27,1006,0,8
2020-04-25,KG,Kyrgyzstan,EURO,9,1015,0,8
2020-04-26,KG,Kyrgyzstan,EURO,18,1033,0,8
2020-04-27,KG,Kyrgyzstan,EURO,15,1048,0,8
2020-04-28,KG,Kyrgyzstan,EURO,15,1063,0,8
2020-04-29,KG,Kyrgyzstan,EURO,22,1085,0,8
2020-04-30,KG,Kyrgyzstan,EURO,25,1110,0,8
2020-05-01,KG,Kyrgyzstan,EURO,12,1122,0,8
2020-05-02,KG,Kyrgyzstan,EURO,18,1140,0,8
2020-05-03,KG,Kyrgyzstan,EURO,27,1167,2,10
2020-05-04,KG,Kyrgyzstan,EURO,38,1205,0,10
2020-05-05,KG,Kyrgyzstan,EURO,14,1219,0,10
2020-05-06,KG,Kyrgyzstan,EURO,33,1252,2,12
2020-05-07,KG,Kyrgyzstan,EURO,24,1276,0,12
2020-05-08,KG,Kyrgyzstan,EURO,12,1288,0,12
2020-05-09,KG,Kyrgyzstan,EURO,25,1313,0,12
2020-05-10,KG,Kyrgyzstan,EURO,73,1386,0,12
2020-05-11,KG,Kyrgyzstan,EURO,16,1402,0,12
2020-05-12,KG,Kyrgyzstan,EURO,27,1429,0,12
2020-05-13,KG,Kyrgyzstan,EURO,7,1436,0,12
2020-05-14,KG,Kyrgyzstan,EURO,40,1476,0,12
2020-05-15,KG,Kyrgyzstan,EURO,30,1506,2,14
2020-05-16,KG,Kyrgyzstan,EURO,6,1512,0,14
2020-05-17,KG,Kyrgyzstan,EURO,22,1534,0,14
2020-05-18,KG,Kyrgyzstan,EURO,79,1613,0,14
2020-05-19,KG,Kyrgyzstan,EURO,28,1641,0,14
2020-05-20,KG,Kyrgyzstan,EURO,28,1669,0,14
2020-05-21,KG,Kyrgyzstan,EURO,43,1712,0,14
2020-05-22,KG,Kyrgyzstan,EURO,38,1750,0,14
2020-05-23,KG,Kyrgyzstan,EURO,15,1765,0,14
2020-05-24,KG,Kyrgyzstan,EURO,38,1803,0,14
2020-05-25,KG,Kyrgyzstan,EURO,30,1833,2,16
2020-05-26,KG,Kyrgyzstan,EURO,36,1869,0,16
2020-05-27,KG,Kyrgyzstan,EURO,58,1927,0,16
2020-05-28,KG,Kyrgyzstan,EURO,78,2005,0,16
2020-05-29,KG,Kyrgyzstan,EURO,74,2079,0,16
2020-05-30,KG,Kyrgyzstan,EURO,62,2141,0,16
2020-05-31,KG,Kyrgyzstan,EURO,26,2167,0,16
2020-06-01,KG,Kyrgyzstan,EURO,70,2237,0,16
2020-06-02,KG,Kyrgyzstan,EURO,30,2267,1,17
2020-06-03,KG,Kyrgyzstan,EURO,28,2295,3,20
2020-06-04,KG,Kyrgyzstan,EURO,29,2324,0,20
2020-06-05,KG,Kyrgyzstan,EURO,39,2363,2,22
2020-06-06,KG,Kyrgyzstan,EURO,40,2403,0,22
2020-06-07,KG,Kyrgyzstan,EURO,35,2438,0,22
2020-06-08,KG,Kyrgyzstan,EURO,25,2463,1,23
2020-03-29,LA,Lao People's Democratic Republic,WPRO,0,6,0,0
2020-03-30,LA,Lao People's Democratic Republic,WPRO,2,8,0,0
2020-03-31,LA,Lao People's Democratic Republic,WPRO,1,9,0,0
2020-04-01,LA,Lao People's Democratic Republic,WPRO,0,9,0,0
2020-04-02,LA,Lao People's Democratic Republic,WPRO,1,10,0,0
2020-04-03,LA,Lao People's Democratic Republic,WPRO,0,10,0,0
2020-04-04,LA,Lao People's Democratic Republic,WPRO,0,10,0,0
2020-04-05,LA,Lao People's Democratic Republic,WPRO,0,10,0,0
2020-04-06,LA,Lao People's Democratic Republic,WPRO,1,11,0,0
2020-04-07,LA,Lao People's Democratic Republic,WPRO,1,12,0,0
2020-04-08,LA,Lao People's Democratic Republic,WPRO,0,12,0,0
2020-04-09,LA,Lao People's Democratic Republic,WPRO,3,15,0,0
2020-04-10,LA,Lao People's Democratic Republic,WPRO,0,15,0,0
2020-04-11,LA,Lao People's Democratic Republic,WPRO,1,16,0,0
2020-04-12,LA,Lao People's Democratic Republic,WPRO,0,16,0,0
2020-04-13,LA,Lao People's Democratic Republic,WPRO,3,19,0,0
2020-04-14,LA,Lao People's Democratic Republic,WPRO,0,19,0,0
2020-04-15,LA,Lao People's Democratic Republic,WPRO,0,19,0,0
2020-04-16,LA,Lao People's Democratic Republic,WPRO,0,19,0,0
2020-04-17,LA,Lao People's Democratic Republic,WPRO,0,19,0,0
2020-04-18,LA,Lao People's Democratic Republic,WPRO,0,19,0,0
2020-04-19,LA,Lao People's Democratic Republic,WPRO,0,19,0,0
2020-04-20,LA,Lao People's Democratic Republic,WPRO,0,19,0,0
2020-04-21,LA,Lao People's Democratic Republic,WPRO,0,19,0,0
2020-04-22,LA,Lao People's Democratic Republic,WPRO,0,19,0,0
2020-04-23,LA,Lao People's Democratic Republic,WPRO,0,19,0,0
2020-04-24,LA,Lao People's Democratic Republic,WPRO,0,19,0,0
2020-04-25,LA,Lao People's Democratic Republic,WPRO,0,19,0,0
2020-04-26,LA,Lao People's Democratic Republic,WPRO,0,19,0,0
2020-04-27,LA,Lao People's Democratic Republic,WPRO,0,19,0,0
2020-04-28,LA,Lao People's Democratic Republic,WPRO,0,19,0,0
2020-04-29,LA,Lao People's Democratic Republic,WPRO,0,19,0,0
2020-04-30,LA,Lao People's Democratic Republic,WPRO,0,19,0,0
2020-05-01,LA,Lao People's Democratic Republic,WPRO,0,19,0,0
2020-05-02,LA,Lao People's Democratic Republic,WPRO,0,19,0,0
2020-05-03,LA,Lao People's Democratic Republic,WPRO,0,19,0,0
2020-05-04,LA,Lao People's Democratic Republic,WPRO,0,19,0,0
2020-05-05,LA,Lao People's Democratic Republic,WPRO,0,19,0,0
2020-05-06,LA,Lao People's Democratic Republic,WPRO,0,19,0,0
2020-05-07,LA,Lao People's Democratic Republic,WPRO,0,19,0,0
2020-05-08,LA,Lao People's Democratic Republic,WPRO,0,19,0,0
2020-05-09,LA,Lao People's Democratic Republic,WPRO,0,19,0,0
2020-05-10,LA,Lao People's Democratic Republic,WPRO,0,19,0,0
2020-05-11,LA,Lao People's Democratic Republic,WPRO,0,19,0,0
2020-05-12,LA,Lao People's Democratic Republic,WPRO,0,19,0,0
2020-05-13,LA,Lao People's Democratic Republic,WPRO,0,19,0,0
2020-05-14,LA,Lao People's Democratic Republic,WPRO,0,19,0,0
2020-05-15,LA,Lao People's Democratic Republic,WPRO,0,19,0,0
2020-05-16,LA,Lao People's Democratic Republic,WPRO,0,19,0,0
2020-05-17,LA,Lao People's Democratic Republic,WPRO,0,19,0,0
2020-05-18,LA,Lao People's Democratic Republic,WPRO,0,19,0,0
2020-05-19,LA,Lao People's Democratic Republic,WPRO,0,19,0,0
2020-05-20,LA,Lao People's Democratic Republic,WPRO,0,19,0,0
2020-05-21,LA,Lao People's Democratic Republic,WPRO,0,19,0,0
2020-05-22,LA,Lao People's Democratic Republic,WPRO,0,19,0,0
2020-05-23,LA,Lao People's Democratic Republic,WPRO,0,19,0,0
2020-05-24,LA,Lao People's Democratic Republic,WPRO,0,19,0,0
2020-05-25,LA,Lao People's Democratic Republic,WPRO,0,19,0,0
2020-05-26,LA,Lao People's Democratic Republic,WPRO,0,19,0,0
2020-05-27,LA,Lao People's Democratic Republic,WPRO,0,19,0,0
2020-05-28,LA,Lao People's Democratic Republic,WPRO,0,19,0,0
2020-05-29,LA,Lao People's Democratic Republic,WPRO,0,19,0,0
2020-05-30,LA,Lao People's Democratic Republic,WPRO,0,19,0,0
2020-05-31,LA,Lao People's Democratic Republic,WPRO,0,19,0,0
2020-06-01,LA,Lao People's Democratic Republic,WPRO,0,19,0,0
2020-06-02,LA,Lao People's Democratic Republic,WPRO,0,19,0,0
2020-06-03,LA,Lao People's Democratic Republic,WPRO,0,19,0,0
2020-06-04,LA,Lao People's Democratic Republic,WPRO,0,19,0,0
2020-06-05,LA,Lao People's Democratic Republic,WPRO,0,19,0,0
2020-06-06,LA,Lao People's Democratic Republic,WPRO,0,19,0,0
2020-06-07,LA,Lao People's Democratic Republic,WPRO,0,19,0,0
2020-06-08,LA,Lao People's Democratic Republic,WPRO,0,19,0,0
2020-03-29,LV,Latvia,EURO,42,347,0,0
2020-03-30,LV,Latvia,EURO,29,376,0,0
2020-03-31,LV,Latvia,EURO,22,398,0,0
2020-04-01,LV,Latvia,EURO,48,446,0,0
2020-04-02,LV,Latvia,EURO,12,458,0,0
2020-04-03,LV,Latvia,EURO,35,493,1,1
2020-04-04,LV,Latvia,EURO,16,509,1,2
2020-04-05,LV,Latvia,EURO,24,533,0,2
2020-04-06,LV,Latvia,EURO,9,542,1,3
2020-04-07,LV,Latvia,EURO,6,548,0,3
2020-04-08,LV,Latvia,EURO,29,577,0,3
2020-04-09,LV,Latvia,EURO,12,589,1,4
2020-04-10,LV,Latvia,EURO,23,612,0,4
2020-04-11,LV,Latvia,EURO,18,630,2,6
2020-04-12,LV,Latvia,EURO,21,651,1,7
2020-04-13,LV,Latvia,EURO,2,653,0,7
2020-04-14,LV,Latvia,EURO,4,657,0,7
2020-04-15,LV,Latvia,EURO,9,666,0,7
2020-04-16,LV,Latvia,EURO,9,675,0,7
2020-04-17,LV,Latvia,EURO,7,682,1,8
2020-04-18,LV,Latvia,EURO,30,712,0,8
2020-04-19,LV,Latvia,EURO,15,727,0,8
2020-04-20,LV,Latvia,EURO,12,739,0,8
2020-04-21,LV,Latvia,EURO,9,748,3,11
2020-04-22,LV,Latvia,EURO,13,761,0,11
2020-04-23,LV,Latvia,EURO,17,778,0,11
2020-04-24,LV,Latvia,EURO,6,784,1,12
2020-04-25,LV,Latvia,EURO,20,804,0,12
2020-04-26,LV,Latvia,EURO,8,812,1,13
2020-04-27,LV,Latvia,EURO,6,818,0,13
2020-04-28,LV,Latvia,EURO,18,836,2,15
2020-04-29,LV,Latvia,EURO,13,849,0,15
2020-04-30,LV,Latvia,EURO,9,858,1,16
2020-05-01,LV,Latvia,EURO,12,870,0,16
2020-05-02,LV,Latvia,EURO,1,871,1,17
2020-05-03,LV,Latvia,EURO,8,879,0,17
2020-05-04,LV,Latvia,EURO,17,896,1,18
2020-05-05,LV,Latvia,EURO,0,896,0,18
2020-05-06,LV,Latvia,EURO,4,900,0,18
2020-05-07,LV,Latvia,EURO,9,909,0,18
2020-05-08,LV,Latvia,EURO,19,928,0,18
2020-05-09,LV,Latvia,EURO,2,930,0,18
2020-05-10,LV,Latvia,EURO,9,939,0,18
2020-05-11,LV,Latvia,EURO,7,946,0,18
2020-05-12,LV,Latvia,EURO,4,950,1,19
2020-05-13,LV,Latvia,EURO,1,951,0,19
2020-05-14,LV,Latvia,EURO,11,962,0,19
2020-05-15,LV,Latvia,EURO,8,970,0,19
2020-05-16,LV,Latvia,EURO,27,997,0,19
2020-05-17,LV,Latvia,EURO,11,1008,1,20
2020-05-18,LV,Latvia,EURO,1,1009,1,21
2020-05-19,LV,Latvia,EURO,3,1012,0,21
2020-05-20,LV,Latvia,EURO,4,1016,0,21
2020-05-21,LV,Latvia,EURO,9,1025,1,22
2020-05-22,LV,Latvia,EURO,5,1030,0,22
2020-05-23,LV,Latvia,EURO,16,1046,0,22
2020-05-24,LV,Latvia,EURO,1,1047,1,23
2020-05-25,LV,Latvia,EURO,2,1049,0,23
2020-05-26,LV,Latvia,EURO,4,1053,0,23
2020-05-27,LV,Latvia,EURO,4,1057,1,24
2020-05-28,LV,Latvia,EURO,4,1061,0,24
2020-05-29,LV,Latvia,EURO,3,1064,0,24
2020-05-30,LV,Latvia,EURO,1,1065,0,24
2020-05-31,LV,Latvia,EURO,1,1066,1,25
2020-06-01,LV,Latvia,EURO,0,1066,0,25
2020-06-02,LV,Latvia,EURO,5,1071,0,25
2020-06-03,LV,Latvia,EURO,8,1079,0,25
2020-06-04,LV,Latvia,EURO,3,1082,0,25
2020-06-05,LV,Latvia,EURO,3,1085,0,25
2020-06-06,LV,Latvia,EURO,1,1086,0,25
2020-06-07,LV,Latvia,EURO,2,1088,0,25
2020-06-08,LV,Latvia,EURO,0,1088,1,26
2020-03-29,LB,Lebanon,EMRO,21,412,0,8
2020-03-30,LB,Lebanon,EMRO,26,438,2,10
2020-03-31,LB,Lebanon,EMRO,8,446,1,11
2020-04-01,LB,Lebanon,EMRO,17,463,1,12
2020-04-02,LB,Lebanon,EMRO,16,479,0,12
2020-04-03,LB,Lebanon,EMRO,15,494,4,16
2020-04-04,LB,Lebanon,EMRO,14,508,1,17
2020-04-05,LB,Lebanon,EMRO,12,520,0,17
2020-04-06,LB,Lebanon,EMRO,7,527,1,18
2020-04-07,LB,Lebanon,EMRO,14,541,1,19
2020-04-08,LB,Lebanon,EMRO,7,548,0,19
2020-04-09,LB,Lebanon,EMRO,27,575,0,19
2020-04-10,LB,Lebanon,EMRO,7,582,0,19
2020-04-11,LB,Lebanon,EMRO,27,609,1,20
2020-04-12,LB,Lebanon,EMRO,10,619,0,20
2020-04-13,LB,Lebanon,EMRO,11,630,0,20
2020-04-14,LB,Lebanon,EMRO,2,632,0,20
2020-04-15,LB,Lebanon,EMRO,9,641,1,21
2020-04-16,LB,Lebanon,EMRO,17,658,0,21
2020-04-17,LB,Lebanon,EMRO,5,663,0,21
2020-04-18,LB,Lebanon,EMRO,5,668,0,21
2020-04-19,LB,Lebanon,EMRO,4,672,0,21
2020-04-20,LB,Lebanon,EMRO,1,673,0,21
2020-04-21,LB,Lebanon,EMRO,4,677,0,21
2020-04-22,LB,Lebanon,EMRO,0,677,0,21
2020-04-23,LB,Lebanon,EMRO,5,682,1,22
2020-04-24,LB,Lebanon,EMRO,6,688,0,22
2020-04-25,LB,Lebanon,EMRO,8,696,0,22
2020-04-26,LB,Lebanon,EMRO,8,704,2,24
2020-04-27,LB,Lebanon,EMRO,3,707,0,24
2020-04-28,LB,Lebanon,EMRO,3,710,0,24
2020-04-29,LB,Lebanon,EMRO,7,717,0,24
2020-04-30,LB,Lebanon,EMRO,4,721,0,24
2020-05-01,LB,Lebanon,EMRO,4,725,0,24
2020-05-02,LB,Lebanon,EMRO,4,729,0,24
2020-05-03,LB,Lebanon,EMRO,4,733,1,25
2020-05-04,LB,Lebanon,EMRO,4,737,0,25
2020-05-05,LB,Lebanon,EMRO,3,740,0,25
2020-05-06,LB,Lebanon,EMRO,1,741,0,25
2020-05-07,LB,Lebanon,EMRO,9,750,0,25
2020-05-08,LB,Lebanon,EMRO,34,784,0,25
2020-05-09,LB,Lebanon,EMRO,12,796,1,26
2020-05-10,LB,Lebanon,EMRO,13,809,0,26
2020-05-11,LB,Lebanon,EMRO,36,845,0,26
2020-05-12,LB,Lebanon,EMRO,14,859,0,26
2020-05-13,LB,Lebanon,EMRO,11,870,0,26
2020-05-14,LB,Lebanon,EMRO,8,878,0,26
2020-05-15,LB,Lebanon,EMRO,8,886,0,26
2020-05-16,LB,Lebanon,EMRO,5,891,0,26
2020-05-17,LB,Lebanon,EMRO,11,902,0,26
2020-05-18,LB,Lebanon,EMRO,9,911,0,26
2020-05-19,LB,Lebanon,EMRO,20,931,0,26
2020-05-20,LB,Lebanon,EMRO,23,954,0,26
2020-05-21,LB,Lebanon,EMRO,7,961,0,26
2020-05-22,LB,Lebanon,EMRO,63,1024,0,26
2020-05-23,LB,Lebanon,EMRO,62,1086,0,26
2020-05-24,LB,Lebanon,EMRO,11,1097,0,26
2020-05-25,LB,Lebanon,EMRO,17,1114,0,26
2020-05-26,LB,Lebanon,EMRO,5,1119,0,26
2020-05-27,LB,Lebanon,EMRO,21,1140,0,26
2020-05-28,LB,Lebanon,EMRO,21,1161,0,26
2020-05-29,LB,Lebanon,EMRO,7,1168,0,26
2020-05-30,LB,Lebanon,EMRO,4,1172,0,26
2020-05-31,LB,Lebanon,EMRO,19,1191,0,26
2020-06-01,LB,Lebanon,EMRO,29,1220,1,27
2020-06-02,LB,Lebanon,EMRO,13,1233,0,27
2020-06-03,LB,Lebanon,EMRO,9,1242,0,27
2020-06-04,LB,Lebanon,EMRO,14,1256,0,27
2020-06-05,LB,Lebanon,EMRO,50,1306,1,28
2020-06-06,LB,Lebanon,EMRO,6,1312,0,28
2020-06-07,LB,Lebanon,EMRO,8,1320,1,29
2020-06-08,LB,Lebanon,EMRO,11,1331,1,30
2020-03-29,LS,Lesotho,AFRO,0,1,0,19
2020-03-30,LS,Lesotho,AFRO,0,1,0,19
2020-03-31,LS,Lesotho,AFRO,0,1,0,19
2020-04-01,LS,Lesotho,AFRO,0,1,0,19
2020-04-02,LS,Lesotho,AFRO,0,1,0,19
2020-04-03,LS,Lesotho,AFRO,0,1,0,19
2020-04-04,LS,Lesotho,AFRO,0,1,0,19
2020-04-05,LS,Lesotho,AFRO,0,1,0,19
2020-04-06,LS,Lesotho,AFRO,0,1,0,19
2020-04-07,LS,Lesotho,AFRO,0,1,0,19
2020-04-08,LS,Lesotho,AFRO,0,1,0,19
2020-04-09,LS,Lesotho,AFRO,0,1,0,19
2020-04-10,LS,Lesotho,AFRO,0,1,0,19
2020-04-11,LS,Lesotho,AFRO,0,1,0,19
2020-04-12,LS,Lesotho,AFRO,0,1,0,19
2020-04-13,LS,Lesotho,AFRO,0,1,0,19
2020-04-14,LS,Lesotho,AFRO,0,1,0,19
2020-04-15,LS,Lesotho,AFRO,0,1,0,19
2020-04-16,LS,Lesotho,AFRO,0,1,0,19
2020-04-17,LS,Lesotho,AFRO,0,1,0,19
2020-04-18,LS,Lesotho,AFRO,0,1,0,19
2020-04-19,LS,Lesotho,AFRO,0,1,0,19
2020-04-20,LS,Lesotho,AFRO,0,1,0,19
2020-04-21,LS,Lesotho,AFRO,0,1,0,19
2020-04-22,LS,Lesotho,AFRO,0,1,0,19
2020-04-23,LS,Lesotho,AFRO,0,1,0,19
2020-04-24,LS,Lesotho,AFRO,0,1,0,19
2020-04-25,LS,Lesotho,AFRO,0,1,0,19
2020-04-26,LS,Lesotho,AFRO,0,1,0,19
2020-04-27,LS,Lesotho,AFRO,0,1,0,19
2020-04-28,LS,Lesotho,AFRO,0,1,0,19
2020-04-29,LS,Lesotho,AFRO,0,1,0,19
2020-04-30,LS,Lesotho,AFRO,0,1,0,19
2020-05-01,LS,Lesotho,AFRO,0,1,0,19
2020-05-02,LS,Lesotho,AFRO,0,1,0,19
2020-05-03,LS,Lesotho,AFRO,0,1,0,19
2020-05-04,LS,Lesotho,AFRO,0,1,0,19
2020-05-05,LS,Lesotho,AFRO,0,1,0,19
2020-05-06,LS,Lesotho,AFRO,0,1,0,19
2020-05-07,LS,Lesotho,AFRO,0,1,0,19
2020-05-08,LS,Lesotho,AFRO,0,1,0,19
2020-05-09,LS,Lesotho,AFRO,0,1,0,19
2020-05-10,LS,Lesotho,AFRO,0,1,0,19
2020-05-11,LS,Lesotho,AFRO,0,1,0,19
2020-05-12,LS,Lesotho,AFRO,0,1,0,19
2020-05-13,LS,Lesotho,AFRO,0,1,0,19
2020-05-14,LS,Lesotho,AFRO,0,1,0,19
2020-05-15,LS,Lesotho,AFRO,0,1,0,19
2020-05-16,LS,Lesotho,AFRO,0,1,0,19
2020-05-17,LS,Lesotho,AFRO,0,1,0,19
2020-05-18,LS,Lesotho,AFRO,0,1,0,19
2020-05-19,LS,Lesotho,AFRO,0,1,0,19
2020-05-20,LS,Lesotho,AFRO,0,1,0,19
2020-05-21,LS,Lesotho,AFRO,0,1,0,19
2020-05-22,LS,Lesotho,AFRO,0,1,0,19
2020-05-23,LS,Lesotho,AFRO,1,2,0,19
2020-05-24,LS,Lesotho,AFRO,0,2,0,19
2020-05-25,LS,Lesotho,AFRO,0,2,0,19
2020-05-26,LS,Lesotho,AFRO,0,2,0,19
2020-05-27,LS,Lesotho,AFRO,0,2,0,19
2020-05-28,LS,Lesotho,AFRO,0,2,0,19
2020-05-29,LS,Lesotho,AFRO,0,2,0,19
2020-05-30,LS,Lesotho,AFRO,0,2,0,19
2020-05-31,LS,Lesotho,AFRO,0,2,0,19
2020-06-01,LS,Lesotho,AFRO,0,2,0,19
2020-06-02,LS,Lesotho,AFRO,2,4,0,19
2020-06-03,LS,Lesotho,AFRO,0,4,0,19
2020-06-04,LS,Lesotho,AFRO,0,4,0,19
2020-06-05,LS,Lesotho,AFRO,0,4,0,19
2020-06-06,LS,Lesotho,AFRO,0,4,0,19
2020-06-07,LS,Lesotho,AFRO,0,4,0,19
2020-06-08,LS,Lesotho,AFRO,0,4,0,19
2020-03-29,LR,Liberia,AFRO,0,4,0,1
2020-03-30,LR,Liberia,AFRO,0,4,0,1
2020-03-31,LR,Liberia,AFRO,3,7,0,1
2020-04-01,LR,Liberia,AFRO,0,7,0,1
2020-04-02,LR,Liberia,AFRO,0,7,0,1
2020-04-03,LR,Liberia,AFRO,0,7,0,1
2020-04-04,LR,Liberia,AFRO,1,8,0,1
2020-04-05,LR,Liberia,AFRO,3,11,0,1
2020-04-06,LR,Liberia,AFRO,3,14,2,3
2020-04-07,LR,Liberia,AFRO,7,21,0,3
2020-04-08,LR,Liberia,AFRO,11,32,2,5
2020-04-09,LR,Liberia,AFRO,6,38,0,5
2020-04-10,LR,Liberia,AFRO,6,44,0,5
2020-04-11,LR,Liberia,AFRO,11,55,1,6
2020-04-12,LR,Liberia,AFRO,2,57,0,6
2020-04-13,LR,Liberia,AFRO,1,58,0,6
2020-04-14,LR,Liberia,AFRO,8,66,0,6
2020-04-15,LR,Liberia,AFRO,8,74,1,7
2020-04-16,LR,Liberia,AFRO,6,80,1,8
2020-04-17,LR,Liberia,AFRO,3,83,0,8
2020-04-18,LR,Liberia,AFRO,5,88,0,8
2020-04-19,LR,Liberia,AFRO,10,98,1,9
2020-04-20,LR,Liberia,AFRO,8,106,0,9
2020-04-21,LR,Liberia,AFRO,6,112,0,9
2020-04-22,LR,Liberia,AFRO,0,112,0,9
2020-04-23,LR,Liberia,AFRO,3,115,0,9
2020-04-24,LR,Liberia,AFRO,8,123,1,10
2020-04-25,LR,Liberia,AFRO,3,126,3,13
2020-04-26,LR,Liberia,AFRO,4,130,1,14
2020-04-27,LR,Liberia,AFRO,9,139,4,18
2020-04-28,LR,Liberia,AFRO,8,147,0,18
2020-04-29,LR,Liberia,AFRO,0,147,0,18
2020-04-30,LR,Liberia,AFRO,6,153,0,18
2020-05-01,LR,Liberia,AFRO,11,164,2,20
2020-05-02,LR,Liberia,AFRO,3,167,0,20
2020-05-03,LR,Liberia,AFRO,4,171,0,20
2020-05-04,LR,Liberia,AFRO,8,179,0,20
2020-05-05,LR,Liberia,AFRO,4,183,2,22
2020-05-06,LR,Liberia,AFRO,8,191,0,22
2020-05-07,LR,Liberia,AFRO,11,202,0,22
2020-05-08,LR,Liberia,AFRO,8,210,0,22
2020-05-09,LR,Liberia,AFRO,0,210,0,22
2020-05-10,LR,Liberia,AFRO,5,215,0,22
2020-05-11,LR,Liberia,AFRO,7,222,0,22
2020-05-12,LR,Liberia,AFRO,1,223,0,22
2020-05-13,LR,Liberia,AFRO,1,224,0,22
2020-05-14,LR,Liberia,AFRO,2,226,0,22
2020-05-15,LR,Liberia,AFRO,4,230,0,22
2020-05-16,LR,Liberia,AFRO,4,234,1,23
2020-05-17,LR,Liberia,AFRO,3,237,0,23
2020-05-18,LR,Liberia,AFRO,3,240,1,24
2020-05-19,LR,Liberia,AFRO,4,244,1,25
2020-05-20,LR,Liberia,AFRO,5,249,0,25
2020-05-21,LR,Liberia,AFRO,2,251,0,25
2020-05-22,LR,Liberia,AFRO,9,260,1,26
2020-05-23,LR,Liberia,AFRO,6,266,2,28
2020-05-24,LR,Liberia,AFRO,4,270,0,28
2020-05-25,LR,Liberia,AFRO,0,270,0,28
2020-05-26,LR,Liberia,AFRO,2,272,1,29
2020-05-27,LR,Liberia,AFRO,0,272,1,30
2020-05-28,LR,Liberia,AFRO,3,275,0,30
2020-05-29,LR,Liberia,AFRO,4,279,0,30
2020-05-30,LR,Liberia,AFRO,7,286,0,30
2020-05-31,LR,Liberia,AFRO,8,294,0,30
2020-06-01,LR,Liberia,AFRO,8,302,0,30
2020-06-02,LR,Liberia,AFRO,15,317,1,31
2020-06-03,LR,Liberia,AFRO,5,322,0,31
2020-06-04,LR,Liberia,AFRO,4,326,0,31
2020-06-05,LR,Liberia,AFRO,13,339,2,33
2020-06-06,LR,Liberia,AFRO,11,350,0,33
2020-06-07,LR,Liberia,AFRO,14,364,0,33
2020-06-08,LR,Liberia,AFRO,11,375,0,33
2020-03-29,LY,Libya,EMRO,0,1,0,0
2020-03-30,LY,Libya,EMRO,0,1,0,0
2020-03-31,LY,Libya,EMRO,7,8,0,0
2020-04-01,LY,Libya,EMRO,0,8,0,0
2020-04-02,LY,Libya,EMRO,0,8,0,0
2020-04-03,LY,Libya,EMRO,2,10,0,0
2020-04-04,LY,Libya,EMRO,0,10,1,1
2020-04-05,LY,Libya,EMRO,1,11,0,1
2020-04-06,LY,Libya,EMRO,6,17,0,1
2020-04-07,LY,Libya,EMRO,1,18,0,1
2020-04-08,LY,Libya,EMRO,0,18,0,1
2020-04-09,LY,Libya,EMRO,2,20,0,1
2020-04-10,LY,Libya,EMRO,1,21,0,1
2020-04-11,LY,Libya,EMRO,3,24,0,1
2020-04-12,LY,Libya,EMRO,0,24,0,1
2020-04-13,LY,Libya,EMRO,0,24,0,1
2020-04-14,LY,Libya,EMRO,1,25,0,1
2020-04-15,LY,Libya,EMRO,1,26,0,1
2020-04-16,LY,Libya,EMRO,0,26,0,1
2020-04-17,LY,Libya,EMRO,9,35,0,1
2020-04-18,LY,Libya,EMRO,14,49,0,1
2020-04-19,LY,Libya,EMRO,0,49,0,1
2020-04-20,LY,Libya,EMRO,0,49,0,1
2020-04-21,LY,Libya,EMRO,0,49,0,1
2020-04-22,LY,Libya,EMRO,2,51,0,1
2020-04-23,LY,Libya,EMRO,0,51,0,1
2020-04-24,LY,Libya,EMRO,8,59,0,1
2020-04-25,LY,Libya,EMRO,1,60,1,2
2020-04-26,LY,Libya,EMRO,0,60,0,2
2020-04-27,LY,Libya,EMRO,1,61,0,2
2020-04-28,LY,Libya,EMRO,0,61,0,2
2020-04-29,LY,Libya,EMRO,0,61,0,2
2020-04-30,LY,Libya,EMRO,0,61,0,2
2020-05-01,LY,Libya,EMRO,0,61,0,2
2020-05-02,LY,Libya,EMRO,0,61,1,3
2020-05-03,LY,Libya,EMRO,2,63,0,3
2020-05-04,LY,Libya,EMRO,0,63,0,3
2020-05-05,LY,Libya,EMRO,0,63,0,3
2020-05-06,LY,Libya,EMRO,0,63,0,3
2020-05-07,LY,Libya,EMRO,0,63,0,3
2020-05-08,LY,Libya,EMRO,1,64,0,3
2020-05-09,LY,Libya,EMRO,0,64,0,3
2020-05-10,LY,Libya,EMRO,0,64,0,3
2020-05-11,LY,Libya,EMRO,0,64,0,3
2020-05-12,LY,Libya,EMRO,0,64,0,3
2020-05-13,LY,Libya,EMRO,0,64,0,3
2020-05-14,LY,Libya,EMRO,0,64,0,3
2020-05-15,LY,Libya,EMRO,0,64,0,3
2020-05-16,LY,Libya,EMRO,0,64,0,3
2020-05-17,LY,Libya,EMRO,0,64,0,3
2020-05-18,LY,Libya,EMRO,1,65,0,3
2020-05-19,LY,Libya,EMRO,0,65,0,3
2020-05-20,LY,Libya,EMRO,0,65,0,3
2020-05-21,LY,Libya,EMRO,3,68,0,3
2020-05-22,LY,Libya,EMRO,1,69,0,3
2020-05-23,LY,Libya,EMRO,2,71,0,3
2020-05-24,LY,Libya,EMRO,1,72,0,3
2020-05-25,LY,Libya,EMRO,3,75,0,3
2020-05-26,LY,Libya,EMRO,0,75,0,3
2020-05-27,LY,Libya,EMRO,0,75,0,3
2020-05-28,LY,Libya,EMRO,2,77,0,3
2020-05-29,LY,Libya,EMRO,22,99,1,4
2020-05-30,LY,Libya,EMRO,6,105,1,5
2020-05-31,LY,Libya,EMRO,13,118,0,5
2020-06-01,LY,Libya,EMRO,12,130,0,5
2020-06-02,LY,Libya,EMRO,26,156,0,5
2020-06-03,LY,Libya,EMRO,12,168,0,5
2020-06-04,LY,Libya,EMRO,14,182,0,5
2020-06-05,LY,Libya,EMRO,14,196,0,5
2020-06-06,LY,Libya,EMRO,13,209,0,5
2020-06-07,LY,Libya,EMRO,30,239,0,5
2020-06-08,LY,Libya,EMRO,17,256,0,5
2020-03-29,LI,Liechtenstein,EURO,1,64,0,0
2020-03-30,LI,Liechtenstein,EURO,1,65,0,0
2020-03-31,LI,Liechtenstein,EURO,4,69,0,0
2020-04-01,LI,Liechtenstein,EURO,4,73,0,0
2020-04-02,LI,Liechtenstein,EURO,3,76,0,0
2020-04-03,LI,Liechtenstein,EURO,1,77,0,0
2020-04-04,LI,Liechtenstein,EURO,1,78,0,0
2020-04-05,LI,Liechtenstein,EURO,0,78,1,1
2020-04-06,LI,Liechtenstein,EURO,0,78,0,1
2020-04-07,LI,Liechtenstein,EURO,1,79,0,1
2020-04-08,LI,Liechtenstein,EURO,0,79,0,1
2020-04-09,LI,Liechtenstein,EURO,1,80,0,1
2020-04-10,LI,Liechtenstein,EURO,0,80,0,1
2020-04-11,LI,Liechtenstein,EURO,0,80,0,1
2020-04-12,LI,Liechtenstein,EURO,1,81,0,1
2020-04-13,LI,Liechtenstein,EURO,0,81,0,1
2020-04-14,LI,Liechtenstein,EURO,0,81,0,1
2020-04-15,LI,Liechtenstein,EURO,0,81,0,1
2020-04-16,LI,Liechtenstein,EURO,0,81,0,1
2020-04-17,LI,Liechtenstein,EURO,1,82,0,1
2020-04-18,LI,Liechtenstein,EURO,0,82,0,1
2020-04-19,LI,Liechtenstein,EURO,0,82,0,1
2020-04-20,LI,Liechtenstein,EURO,0,82,0,1
2020-04-21,LI,Liechtenstein,EURO,0,82,0,1
2020-04-22,LI,Liechtenstein,EURO,0,82,0,1
2020-04-23,LI,Liechtenstein,EURO,0,82,0,1
2020-04-24,LI,Liechtenstein,EURO,1,83,0,1
2020-04-25,LI,Liechtenstein,EURO,0,83,0,1
2020-04-26,LI,Liechtenstein,EURO,0,83,0,1
2020-04-27,LI,Liechtenstein,EURO,0,83,0,1
2020-04-28,LI,Liechtenstein,EURO,0,83,0,1
2020-04-29,LI,Liechtenstein,EURO,0,83,0,1
2020-04-30,LI,Liechtenstein,EURO,0,83,0,1
2020-05-01,LI,Liechtenstein,EURO,0,83,0,1
2020-05-02,LI,Liechtenstein,EURO,0,83,0,1
2020-05-03,LI,Liechtenstein,EURO,0,83,0,1
2020-05-04,LI,Liechtenstein,EURO,0,83,0,1
2020-05-05,LI,Liechtenstein,EURO,0,83,0,1
2020-05-06,LI,Liechtenstein,EURO,0,83,0,1
2020-05-07,LI,Liechtenstein,EURO,0,83,0,1
2020-05-08,LI,Liechtenstein,EURO,0,83,0,1
2020-05-09,LI,Liechtenstein,EURO,0,83,0,1
2020-05-10,LI,Liechtenstein,EURO,0,83,0,1
2020-05-11,LI,Liechtenstein,EURO,0,83,0,1
2020-05-12,LI,Liechtenstein,EURO,0,83,0,1
2020-05-13,LI,Liechtenstein,EURO,0,83,0,1
2020-05-14,LI,Liechtenstein,EURO,0,83,0,1
2020-05-15,LI,Liechtenstein,EURO,0,83,0,1
2020-05-16,LI,Liechtenstein,EURO,0,83,0,1
2020-05-17,LI,Liechtenstein,EURO,0,83,0,1
2020-05-18,LI,Liechtenstein,EURO,0,83,0,1
2020-05-19,LI,Liechtenstein,EURO,0,83,0,1
2020-05-20,LI,Liechtenstein,EURO,0,83,0,1
2020-05-21,LI,Liechtenstein,EURO,0,83,0,1
2020-05-22,LI,Liechtenstein,EURO,0,83,0,1
2020-05-23,LI,Liechtenstein,EURO,0,83,0,1
2020-05-24,LI,Liechtenstein,EURO,0,83,0,1
2020-05-25,LI,Liechtenstein,EURO,0,83,0,1
2020-05-26,LI,Liechtenstein,EURO,0,83,0,1
2020-05-27,LI,Liechtenstein,EURO,0,83,0,1
2020-05-28,LI,Liechtenstein,EURO,0,83,0,1
2020-05-29,LI,Liechtenstein,EURO,0,83,0,1
2020-05-30,LI,Liechtenstein,EURO,0,83,0,1
2020-05-31,LI,Liechtenstein,EURO,0,83,0,1
2020-06-01,LI,Liechtenstein,EURO,0,83,0,1
2020-06-02,LI,Liechtenstein,EURO,0,83,0,1
2020-06-03,LI,Liechtenstein,EURO,0,83,0,1
2020-06-04,LI,Liechtenstein,EURO,0,83,0,1
2020-06-05,LI,Liechtenstein,EURO,0,83,0,1
2020-06-06,LI,Liechtenstein,EURO,0,83,0,1
2020-06-07,LI,Liechtenstein,EURO,0,83,0,1
2020-06-08,LI,Liechtenstein,EURO,0,83,0,1
2020-03-29,LT,Lithuania,EURO,36,262,0,4
2020-03-30,LT,Lithuania,EURO,17,279,0,4
2020-03-31,LT,Lithuania,EURO,73,352,0,4
2020-04-01,LT,Lithuania,EURO,44,396,2,6
2020-04-02,LT,Lithuania,EURO,73,469,0,6
2020-04-03,LT,Lithuania,EURO,58,527,0,6
2020-04-04,LT,Lithuania,EURO,43,570,1,7
2020-04-05,LT,Lithuania,EURO,46,616,1,8
2020-04-06,LT,Lithuania,EURO,31,647,2,10
2020-04-07,LT,Lithuania,EURO,40,687,1,11
2020-04-08,LT,Lithuania,EURO,33,720,0,11
2020-04-09,LT,Lithuania,EURO,50,770,0,11
2020-04-10,LT,Lithuania,EURO,38,808,1,12
2020-04-11,LT,Lithuania,EURO,39,847,1,13
2020-04-12,LT,Lithuania,EURO,33,880,1,14
2020-04-13,LT,Lithuania,EURO,19,899,1,15
2020-04-14,LT,Lithuania,EURO,6,905,1,16
2020-04-15,LT,Lithuania,EURO,18,923,4,20
2020-04-16,LT,Lithuania,EURO,27,950,0,20
2020-04-17,LT,Lithuania,EURO,26,976,1,21
2020-04-18,LT,Lithuania,EURO,49,1025,1,22
2020-04-19,LT,Lithuania,EURO,93,1118,1,23
2020-04-20,LT,Lithuania,EURO,21,1139,3,26
2020-04-21,LT,Lithuania,EURO,26,1165,0,26
2020-04-22,LT,Lithuania,EURO,22,1187,1,27
2020-04-23,LT,Lithuania,EURO,18,1205,0,27
2020-04-24,LT,Lithuania,EURO,16,1221,1,28
2020-04-25,LT,Lithuania,EURO,13,1234,1,29
2020-04-26,LT,Lithuania,EURO,11,1245,2,31
2020-04-27,LT,Lithuania,EURO,15,1260,1,32
2020-04-28,LT,Lithuania,EURO,2,1262,0,32
2020-04-29,LT,Lithuania,EURO,29,1291,0,32
2020-04-30,LT,Lithuania,EURO,19,1310,0,32
2020-05-01,LT,Lithuania,EURO,6,1316,0,32
2020-05-02,LT,Lithuania,EURO,4,1320,1,33
2020-05-03,LT,Lithuania,EURO,7,1327,0,33
2020-05-04,LT,Lithuania,EURO,7,1334,0,33
2020-05-05,LT,Lithuania,EURO,4,1338,0,33
2020-05-06,LT,Lithuania,EURO,7,1345,1,34
2020-05-07,LT,Lithuania,EURO,4,1349,1,35
2020-05-08,LT,Lithuania,EURO,11,1360,0,35
2020-05-09,LT,Lithuania,EURO,25,1385,0,35
2020-05-10,LT,Lithuania,EURO,14,1399,1,36
2020-05-11,LT,Lithuania,EURO,9,1408,0,36
2020-05-12,LT,Lithuania,EURO,9,1417,3,39
2020-05-13,LT,Lithuania,EURO,13,1430,0,39
2020-05-14,LT,Lithuania,EURO,9,1439,0,39
2020-05-15,LT,Lithuania,EURO,12,1451,2,41
2020-05-16,LT,Lithuania,EURO,14,1465,1,42
2020-05-17,LT,Lithuania,EURO,10,1475,1,43
2020-05-18,LT,Lithuania,EURO,6,1481,2,45
2020-05-19,LT,Lithuania,EURO,12,1493,0,45
2020-05-20,LT,Lithuania,EURO,16,1509,1,46
2020-05-21,LT,Lithuania,EURO,15,1524,0,46
2020-05-22,LT,Lithuania,EURO,12,1536,0,46
2020-05-23,LT,Lithuania,EURO,11,1547,1,47
2020-05-24,LT,Lithuania,EURO,10,1557,1,48
2020-05-25,LT,Lithuania,EURO,6,1563,1,49
2020-05-26,LT,Lithuania,EURO,7,1570,2,51
2020-05-27,LT,Lithuania,EURO,5,1575,0,51
2020-05-28,LT,Lithuania,EURO,10,1585,1,52
2020-05-29,LT,Lithuania,EURO,7,1592,0,52
2020-05-30,LT,Lithuania,EURO,9,1601,2,54
2020-05-31,LT,Lithuania,EURO,4,1605,0,54
2020-06-01,LT,Lithuania,EURO,6,1611,1,55
2020-06-02,LT,Lithuania,EURO,3,1614,0,55
2020-06-03,LT,Lithuania,EURO,3,1617,0,55
2020-06-04,LT,Lithuania,EURO,5,1622,0,55
2020-06-05,LT,Lithuania,EURO,8,1630,0,55
2020-06-06,LT,Lithuania,EURO,13,1643,0,55
2020-06-07,LT,Lithuania,EURO,6,1649,1,56
2020-06-08,LT,Lithuania,EURO,6,1655,2,58
2020-03-29,LU,Luxembourg,EURO,152,1682,5,14
2020-03-30,LU,Luxembourg,EURO,97,1779,3,17
2020-03-31,LU,Luxembourg,EURO,33,1812,4,21
2020-04-01,LU,Luxembourg,EURO,136,1948,1,22
2020-04-02,LU,Luxembourg,EURO,86,2034,4,26
2020-04-03,LU,Luxembourg,EURO,119,2153,1,27
2020-04-04,LU,Luxembourg,EURO,109,2262,1,28
2020-04-05,LU,Luxembourg,EURO,87,2349,1,29
2020-04-06,LU,Luxembourg,EURO,59,2408,5,34
2020-04-07,LU,Luxembourg,EURO,31,2439,2,36
2020-04-08,LU,Luxembourg,EURO,59,2498,2,38
2020-04-09,LU,Luxembourg,EURO,61,2559,5,43
2020-04-10,LU,Luxembourg,EURO,64,2623,3,46
2020-04-11,LU,Luxembourg,EURO,57,2680,3,49
2020-04-12,LU,Luxembourg,EURO,35,2715,5,54
2020-04-13,LU,Luxembourg,EURO,7,2722,4,58
2020-04-14,LU,Luxembourg,EURO,12,2734,4,62
2020-04-15,LU,Luxembourg,EURO,3,2737,3,65
2020-04-16,LU,Luxembourg,EURO,59,2796,3,68
2020-04-17,LU,Luxembourg,EURO,33,2829,0,68
2020-04-18,LU,Luxembourg,EURO,25,2854,3,71
2020-04-19,LU,Luxembourg,EURO,44,2898,0,71
2020-04-20,LU,Luxembourg,EURO,15,2913,3,74
2020-04-21,LU,Luxembourg,EURO,3,2916,1,75
2020-04-22,LU,Luxembourg,EURO,15,2931,3,78
2020-04-23,LU,Luxembourg,EURO,24,2955,2,80
2020-04-24,LU,Luxembourg,EURO,9,2964,1,81
2020-04-25,LU,Luxembourg,EURO,16,2980,3,84
2020-04-26,LU,Luxembourg,EURO,17,2997,1,85
2020-04-27,LU,Luxembourg,EURO,12,3009,3,88
2020-04-28,LU,Luxembourg,EURO,5,3014,0,88
2020-04-29,LU,Luxembourg,EURO,9,3023,1,89
2020-04-30,LU,Luxembourg,EURO,17,3040,0,89
2020-05-01,LU,Luxembourg,EURO,10,3050,1,90
2020-05-02,LU,Luxembourg,EURO,12,3062,2,92
2020-05-03,LU,Luxembourg,EURO,7,3069,1,93
2020-05-04,LU,Luxembourg,EURO,4,3073,3,96
2020-05-05,LU,Luxembourg,EURO,4,3077,0,96
2020-05-06,LU,Luxembourg,EURO,11,3088,2,98
2020-05-07,LU,Luxembourg,EURO,8,3096,1,99
2020-05-08,LU,Luxembourg,EURO,6,3102,1,100
2020-05-09,LU,Luxembourg,EURO,5,3107,0,100
2020-05-10,LU,Luxembourg,EURO,3,3110,1,101
2020-05-11,LU,Luxembourg,EURO,8,3118,0,101
2020-05-12,LU,Luxembourg,EURO,1,3119,0,101
2020-05-13,LU,Luxembourg,EURO,4,3123,1,102
2020-05-14,LU,Luxembourg,EURO,7,3130,1,103
2020-05-15,LU,Luxembourg,EURO,9,3139,0,103
2020-05-16,LU,Luxembourg,EURO,3,3142,1,104
2020-05-17,LU,Luxembourg,EURO,5,3147,1,105
2020-05-18,LU,Luxembourg,EURO,9,3156,1,106
2020-05-19,LU,Luxembourg,EURO,1,3157,0,106
2020-05-20,LU,Luxembourg,EURO,12,3169,2,108
2020-05-21,LU,Luxembourg,EURO,7,3176,0,108
2020-05-22,LU,Luxembourg,EURO,7,3183,0,108
2020-05-23,LU,Luxembourg,EURO,0,3183,0,108
2020-05-24,LU,Luxembourg,EURO,9,3192,0,108
2020-05-25,LU,Luxembourg,EURO,2,3194,1,109
2020-05-26,LU,Luxembourg,EURO,1,3195,0,109
2020-05-27,LU,Luxembourg,EURO,2,3197,0,109
2020-05-28,LU,Luxembourg,EURO,5,3202,1,110
2020-05-29,LU,Luxembourg,EURO,1,3203,0,110
2020-05-30,LU,Luxembourg,EURO,3,3206,0,110
2020-05-31,LU,Luxembourg,EURO,3,3209,0,110
2020-06-01,LU,Luxembourg,EURO,2,3211,0,110
2020-06-02,LU,Luxembourg,EURO,0,3211,0,110
2020-06-03,LU,Luxembourg,EURO,1,3212,0,110
2020-06-04,LU,Luxembourg,EURO,2,3214,0,110
2020-06-05,LU,Luxembourg,EURO,2,3216,0,110
2020-06-06,LU,Luxembourg,EURO,4,3220,0,110
2020-06-07,LU,Luxembourg,EURO,1,3221,0,110
2020-06-08,LU,Luxembourg,EURO,2,3223,0,110
2020-03-29,MG,Madagascar,AFRO,11,42,0,1
2020-03-30,MG,Madagascar,AFRO,2,44,0,1
2020-03-31,MG,Madagascar,AFRO,0,44,0,1
2020-04-01,MG,Madagascar,AFRO,9,53,0,1
2020-04-02,MG,Madagascar,AFRO,6,59,0,1
2020-04-03,MG,Madagascar,AFRO,6,65,0,1
2020-04-04,MG,Madagascar,AFRO,5,70,0,1
2020-04-05,MG,Madagascar,AFRO,1,71,0,1
2020-04-06,MG,Madagascar,AFRO,6,77,0,1
2020-04-07,MG,Madagascar,AFRO,8,85,0,1
2020-04-08,MG,Madagascar,AFRO,7,92,0,1
2020-04-09,MG,Madagascar,AFRO,1,93,0,1
2020-04-10,MG,Madagascar,AFRO,2,95,0,1
2020-04-11,MG,Madagascar,AFRO,0,95,0,1
2020-04-12,MG,Madagascar,AFRO,11,106,0,1
2020-04-13,MG,Madagascar,AFRO,0,106,0,1
2020-04-14,MG,Madagascar,AFRO,2,108,0,1
2020-04-15,MG,Madagascar,AFRO,2,110,0,1
2020-04-16,MG,Madagascar,AFRO,7,117,0,1
2020-04-17,MG,Madagascar,AFRO,0,117,0,1
2020-04-18,MG,Madagascar,AFRO,3,120,0,1
2020-04-19,MG,Madagascar,AFRO,0,120,0,1
2020-04-20,MG,Madagascar,AFRO,1,121,0,1
2020-04-21,MG,Madagascar,AFRO,0,121,0,1
2020-04-22,MG,Madagascar,AFRO,0,121,0,1
2020-04-23,MG,Madagascar,AFRO,0,121,0,1
2020-04-24,MG,Madagascar,AFRO,0,121,0,1
2020-04-25,MG,Madagascar,AFRO,1,122,0,1
2020-04-26,MG,Madagascar,AFRO,2,124,0,1
2020-04-27,MG,Madagascar,AFRO,4,128,0,1
2020-04-28,MG,Madagascar,AFRO,0,128,0,1
2020-04-29,MG,Madagascar,AFRO,0,128,0,1
2020-04-30,MG,Madagascar,AFRO,0,128,0,1
2020-05-01,MG,Madagascar,AFRO,4,132,0,1
2020-05-02,MG,Madagascar,AFRO,3,135,0,1
2020-05-03,MG,Madagascar,AFRO,14,149,0,1
2020-05-04,MG,Madagascar,AFRO,9,158,0,1
2020-05-05,MG,Madagascar,AFRO,0,158,0,1
2020-05-06,MG,Madagascar,AFRO,0,158,0,1
2020-05-07,MG,Madagascar,AFRO,0,158,0,1
2020-05-08,MG,Madagascar,AFRO,3,161,0,1
2020-05-09,MG,Madagascar,AFRO,6,167,0,1
2020-05-10,MG,Madagascar,AFRO,2,169,0,1
2020-05-11,MG,Madagascar,AFRO,2,171,0,1
2020-05-12,MG,Madagascar,AFRO,15,186,0,1
2020-05-13,MG,Madagascar,AFRO,6,192,0,1
2020-05-14,MG,Madagascar,AFRO,20,212,0,1
2020-05-15,MG,Madagascar,AFRO,18,230,0,1
2020-05-16,MG,Madagascar,AFRO,8,238,0,1
2020-05-17,MG,Madagascar,AFRO,45,283,0,1
2020-05-18,MG,Madagascar,AFRO,21,304,1,2
2020-05-19,MG,Madagascar,AFRO,18,322,0,2
2020-05-20,MG,Madagascar,AFRO,4,326,1,3
2020-05-21,MG,Madagascar,AFRO,45,371,0,3
2020-05-22,MG,Madagascar,AFRO,34,405,0,3
2020-05-23,MG,Madagascar,AFRO,43,448,0,3
2020-05-24,MG,Madagascar,AFRO,40,488,0,3
2020-05-25,MG,Madagascar,AFRO,39,527,0,3
2020-05-26,MG,Madagascar,AFRO,15,542,0,3
2020-05-27,MG,Madagascar,AFRO,44,586,0,3
2020-05-28,MG,Madagascar,AFRO,26,612,0,3
2020-05-29,MG,Madagascar,AFRO,44,656,0,3
2020-05-30,MG,Madagascar,AFRO,42,698,3,6
2020-05-31,MG,Madagascar,AFRO,60,758,0,6
2020-06-01,MG,Madagascar,AFRO,37,795,0,6
2020-06-02,MG,Madagascar,AFRO,31,826,0,6
2020-06-03,MG,Madagascar,AFRO,19,845,0,6
2020-06-04,MG,Madagascar,AFRO,63,908,0,6
2020-06-05,MG,Madagascar,AFRO,49,957,1,7
2020-06-06,MG,Madagascar,AFRO,18,975,0,7
2020-06-07,MG,Madagascar,AFRO,51,1026,1,8
2020-06-08,MG,Madagascar,AFRO,26,1052,1,9
2020-03-29,MW,Malawi,AFRO,0,3,0,1
2020-03-30,MW,Malawi,AFRO,0,3,0,1
2020-03-31,MW,Malawi,AFRO,0,3,0,1
2020-04-01,MW,Malawi,AFRO,0,3,0,1
2020-04-02,MW,Malawi,AFRO,0,3,0,1
2020-04-03,MW,Malawi,AFRO,0,3,0,1
2020-04-04,MW,Malawi,AFRO,0,3,0,1
2020-04-05,MW,Malawi,AFRO,0,3,0,1
2020-04-06,MW,Malawi,AFRO,1,4,0,1
2020-04-07,MW,Malawi,AFRO,0,4,0,1
2020-04-08,MW,Malawi,AFRO,4,8,0,1
2020-04-09,MW,Malawi,AFRO,0,8,0,1
2020-04-10,MW,Malawi,AFRO,0,8,0,1
2020-04-11,MW,Malawi,AFRO,1,9,0,1
2020-04-12,MW,Malawi,AFRO,3,12,0,1
2020-04-13,MW,Malawi,AFRO,1,13,0,1
2020-04-14,MW,Malawi,AFRO,3,16,1,2
2020-04-15,MW,Malawi,AFRO,0,16,0,2
2020-04-16,MW,Malawi,AFRO,0,16,0,2
2020-04-17,MW,Malawi,AFRO,0,16,0,2
2020-04-18,MW,Malawi,AFRO,1,17,0,2
2020-04-19,MW,Malawi,AFRO,0,17,0,2
2020-04-20,MW,Malawi,AFRO,0,17,0,2
2020-04-21,MW,Malawi,AFRO,0,17,0,2
2020-04-22,MW,Malawi,AFRO,1,18,0,2
2020-04-23,MW,Malawi,AFRO,5,23,1,3
2020-04-24,MW,Malawi,AFRO,10,33,0,3
2020-04-25,MW,Malawi,AFRO,0,33,0,3
2020-04-26,MW,Malawi,AFRO,0,33,0,3
2020-04-27,MW,Malawi,AFRO,1,34,0,3
2020-04-28,MW,Malawi,AFRO,2,36,0,3
2020-04-29,MW,Malawi,AFRO,0,36,0,3
2020-04-30,MW,Malawi,AFRO,0,36,0,3
2020-05-01,MW,Malawi,AFRO,1,37,0,3
2020-05-02,MW,Malawi,AFRO,0,37,0,3
2020-05-03,MW,Malawi,AFRO,1,38,0,3
2020-05-04,MW,Malawi,AFRO,1,39,0,3
2020-05-05,MW,Malawi,AFRO,2,41,0,3
2020-05-06,MW,Malawi,AFRO,0,41,0,3
2020-05-07,MW,Malawi,AFRO,2,43,0,3
2020-05-08,MW,Malawi,AFRO,0,43,0,3
2020-05-09,MW,Malawi,AFRO,0,43,0,3
2020-05-10,MW,Malawi,AFRO,13,56,0,3
2020-05-11,MW,Malawi,AFRO,0,56,0,3
2020-05-12,MW,Malawi,AFRO,1,57,0,3
2020-05-13,MW,Malawi,AFRO,1,58,0,3
2020-05-14,MW,Malawi,AFRO,5,63,0,3
2020-05-15,MW,Malawi,AFRO,0,63,0,3
2020-05-16,MW,Malawi,AFRO,2,65,0,3
2020-05-17,MW,Malawi,AFRO,5,70,0,3
2020-05-18,MW,Malawi,AFRO,0,70,0,3
2020-05-19,MW,Malawi,AFRO,0,70,0,3
2020-05-20,MW,Malawi,AFRO,2,72,0,3
2020-05-21,MW,Malawi,AFRO,0,72,0,3
2020-05-22,MW,Malawi,AFRO,0,72,0,3
2020-05-23,MW,Malawi,AFRO,10,82,0,3
2020-05-24,MW,Malawi,AFRO,1,83,1,4
2020-05-25,MW,Malawi,AFRO,0,83,0,4
2020-05-26,MW,Malawi,AFRO,18,101,0,4
2020-05-27,MW,Malawi,AFRO,0,101,0,4
2020-05-28,MW,Malawi,AFRO,0,101,0,4
2020-05-29,MW,Malawi,AFRO,102,203,0,4
2020-05-30,MW,Malawi,AFRO,76,279,0,4
2020-05-31,MW,Malawi,AFRO,0,279,0,4
2020-06-01,MW,Malawi,AFRO,5,284,0,4
2020-06-02,MW,Malawi,AFRO,52,336,0,4
2020-06-03,MW,Malawi,AFRO,22,358,0,4
2020-06-04,MW,Malawi,AFRO,11,369,0,4
2020-06-05,MW,Malawi,AFRO,24,393,0,4
2020-06-06,MW,Malawi,AFRO,16,409,0,4
2020-06-07,MW,Malawi,AFRO,0,409,0,4
2020-06-08,MW,Malawi,AFRO,29,438,0,4
2020-03-29,MY,Malaysia,WPRO,159,2320,1,27
2020-03-30,MY,Malaysia,WPRO,150,2470,7,34
2020-03-31,MY,Malaysia,WPRO,156,2626,3,37
2020-04-01,MY,Malaysia,WPRO,140,2766,6,43
2020-04-02,MY,Malaysia,WPRO,142,2908,2,45
2020-04-03,MY,Malaysia,WPRO,208,3116,5,50
2020-04-04,MY,Malaysia,WPRO,217,3333,3,53
2020-04-05,MY,Malaysia,WPRO,150,3483,4,57
2020-04-06,MY,Malaysia,WPRO,179,3662,4,61
2020-04-07,MY,Malaysia,WPRO,131,3793,1,62
2020-04-08,MY,Malaysia,WPRO,170,3963,1,63
2020-04-09,MY,Malaysia,WPRO,156,4119,2,65
2020-04-10,MY,Malaysia,WPRO,109,4228,2,67
2020-04-11,MY,Malaysia,WPRO,118,4346,3,70
2020-04-12,MY,Malaysia,WPRO,184,4530,3,73
2020-04-13,MY,Malaysia,WPRO,153,4683,3,76
2020-04-14,MY,Malaysia,WPRO,134,4817,1,77
2020-04-15,MY,Malaysia,WPRO,170,4987,5,82
2020-04-16,MY,Malaysia,WPRO,85,5072,1,83
2020-04-17,MY,Malaysia,WPRO,110,5182,1,84
2020-04-18,MY,Malaysia,WPRO,69,5251,2,86
2020-04-19,MY,Malaysia,WPRO,54,5305,2,88
2020-04-20,MY,Malaysia,WPRO,84,5389,1,89
2020-04-21,MY,Malaysia,WPRO,35,5424,0,89
2020-04-22,MY,Malaysia,WPRO,58,5482,3,92
2020-04-23,MY,Malaysia,WPRO,50,5532,1,93
2020-04-24,MY,Malaysia,WPRO,71,5603,2,95
2020-04-25,MY,Malaysia,WPRO,88,5691,1,96
2020-04-26,MY,Malaysia,WPRO,51,5742,2,98
2020-04-27,MY,Malaysia,WPRO,38,5780,0,98
2020-04-28,MY,Malaysia,WPRO,40,5820,1,99
2020-04-29,MY,Malaysia,WPRO,31,5851,1,100
2020-04-30,MY,Malaysia,WPRO,94,5945,0,100
2020-05-01,MY,Malaysia,WPRO,57,6002,2,102
2020-05-02,MY,Malaysia,WPRO,69,6071,1,103
2020-05-03,MY,Malaysia,WPRO,105,6176,0,103
2020-05-04,MY,Malaysia,WPRO,122,6298,2,105
2020-05-05,MY,Malaysia,WPRO,55,6353,0,105
2020-05-06,MY,Malaysia,WPRO,30,6383,1,106
2020-05-07,MY,Malaysia,WPRO,45,6428,1,107
2020-05-08,MY,Malaysia,WPRO,39,6467,0,107
2020-05-09,MY,Malaysia,WPRO,68,6535,0,107
2020-05-10,MY,Malaysia,WPRO,54,6589,1,108
2020-05-11,MY,Malaysia,WPRO,67,6656,0,108
2020-05-12,MY,Malaysia,WPRO,70,6726,1,109
2020-05-13,MY,Malaysia,WPRO,16,6742,0,109
2020-05-14,MY,Malaysia,WPRO,37,6779,2,111
2020-05-15,MY,Malaysia,WPRO,40,6819,1,112
2020-05-16,MY,Malaysia,WPRO,36,6855,0,112
2020-05-17,MY,Malaysia,WPRO,17,6872,1,113
2020-05-18,MY,Malaysia,WPRO,22,6894,0,113
2020-05-19,MY,Malaysia,WPRO,47,6941,0,113
2020-05-20,MY,Malaysia,WPRO,37,6978,1,114
2020-05-21,MY,Malaysia,WPRO,31,7009,0,114
2020-05-22,MY,Malaysia,WPRO,50,7059,0,114
2020-05-23,MY,Malaysia,WPRO,78,7137,1,115
2020-05-24,MY,Malaysia,WPRO,48,7185,0,115
2020-05-25,MY,Malaysia,WPRO,60,7245,0,115
2020-05-26,MY,Malaysia,WPRO,172,7417,0,115
2020-05-27,MY,Malaysia,WPRO,187,7604,0,115
2020-05-28,MY,Malaysia,WPRO,15,7619,0,115
2020-05-29,MY,Malaysia,WPRO,10,7629,0,115
2020-05-30,MY,Malaysia,WPRO,103,7732,0,115
2020-05-31,MY,Malaysia,WPRO,30,7762,0,115
2020-06-01,MY,Malaysia,WPRO,57,7819,0,115
2020-06-02,MY,Malaysia,WPRO,38,7857,0,115
2020-06-03,MY,Malaysia,WPRO,20,7877,0,115
2020-06-04,MY,Malaysia,WPRO,93,7970,0,115
2020-06-05,MY,Malaysia,WPRO,277,8247,0,115
2020-06-06,MY,Malaysia,WPRO,19,8266,1,116
2020-06-07,MY,Malaysia,WPRO,37,8303,1,117
2020-06-08,MY,Malaysia,WPRO,19,8322,0,117
2020-03-29,MV,Maldives,SEARO,-1,16,0,0
2020-03-30,MV,Maldives,SEARO,1,17,0,0
2020-03-31,MV,Maldives,SEARO,1,18,0,0
2020-04-01,MV,Maldives,SEARO,1,19,0,0
2020-04-02,MV,Maldives,SEARO,0,19,0,0
2020-04-03,MV,Maldives,SEARO,0,19,0,0
2020-04-04,MV,Maldives,SEARO,0,19,0,0
2020-04-05,MV,Maldives,SEARO,0,19,0,0
2020-04-06,MV,Maldives,SEARO,0,19,0,0
2020-04-07,MV,Maldives,SEARO,0,19,0,0
2020-04-08,MV,Maldives,SEARO,0,19,0,0
2020-04-09,MV,Maldives,SEARO,0,19,0,0
2020-04-10,MV,Maldives,SEARO,0,19,0,0
2020-04-11,MV,Maldives,SEARO,0,19,0,0
2020-04-12,MV,Maldives,SEARO,1,20,0,0
2020-04-13,MV,Maldives,SEARO,0,20,0,0
2020-04-14,MV,Maldives,SEARO,0,20,0,0
2020-04-15,MV,Maldives,SEARO,1,21,0,0
2020-04-16,MV,Maldives,SEARO,2,23,0,0
2020-04-17,MV,Maldives,SEARO,5,28,0,0
2020-04-18,MV,Maldives,SEARO,6,34,0,0
2020-04-19,MV,Maldives,SEARO,17,51,0,0
2020-04-20,MV,Maldives,SEARO,16,67,0,0
2020-04-21,MV,Maldives,SEARO,16,83,0,0
2020-04-22,MV,Maldives,SEARO,2,85,0,0
2020-04-23,MV,Maldives,SEARO,9,94,0,0
2020-04-24,MV,Maldives,SEARO,22,116,0,0
2020-04-25,MV,Maldives,SEARO,21,137,0,0
2020-04-26,MV,Maldives,SEARO,51,188,0,0
2020-04-27,MV,Maldives,SEARO,26,214,0,0
2020-04-28,MV,Maldives,SEARO,31,245,0,0
2020-04-29,MV,Maldives,SEARO,11,256,0,0
2020-04-30,MV,Maldives,SEARO,140,396,0,0
2020-05-01,MV,Maldives,SEARO,72,468,1,1
2020-05-02,MV,Maldives,SEARO,51,519,0,1
2020-05-03,MV,Maldives,SEARO,8,527,0,1
2020-05-04,MV,Maldives,SEARO,24,551,0,1
2020-05-05,MV,Maldives,SEARO,22,573,1,2
2020-05-06,MV,Maldives,SEARO,45,618,0,2
2020-05-07,MV,Maldives,SEARO,30,648,1,3
2020-05-08,MV,Maldives,SEARO,96,744,0,3
2020-05-09,MV,Maldives,SEARO,41,785,0,3
2020-05-10,MV,Maldives,SEARO,50,835,0,3
2020-05-11,MV,Maldives,SEARO,27,862,0,3
2020-05-12,MV,Maldives,SEARO,42,904,0,3
2020-05-13,MV,Maldives,SEARO,51,955,1,4
2020-05-14,MV,Maldives,SEARO,27,982,0,4
2020-05-15,MV,Maldives,SEARO,38,1020,0,4
2020-05-16,MV,Maldives,SEARO,48,1068,0,4
2020-05-17,MV,Maldives,SEARO,26,1094,0,4
2020-05-18,MV,Maldives,SEARO,12,1106,0,4
2020-05-19,MV,Maldives,SEARO,37,1143,0,4
2020-05-20,MV,Maldives,SEARO,43,1186,0,4
2020-05-21,MV,Maldives,SEARO,30,1216,0,4
2020-05-22,MV,Maldives,SEARO,58,1274,0,4
2020-05-23,MV,Maldives,SEARO,39,1313,0,4
2020-05-24,MV,Maldives,SEARO,58,1371,0,4
2020-05-25,MV,Maldives,SEARO,24,1395,0,4
2020-05-26,MV,Maldives,SEARO,43,1438,1,5
2020-05-27,MV,Maldives,SEARO,19,1457,0,5
2020-05-28,MV,Maldives,SEARO,56,1513,0,5
2020-05-29,MV,Maldives,SEARO,34,1547,0,5
2020-05-30,MV,Maldives,SEARO,86,1633,0,5
2020-05-31,MV,Maldives,SEARO,39,1672,0,5
2020-06-01,MV,Maldives,SEARO,101,1773,1,6
2020-06-02,MV,Maldives,SEARO,68,1841,1,7
2020-06-03,MV,Maldives,SEARO,9,1850,0,7
2020-06-04,MV,Maldives,SEARO,22,1872,0,7
2020-06-05,MV,Maldives,SEARO,11,1883,0,7
2020-06-06,MV,Maldives,SEARO,18,1901,1,8
2020-06-07,MV,Maldives,SEARO,2,1903,0,8
2020-06-08,MV,Maldives,SEARO,13,1916,0,8
2020-03-29,ML,Mali,AFRO,7,17,0,1
2020-03-30,ML,Mali,AFRO,0,17,1,2
2020-03-31,ML,Mali,AFRO,0,17,0,2
2020-04-01,ML,Mali,AFRO,7,24,0,2
2020-04-02,ML,Mali,AFRO,6,30,1,3
2020-04-03,ML,Mali,AFRO,6,36,0,3
2020-04-04,ML,Mali,AFRO,0,36,0,3
2020-04-05,ML,Mali,AFRO,3,39,0,3
2020-04-06,ML,Mali,AFRO,6,45,2,5
2020-04-07,ML,Mali,AFRO,2,47,0,5
2020-04-08,ML,Mali,AFRO,9,56,1,6
2020-04-09,ML,Mali,AFRO,3,59,1,7
2020-04-10,ML,Mali,AFRO,15,74,0,7
2020-04-11,ML,Mali,AFRO,13,87,0,7
2020-04-12,ML,Mali,AFRO,18,105,2,9
2020-04-13,ML,Mali,AFRO,11,116,0,9
2020-04-14,ML,Mali,AFRO,7,123,1,10
2020-04-15,ML,Mali,AFRO,21,144,3,13
2020-04-16,ML,Mali,AFRO,4,148,0,13
2020-04-17,ML,Mali,AFRO,23,171,0,13
2020-04-18,ML,Mali,AFRO,19,190,0,13
2020-04-19,ML,Mali,AFRO,26,216,0,13
2020-04-20,ML,Mali,AFRO,8,224,1,14
2020-04-21,ML,Mali,AFRO,22,246,0,14
2020-04-22,ML,Mali,AFRO,12,258,0,14
2020-04-23,ML,Mali,AFRO,51,309,3,17
2020-04-24,ML,Mali,AFRO,0,309,4,21
2020-04-25,ML,Mali,AFRO,16,325,0,21
2020-04-26,ML,Mali,AFRO,45,370,0,21
2020-04-27,ML,Mali,AFRO,19,389,2,23
2020-04-28,ML,Mali,AFRO,19,408,0,23
2020-04-29,ML,Mali,AFRO,16,424,1,24
2020-04-30,ML,Mali,AFRO,58,482,1,25
2020-05-01,ML,Mali,AFRO,8,490,1,26
2020-05-02,ML,Mali,AFRO,18,508,0,26
2020-05-03,ML,Mali,AFRO,36,544,0,26
2020-05-04,ML,Mali,AFRO,19,563,1,27
2020-05-05,ML,Mali,AFRO,17,580,2,29
2020-05-06,ML,Mali,AFRO,32,612,3,32
2020-05-07,ML,Mali,AFRO,19,631,0,32
2020-05-08,ML,Mali,AFRO,19,650,0,32
2020-05-09,ML,Mali,AFRO,18,668,3,35
2020-05-10,ML,Mali,AFRO,24,692,3,38
2020-05-11,ML,Mali,AFRO,12,704,0,38
2020-05-12,ML,Mali,AFRO,8,712,1,39
2020-05-13,ML,Mali,AFRO,18,730,1,40
2020-05-14,ML,Mali,AFRO,28,758,4,44
2020-05-15,ML,Mali,AFRO,21,779,2,46
2020-05-16,ML,Mali,AFRO,27,806,0,46
2020-05-17,ML,Mali,AFRO,29,835,2,48
2020-05-18,ML,Mali,AFRO,25,860,4,52
2020-05-19,ML,Mali,AFRO,14,874,0,52
2020-05-20,ML,Mali,AFRO,27,901,1,53
2020-05-21,ML,Mali,AFRO,30,931,2,55
2020-05-22,ML,Mali,AFRO,16,947,5,60
2020-05-23,ML,Mali,AFRO,22,969,2,62
2020-05-24,ML,Mali,AFRO,44,1013,1,63
2020-05-25,ML,Mali,AFRO,15,1028,2,65
2020-05-26,ML,Mali,AFRO,29,1057,2,67
2020-05-27,ML,Mali,AFRO,18,1075,3,70
2020-05-28,ML,Mali,AFRO,39,1114,0,70
2020-05-29,ML,Mali,AFRO,78,1192,2,72
2020-05-30,ML,Mali,AFRO,32,1224,1,73
2020-05-31,ML,Mali,AFRO,24,1248,3,76
2020-06-01,ML,Mali,AFRO,15,1263,1,77
2020-06-02,ML,Mali,AFRO,50,1313,1,78
2020-06-03,ML,Mali,AFRO,36,1349,0,78
2020-06-04,ML,Mali,AFRO,35,1384,1,79
2020-06-05,ML,Mali,AFRO,75,1459,6,85
2020-06-06,ML,Mali,AFRO,24,1483,2,87
2020-06-07,ML,Mali,AFRO,38,1521,3,90
2020-06-08,ML,Mali,AFRO,10,1531,2,92
2020-03-29,MT,Malta,EURO,2,151,0,0
2020-03-30,MT,Malta,EURO,5,156,0,0
2020-03-31,MT,Malta,EURO,13,169,0,0
2020-04-01,MT,Malta,EURO,19,188,0,0
2020-04-02,MT,Malta,EURO,7,195,0,0
2020-04-03,MT,Malta,EURO,7,202,0,0
2020-04-04,MT,Malta,EURO,11,213,0,0
2020-04-05,MT,Malta,EURO,14,227,0,0
2020-04-06,MT,Malta,EURO,14,241,0,0
2020-04-07,MT,Malta,EURO,52,293,0,0
2020-04-08,MT,Malta,EURO,6,299,1,1
2020-04-09,MT,Malta,EURO,38,337,1,2
2020-04-10,MT,Malta,EURO,13,350,0,2
2020-04-11,MT,Malta,EURO,20,370,1,3
2020-04-12,MT,Malta,EURO,8,378,0,3
2020-04-13,MT,Malta,EURO,6,384,0,3
2020-04-14,MT,Malta,EURO,9,393,0,3
2020-04-15,MT,Malta,EURO,6,399,0,3
2020-04-16,MT,Malta,EURO,13,412,0,3
2020-04-17,MT,Malta,EURO,10,422,0,3
2020-04-18,MT,Malta,EURO,4,426,0,3
2020-04-19,MT,Malta,EURO,1,427,0,3
2020-04-20,MT,Malta,EURO,4,431,0,3
2020-04-21,MT,Malta,EURO,12,443,0,3
2020-04-22,MT,Malta,EURO,1,444,0,3
2020-04-23,MT,Malta,EURO,1,445,0,3
2020-04-24,MT,Malta,EURO,2,447,0,3
2020-04-25,MT,Malta,EURO,1,448,1,4
2020-04-26,MT,Malta,EURO,0,448,0,4
2020-04-27,MT,Malta,EURO,2,450,0,4
2020-04-28,MT,Malta,EURO,8,458,0,4
2020-04-29,MT,Malta,EURO,5,463,0,4
2020-04-30,MT,Malta,EURO,2,465,0,4
2020-05-01,MT,Malta,EURO,2,467,0,4
2020-05-02,MT,Malta,EURO,1,468,0,4
2020-05-03,MT,Malta,EURO,9,477,0,4
2020-05-04,MT,Malta,EURO,3,480,0,4
2020-05-05,MT,Malta,EURO,2,482,1,5
2020-05-06,MT,Malta,EURO,2,484,0,5
2020-05-07,MT,Malta,EURO,2,486,0,5
2020-05-08,MT,Malta,EURO,3,489,0,5
2020-05-09,MT,Malta,EURO,1,490,0,5
2020-05-10,MT,Malta,EURO,6,496,0,5
2020-05-11,MT,Malta,EURO,7,503,0,5
2020-05-12,MT,Malta,EURO,3,506,0,5
2020-05-13,MT,Malta,EURO,2,508,1,6
2020-05-14,MT,Malta,EURO,14,522,0,6
2020-05-15,MT,Malta,EURO,10,532,0,6
2020-05-16,MT,Malta,EURO,14,546,0,6
2020-05-17,MT,Malta,EURO,7,553,0,6
2020-05-18,MT,Malta,EURO,5,558,0,6
2020-05-19,MT,Malta,EURO,11,569,0,6
2020-05-20,MT,Malta,EURO,15,584,0,6
2020-05-21,MT,Malta,EURO,15,599,0,6
2020-05-22,MT,Malta,EURO,1,600,0,6
2020-05-23,MT,Malta,EURO,9,609,0,6
2020-05-24,MT,Malta,EURO,1,610,0,6
2020-05-25,MT,Malta,EURO,1,611,0,6
2020-05-26,MT,Malta,EURO,0,611,0,6
2020-05-27,MT,Malta,EURO,1,612,1,7
2020-05-28,MT,Malta,EURO,4,616,0,7
2020-05-29,MT,Malta,EURO,0,616,1,8
2020-05-30,MT,Malta,EURO,2,618,1,9
2020-05-31,MT,Malta,EURO,0,618,0,9
2020-06-01,MT,Malta,EURO,1,619,0,9
2020-06-02,MT,Malta,EURO,1,620,0,9
2020-06-03,MT,Malta,EURO,2,622,0,9
2020-06-04,MT,Malta,EURO,0,622,0,9
2020-06-05,MT,Malta,EURO,3,625,0,9
2020-06-06,MT,Malta,EURO,2,627,0,9
2020-06-07,MT,Malta,EURO,2,629,0,9
2020-06-08,MT,Malta,EURO,1,630,0,9
2020-03-29,MH,Marshall Islands,WPRO,0,0,0,0
2020-03-30,MH,Marshall Islands,WPRO,0,0,0,0
2020-03-31,MH,Marshall Islands,WPRO,0,0,0,0
2020-04-01,MH,Marshall Islands,WPRO,0,0,0,0
2020-04-02,MH,Marshall Islands,WPRO,0,0,0,0
2020-04-03,MH,Marshall Islands,WPRO,0,0,0,0
2020-04-04,MH,Marshall Islands,WPRO,0,0,0,0
2020-04-05,MH,Marshall Islands,WPRO,0,0,0,0
2020-04-06,MH,Marshall Islands,WPRO,0,0,0,0
2020-04-07,MH,Marshall Islands,WPRO,0,0,0,0
2020-04-08,MH,Marshall Islands,WPRO,0,0,0,0
2020-04-09,MH,Marshall Islands,WPRO,0,0,0,0
2020-04-10,MH,Marshall Islands,WPRO,0,0,0,0
2020-04-11,MH,Marshall Islands,WPRO,0,0,0,0
2020-04-12,MH,Marshall Islands,WPRO,0,0,0,0
2020-04-13,MH,Marshall Islands,WPRO,0,0,0,0
2020-04-14,MH,Marshall Islands,WPRO,0,0,0,0
2020-04-15,MH,Marshall Islands,WPRO,0,0,0,0
2020-04-16,MH,Marshall Islands,WPRO,0,0,0,0
2020-04-17,MH,Marshall Islands,WPRO,0,0,0,0
2020-04-18,MH,Marshall Islands,WPRO,0,0,0,0
2020-04-19,MH,Marshall Islands,WPRO,0,0,0,0
2020-04-20,MH,Marshall Islands,WPRO,0,0,0,0
2020-04-21,MH,Marshall Islands,WPRO,0,0,0,0
2020-04-22,MH,Marshall Islands,WPRO,0,0,0,0
2020-04-23,MH,Marshall Islands,WPRO,0,0,0,0
2020-04-24,MH,Marshall Islands,WPRO,0,0,0,0
2020-04-25,MH,Marshall Islands,WPRO,0,0,0,0
2020-04-26,MH,Marshall Islands,WPRO,0,0,0,0
2020-04-27,MH,Marshall Islands,WPRO,0,0,0,0
2020-04-28,MH,Marshall Islands,WPRO,0,0,0,0
2020-04-29,MH,Marshall Islands,WPRO,0,0,0,0
2020-04-30,MH,Marshall Islands,WPRO,0,0,0,0
2020-05-01,MH,Marshall Islands,WPRO,0,0,0,0
2020-05-02,MH,Marshall Islands,WPRO,0,0,0,0
2020-05-03,MH,Marshall Islands,WPRO,0,0,0,0
2020-05-04,MH,Marshall Islands,WPRO,0,0,0,0
2020-05-05,MH,Marshall Islands,WPRO,0,0,0,0
2020-05-06,MH,Marshall Islands,WPRO,0,0,0,0
2020-05-07,MH,Marshall Islands,WPRO,0,0,0,0
2020-05-08,MH,Marshall Islands,WPRO,0,0,0,0
2020-05-09,MH,Marshall Islands,WPRO,0,0,0,0
2020-05-10,MH,Marshall Islands,WPRO,0,0,0,0
2020-05-11,MH,Marshall Islands,WPRO,0,0,0,0
2020-05-12,MH,Marshall Islands,WPRO,0,0,0,0
2020-05-13,MH,Marshall Islands,WPRO,0,0,0,0
2020-05-14,MH,Marshall Islands,WPRO,0,0,0,0
2020-05-15,MH,Marshall Islands,WPRO,0,0,0,0
2020-05-16,MH,Marshall Islands,WPRO,0,0,0,0
2020-05-17,MH,Marshall Islands,WPRO,0,0,0,0
2020-05-18,MH,Marshall Islands,WPRO,0,0,0,0
2020-05-19,MH,Marshall Islands,WPRO,0,0,0,0
2020-05-20,MH,Marshall Islands,WPRO,0,0,0,0
2020-05-21,MH,Marshall Islands,WPRO,0,0,0,0
2020-05-22,MH,Marshall Islands,WPRO,0,0,0,0
2020-05-23,MH,Marshall Islands,WPRO,0,0,0,0
2020-05-24,MH,Marshall Islands,WPRO,0,0,0,0
2020-05-25,MH,Marshall Islands,WPRO,0,0,0,0
2020-05-26,MH,Marshall Islands,WPRO,0,0,0,0
2020-05-27,MH,Marshall Islands,WPRO,0,0,0,0
2020-05-28,MH,Marshall Islands,WPRO,0,0,0,0
2020-05-29,MH,Marshall Islands,WPRO,0,0,0,0
2020-05-30,MH,Marshall Islands,WPRO,0,0,0,0
2020-05-31,MH,Marshall Islands,WPRO,0,0,0,0
2020-06-01,MH,Marshall Islands,WPRO,0,0,0,0
2020-06-02,MH,Marshall Islands,WPRO,0,0,0,0
2020-06-03,MH,Marshall Islands,WPRO,0,0,0,0
2020-06-04,MH,Marshall Islands,WPRO,0,0,0,0
2020-06-05,MH,Marshall Islands,WPRO,0,0,0,0
2020-06-06,MH,Marshall Islands,WPRO,0,0,0,0
2020-06-07,MH,Marshall Islands,WPRO,0,0,0,0
2020-06-08,MH,Marshall Islands,WPRO,0,0,0,0
2020-03-29,MQ,Martinique,AMRO,0,93,0,1
2020-03-30,MQ,Martinique,AMRO,12,105,1,2
2020-03-31,MQ,Martinique,AMRO,6,111,0,2
2020-04-01,MQ,Martinique,AMRO,8,119,0,2
2020-04-02,MQ,Martinique,AMRO,9,128,1,3
2020-04-03,MQ,Martinique,AMRO,3,131,0,3
2020-04-04,MQ,Martinique,AMRO,7,138,0,3
2020-04-05,MQ,Martinique,AMRO,7,145,0,3
2020-04-06,MQ,Martinique,AMRO,0,145,0,3
2020-04-07,MQ,Martinique,AMRO,4,149,1,4
2020-04-08,MQ,Martinique,AMRO,2,151,0,4
2020-04-09,MQ,Martinique,AMRO,1,152,0,4
2020-04-10,MQ,Martinique,AMRO,2,154,2,6
2020-04-11,MQ,Martinique,AMRO,0,154,0,6
2020-04-12,MQ,Martinique,AMRO,1,155,0,6
2020-04-13,MQ,Martinique,AMRO,1,156,0,6
2020-04-14,MQ,Martinique,AMRO,1,157,2,8
2020-04-15,MQ,Martinique,AMRO,0,157,0,8
2020-04-16,MQ,Martinique,AMRO,1,158,0,8
2020-04-17,MQ,Martinique,AMRO,1,159,0,8
2020-04-18,MQ,Martinique,AMRO,0,159,0,8
2020-04-19,MQ,Martinique,AMRO,4,163,4,12
2020-04-20,MQ,Martinique,AMRO,0,163,0,12
2020-04-21,MQ,Martinique,AMRO,0,163,2,14
2020-04-22,MQ,Martinique,AMRO,0,163,0,14
2020-04-23,MQ,Martinique,AMRO,1,164,0,14
2020-04-24,MQ,Martinique,AMRO,6,170,0,14
2020-04-25,MQ,Martinique,AMRO,0,170,0,14
2020-04-26,MQ,Martinique,AMRO,0,170,0,14
2020-04-27,MQ,Martinique,AMRO,5,175,0,14
2020-04-28,MQ,Martinique,AMRO,0,175,0,14
2020-04-29,MQ,Martinique,AMRO,0,175,0,14
2020-04-30,MQ,Martinique,AMRO,0,175,0,14
2020-05-01,MQ,Martinique,AMRO,3,178,0,14
2020-05-02,MQ,Martinique,AMRO,1,179,0,14
2020-05-03,MQ,Martinique,AMRO,1,180,0,14
2020-05-04,MQ,Martinique,AMRO,1,181,0,14
2020-05-05,MQ,Martinique,AMRO,0,181,0,14
2020-05-06,MQ,Martinique,AMRO,0,181,0,14
2020-05-07,MQ,Martinique,AMRO,1,182,0,14
2020-05-08,MQ,Martinique,AMRO,0,182,0,14
2020-05-09,MQ,Martinique,AMRO,1,183,0,14
2020-05-10,MQ,Martinique,AMRO,3,186,0,14
2020-05-11,MQ,Martinique,AMRO,1,187,0,14
2020-05-12,MQ,Martinique,AMRO,0,187,0,14
2020-05-13,MQ,Martinique,AMRO,0,187,0,14
2020-05-14,MQ,Martinique,AMRO,2,189,0,14
2020-05-15,MQ,Martinique,AMRO,0,189,0,14
2020-05-16,MQ,Martinique,AMRO,0,189,0,14
2020-05-17,MQ,Martinique,AMRO,3,192,0,14
2020-05-18,MQ,Martinique,AMRO,0,192,0,14
2020-05-19,MQ,Martinique,AMRO,0,192,0,14
2020-05-20,MQ,Martinique,AMRO,0,192,0,14
2020-05-21,MQ,Martinique,AMRO,0,192,0,14
2020-05-22,MQ,Martinique,AMRO,0,192,0,14
2020-05-23,MQ,Martinique,AMRO,5,197,0,14
2020-05-24,MQ,Martinique,AMRO,0,197,0,14
2020-05-25,MQ,Martinique,AMRO,0,197,0,14
2020-05-26,MQ,Martinique,AMRO,0,197,0,14
2020-05-27,MQ,Martinique,AMRO,0,197,0,14
2020-05-28,MQ,Martinique,AMRO,0,197,0,14
2020-05-29,MQ,Martinique,AMRO,0,197,0,14
2020-05-30,MQ,Martinique,AMRO,0,197,0,14
2020-05-31,MQ,Martinique,AMRO,3,200,0,14
2020-06-01,MQ,Martinique,AMRO,0,200,0,14
2020-06-02,MQ,Martinique,AMRO,0,200,0,14
2020-06-03,MQ,Martinique,AMRO,0,200,0,14
2020-06-04,MQ,Martinique,AMRO,0,200,0,14
2020-06-05,MQ,Martinique,AMRO,0,200,0,14
2020-06-06,MQ,Martinique,AMRO,0,200,0,14
2020-06-07,MQ,Martinique,AMRO,2,202,0,14
2020-06-08,MQ,Martinique,AMRO,0,202,0,14
2020-03-29,MR,Mauritania,AFRO,2,5,0,149
2020-03-30,MR,Mauritania,AFRO,0,5,0,149
2020-03-31,MR,Mauritania,AFRO,0,5,0,149
2020-04-01,MR,Mauritania,AFRO,0,5,0,149
2020-04-02,MR,Mauritania,AFRO,1,6,0,149
2020-04-03,MR,Mauritania,AFRO,0,6,0,149
2020-04-04,MR,Mauritania,AFRO,0,6,0,149
2020-04-05,MR,Mauritania,AFRO,0,6,0,149
2020-04-06,MR,Mauritania,AFRO,0,6,0,149
2020-04-07,MR,Mauritania,AFRO,0,6,0,149
2020-04-08,MR,Mauritania,AFRO,0,6,0,149
2020-04-09,MR,Mauritania,AFRO,0,6,0,149
2020-04-10,MR,Mauritania,AFRO,1,7,0,149
2020-04-11,MR,Mauritania,AFRO,0,7,0,149
2020-04-12,MR,Mauritania,AFRO,0,7,0,149
2020-04-13,MR,Mauritania,AFRO,0,7,0,149
2020-04-14,MR,Mauritania,AFRO,0,7,0,149
2020-04-15,MR,Mauritania,AFRO,0,7,0,149
2020-04-16,MR,Mauritania,AFRO,0,7,0,149
2020-04-17,MR,Mauritania,AFRO,0,7,0,149
2020-04-18,MR,Mauritania,AFRO,0,7,0,149
2020-04-19,MR,Mauritania,AFRO,0,7,0,149
2020-04-20,MR,Mauritania,AFRO,0,7,0,149
2020-04-21,MR,Mauritania,AFRO,0,7,0,149
2020-04-22,MR,Mauritania,AFRO,0,7,0,149
2020-04-23,MR,Mauritania,AFRO,0,7,0,149
2020-04-24,MR,Mauritania,AFRO,0,7,0,149
2020-04-25,MR,Mauritania,AFRO,0,7,0,149
2020-04-26,MR,Mauritania,AFRO,0,7,0,149
2020-04-27,MR,Mauritania,AFRO,0,7,0,149
2020-04-28,MR,Mauritania,AFRO,0,7,0,149
2020-04-29,MR,Mauritania,AFRO,0,7,0,149
2020-04-30,MR,Mauritania,AFRO,1,8,0,149
2020-05-01,MR,Mauritania,AFRO,0,8,0,149
2020-05-02,MR,Mauritania,AFRO,0,8,0,149
2020-05-03,MR,Mauritania,AFRO,0,8,0,149
2020-05-04,MR,Mauritania,AFRO,0,8,0,149
2020-05-05,MR,Mauritania,AFRO,0,8,0,149
2020-05-06,MR,Mauritania,AFRO,0,8,0,149
2020-05-07,MR,Mauritania,AFRO,0,8,0,149
2020-05-08,MR,Mauritania,AFRO,0,8,0,149
2020-05-09,MR,Mauritania,AFRO,0,8,0,149
2020-05-10,MR,Mauritania,AFRO,0,8,0,149
2020-05-11,MR,Mauritania,AFRO,0,8,0,149
2020-05-12,MR,Mauritania,AFRO,0,8,0,149
2020-05-13,MR,Mauritania,AFRO,0,8,0,149
2020-05-14,MR,Mauritania,AFRO,8,16,0,149
2020-05-15,MR,Mauritania,AFRO,0,16,0,149
2020-05-16,MR,Mauritania,AFRO,13,29,0,149
2020-05-17,MR,Mauritania,AFRO,11,40,0,149
2020-05-18,MR,Mauritania,AFRO,22,62,0,149
2020-05-19,MR,Mauritania,AFRO,19,81,0,149
2020-05-20,MR,Mauritania,AFRO,50,131,0,149
2020-05-21,MR,Mauritania,AFRO,10,141,0,149
2020-05-22,MR,Mauritania,AFRO,32,173,4,153
2020-05-23,MR,Mauritania,AFRO,0,173,0,153
2020-05-24,MR,Mauritania,AFRO,54,227,1,154
2020-05-25,MR,Mauritania,AFRO,10,237,0,154
2020-05-26,MR,Mauritania,AFRO,25,262,3,157
2020-05-27,MR,Mauritania,AFRO,0,262,4,161
2020-05-28,MR,Mauritania,AFRO,30,292,3,164
2020-05-29,MR,Mauritania,AFRO,54,346,3,167
2020-05-30,MR,Mauritania,AFRO,77,423,1,168
2020-05-31,MR,Mauritania,AFRO,60,483,3,171
2020-06-01,MR,Mauritania,AFRO,47,530,0,171
2020-06-02,MR,Mauritania,AFRO,58,588,3,174
2020-06-03,MR,Mauritania,AFRO,80,668,5,179
2020-06-04,MR,Mauritania,AFRO,77,745,5,184
2020-06-05,MR,Mauritania,AFRO,39,784,3,187
2020-06-06,MR,Mauritania,AFRO,99,883,4,191
2020-06-07,MR,Mauritania,AFRO,64,947,6,197
2020-06-08,MR,Mauritania,AFRO,102,1049,6,203
2020-03-29,MU,Mauritius,AFRO,8,102,0,2
2020-03-30,MU,Mauritius,AFRO,5,107,0,2
2020-03-31,MU,Mauritius,AFRO,18,125,1,3
2020-04-01,MU,Mauritius,AFRO,18,143,2,5
2020-04-02,MU,Mauritius,AFRO,11,154,0,5
2020-04-03,MU,Mauritius,AFRO,17,171,2,7
2020-04-04,MU,Mauritius,AFRO,15,186,0,7
2020-04-05,MU,Mauritius,AFRO,10,196,0,7
2020-04-06,MU,Mauritius,AFRO,31,227,0,7
2020-04-07,MU,Mauritius,AFRO,17,244,0,7
2020-04-08,MU,Mauritius,AFRO,24,268,0,7
2020-04-09,MU,Mauritius,AFRO,5,273,0,7
2020-04-10,MU,Mauritius,AFRO,41,314,0,7
2020-04-11,MU,Mauritius,AFRO,4,318,2,9
2020-04-12,MU,Mauritius,AFRO,1,319,0,9
2020-04-13,MU,Mauritius,AFRO,5,324,0,9
2020-04-14,MU,Mauritius,AFRO,0,324,0,9
2020-04-15,MU,Mauritius,AFRO,0,324,0,9
2020-04-16,MU,Mauritius,AFRO,0,324,0,9
2020-04-17,MU,Mauritius,AFRO,0,324,0,9
2020-04-18,MU,Mauritius,AFRO,0,324,0,9
2020-04-19,MU,Mauritius,AFRO,1,325,0,9
2020-04-20,MU,Mauritius,AFRO,3,328,0,9
2020-04-21,MU,Mauritius,AFRO,0,328,0,9
2020-04-22,MU,Mauritius,AFRO,0,328,0,9
2020-04-23,MU,Mauritius,AFRO,1,329,0,9
2020-04-24,MU,Mauritius,AFRO,2,331,0,9
2020-04-25,MU,Mauritius,AFRO,0,331,0,9
2020-04-26,MU,Mauritius,AFRO,0,331,0,9
2020-04-27,MU,Mauritius,AFRO,1,332,0,9
2020-04-28,MU,Mauritius,AFRO,0,332,0,9
2020-04-29,MU,Mauritius,AFRO,0,332,1,10
2020-04-30,MU,Mauritius,AFRO,0,332,0,10
2020-05-01,MU,Mauritius,AFRO,0,332,0,10
2020-05-02,MU,Mauritius,AFRO,0,332,0,10
2020-05-03,MU,Mauritius,AFRO,0,332,0,10
2020-05-04,MU,Mauritius,AFRO,0,332,0,10
2020-05-05,MU,Mauritius,AFRO,0,332,0,10
2020-05-06,MU,Mauritius,AFRO,0,332,0,10
2020-05-07,MU,Mauritius,AFRO,0,332,0,10
2020-05-08,MU,Mauritius,AFRO,0,332,0,10
2020-05-09,MU,Mauritius,AFRO,0,332,0,10
2020-05-10,MU,Mauritius,AFRO,0,332,0,10
2020-05-11,MU,Mauritius,AFRO,0,332,0,10
2020-05-12,MU,Mauritius,AFRO,0,332,0,10
2020-05-13,MU,Mauritius,AFRO,0,332,0,10
2020-05-14,MU,Mauritius,AFRO,0,332,0,10
2020-05-15,MU,Mauritius,AFRO,0,332,0,10
2020-05-16,MU,Mauritius,AFRO,0,332,0,10
2020-05-17,MU,Mauritius,AFRO,0,332,0,10
2020-05-18,MU,Mauritius,AFRO,0,332,0,10
2020-05-19,MU,Mauritius,AFRO,0,332,0,10
2020-05-20,MU,Mauritius,AFRO,0,332,0,10
2020-05-21,MU,Mauritius,AFRO,0,332,0,10
2020-05-22,MU,Mauritius,AFRO,0,332,0,10
2020-05-23,MU,Mauritius,AFRO,0,332,0,10
2020-05-24,MU,Mauritius,AFRO,0,332,0,10
2020-05-25,MU,Mauritius,AFRO,2,334,0,10
2020-05-26,MU,Mauritius,AFRO,0,334,0,10
2020-05-27,MU,Mauritius,AFRO,0,334,0,10
2020-05-28,MU,Mauritius,AFRO,0,334,0,10
2020-05-29,MU,Mauritius,AFRO,0,334,0,10
2020-05-30,MU,Mauritius,AFRO,1,335,0,10
2020-05-31,MU,Mauritius,AFRO,0,335,0,10
2020-06-01,MU,Mauritius,AFRO,0,335,0,10
2020-06-02,MU,Mauritius,AFRO,0,335,0,10
2020-06-03,MU,Mauritius,AFRO,0,335,0,10
2020-06-04,MU,Mauritius,AFRO,0,335,0,10
2020-06-05,MU,Mauritius,AFRO,0,335,0,10
2020-06-06,MU,Mauritius,AFRO,2,337,0,10
2020-06-07,MU,Mauritius,AFRO,0,337,0,10
2020-06-08,MU,Mauritius,AFRO,0,337,0,10
2020-03-29,YT,Mayotte,AFRO,0,50,0,0
2020-03-30,YT,Mayotte,AFRO,32,82,0,0
2020-03-31,YT,Mayotte,AFRO,0,82,0,0
2020-04-01,YT,Mayotte,AFRO,19,101,0,0
2020-04-02,YT,Mayotte,AFRO,15,116,2,2
2020-04-03,YT,Mayotte,AFRO,12,128,0,2
2020-04-04,YT,Mayotte,AFRO,0,128,0,2
2020-04-05,YT,Mayotte,AFRO,19,147,0,2
2020-04-06,YT,Mayotte,AFRO,0,147,0,2
2020-04-07,YT,Mayotte,AFRO,17,164,0,2
2020-04-08,YT,Mayotte,AFRO,20,184,0,2
2020-04-09,YT,Mayotte,AFRO,2,186,0,2
2020-04-10,YT,Mayotte,AFRO,5,191,0,2
2020-04-11,YT,Mayotte,AFRO,0,191,0,2
2020-04-12,YT,Mayotte,AFRO,0,191,0,2
2020-04-13,YT,Mayotte,AFRO,16,207,1,3
2020-04-14,YT,Mayotte,AFRO,0,207,0,3
2020-04-15,YT,Mayotte,AFRO,10,217,0,3
2020-04-16,YT,Mayotte,AFRO,4,221,0,3
2020-04-17,YT,Mayotte,AFRO,12,233,0,3
2020-04-18,YT,Mayotte,AFRO,12,245,1,4
2020-04-19,YT,Mayotte,AFRO,0,245,0,4
2020-04-20,YT,Mayotte,AFRO,39,284,0,4
2020-04-21,YT,Mayotte,AFRO,0,284,0,4
2020-04-22,YT,Mayotte,AFRO,27,311,0,4
2020-04-23,YT,Mayotte,AFRO,15,326,0,4
2020-04-24,YT,Mayotte,AFRO,13,339,0,4
2020-04-25,YT,Mayotte,AFRO,15,354,0,4
2020-04-26,YT,Mayotte,AFRO,0,354,0,4
2020-04-27,YT,Mayotte,AFRO,47,401,0,4
2020-04-28,YT,Mayotte,AFRO,32,433,0,4
2020-04-29,YT,Mayotte,AFRO,27,460,0,4
2020-04-30,YT,Mayotte,AFRO,0,460,0,4
2020-05-01,YT,Mayotte,AFRO,79,539,0,4
2020-05-02,YT,Mayotte,AFRO,0,539,0,4
2020-05-03,YT,Mayotte,AFRO,57,596,2,6
2020-05-04,YT,Mayotte,AFRO,54,650,0,6
2020-05-05,YT,Mayotte,AFRO,36,686,0,6
2020-05-06,YT,Mayotte,AFRO,53,739,3,9
2020-05-07,YT,Mayotte,AFRO,0,739,0,9
2020-05-08,YT,Mayotte,AFRO,115,854,1,10
2020-05-09,YT,Mayotte,AFRO,36,890,1,11
2020-05-10,YT,Mayotte,AFRO,0,890,0,11
2020-05-11,YT,Mayotte,AFRO,133,1023,0,11
2020-05-12,YT,Mayotte,AFRO,38,1061,1,12
2020-05-13,YT,Mayotte,AFRO,34,1095,0,12
2020-05-14,YT,Mayotte,AFRO,48,1143,2,14
2020-05-15,YT,Mayotte,AFRO,67,1210,2,16
2020-05-16,YT,Mayotte,AFRO,48,1258,0,16
2020-05-17,YT,Mayotte,AFRO,0,1258,0,16
2020-05-18,YT,Mayotte,AFRO,84,1342,2,18
2020-05-19,YT,Mayotte,AFRO,28,1370,0,18
2020-05-20,YT,Mayotte,AFRO,49,1419,1,19
2020-05-21,YT,Mayotte,AFRO,56,1475,0,19
2020-05-22,YT,Mayotte,AFRO,19,1494,0,19
2020-05-23,YT,Mayotte,AFRO,27,1521,0,19
2020-05-24,YT,Mayotte,AFRO,0,1521,0,19
2020-05-25,YT,Mayotte,AFRO,66,1587,1,20
2020-05-26,YT,Mayotte,AFRO,22,1609,0,20
2020-05-27,YT,Mayotte,AFRO,25,1634,0,20
2020-05-28,YT,Mayotte,AFRO,11,1645,0,20
2020-05-29,YT,Mayotte,AFRO,25,1670,1,21
2020-05-30,YT,Mayotte,AFRO,29,1699,0,21
2020-05-31,YT,Mayotte,AFRO,44,1743,0,21
2020-06-01,YT,Mayotte,AFRO,128,1871,2,23
2020-06-02,YT,Mayotte,AFRO,63,1934,1,24
2020-06-03,YT,Mayotte,AFRO,52,1986,0,24
2020-06-04,YT,Mayotte,AFRO,7,1993,0,24
2020-06-05,YT,Mayotte,AFRO,65,2058,1,25
2020-06-06,YT,Mayotte,AFRO,21,2079,0,25
2020-06-07,YT,Mayotte,AFRO,0,2079,0,25
2020-06-08,YT,Mayotte,AFRO,0,2079,0,25
2020-03-29,MX,Mexico,AMRO,262,2117,8,28
2020-03-30,MX,Mexico,AMRO,191,2308,15,43
2020-03-31,MX,Mexico,AMRO,166,2474,9,52
2020-04-01,MX,Mexico,AMRO,345,2819,14,66
2020-04-02,MX,Mexico,AMRO,311,3130,26,92
2020-04-03,MX,Mexico,AMRO,382,3512,22,114
2020-04-04,MX,Mexico,AMRO,347,3859,26,140
2020-04-05,MX,Mexico,AMRO,392,4251,34,174
2020-04-06,MX,Mexico,AMRO,250,4501,40,214
2020-04-07,MX,Mexico,AMRO,259,4760,33,247
2020-04-08,MX,Mexico,AMRO,631,5391,58,305
2020-04-09,MX,Mexico,AMRO,515,5906,62,367
2020-04-10,MX,Mexico,AMRO,581,6487,49,416
2020-04-11,MX,Mexico,AMRO,483,6970,62,478
2020-04-12,MX,Mexico,AMRO,572,7542,78,556
2020-04-13,MX,Mexico,AMRO,464,8006,81,637
2020-04-14,MX,Mexico,AMRO,479,8485,88,725
2020-04-15,MX,Mexico,AMRO,953,9438,102,827
2020-04-16,MX,Mexico,AMRO,936,10374,114,941
2020-04-17,MX,Mexico,AMRO,985,11359,115,1056
2020-04-18,MX,Mexico,AMRO,996,12355,107,1163
2020-04-19,MX,Mexico,AMRO,1145,13500,142,1305
2020-04-20,MX,Mexico,AMRO,815,14315,137,1442
2020-04-21,MX,Mexico,AMRO,794,15109,181,1623
2020-04-22,MX,Mexico,AMRO,1521,16630,211,1834
2020-04-23,MX,Mexico,AMRO,1471,18101,215,2049
2020-04-24,MX,Mexico,AMRO,1423,19524,216,2265
2020-04-25,MX,Mexico,AMRO,1506,21030,230,2495
2020-04-26,MX,Mexico,AMRO,1734,22764,263,2758
2020-04-27,MX,Mexico,AMRO,1164,23928,290,3048
2020-04-28,MX,Mexico,AMRO,1117,25045,310,3358
2020-04-29,MX,Mexico,AMRO,1942,26987,285,3643
2020-04-30,MX,Mexico,AMRO,1961,28948,326,3969
2020-05-01,MX,Mexico,AMRO,1948,30896,386,4355
2020-05-02,MX,Mexico,AMRO,1884,32780,354,4709
2020-05-03,MX,Mexico,AMRO,1555,34335,410,5119
2020-05-04,MX,Mexico,AMRO,1493,35828,358,5477
2020-05-05,MX,Mexico,AMRO,1377,37205,369,5846
2020-05-06,MX,Mexico,AMRO,2642,39847,461,6307
2020-05-07,MX,Mexico,AMRO,2234,42081,449,6756
2020-05-08,MX,Mexico,AMRO,2389,44470,414,7170
2020-05-09,MX,Mexico,AMRO,2531,47001,403,7573
2020-05-10,MX,Mexico,AMRO,2530,49531,439,8012
2020-05-11,MX,Mexico,AMRO,1657,51188,418,8430
2020-05-12,MX,Mexico,AMRO,1552,52740,457,8887
2020-05-13,MX,Mexico,AMRO,3118,55858,460,9347
2020-05-14,MX,Mexico,AMRO,3070,58928,487,9834
2020-05-15,MX,Mexico,AMRO,3230,62158,490,10324
2020-05-16,MX,Mexico,AMRO,3217,65375,546,10870
2020-05-17,MX,Mexico,AMRO,3694,69069,556,11426
2020-05-18,MX,Mexico,AMRO,2270,71339,534,11960
2020-05-19,MX,Mexico,AMRO,1739,73078,587,12547
2020-05-20,MX,Mexico,AMRO,4181,77259,591,13138
2020-05-21,MX,Mexico,AMRO,3710,80969,579,13717
2020-05-22,MX,Mexico,AMRO,4052,85021,571,14288
2020-05-23,MX,Mexico,AMRO,4103,89124,572,14860
2020-05-24,MX,Mexico,AMRO,4132,93256,560,15420
2020-05-25,MX,Mexico,AMRO,2416,95672,539,15959
2020-05-26,MX,Mexico,AMRO,2002,97674,608,16567
2020-05-27,MX,Mexico,AMRO,4788,102462,628,17195
2020-05-28,MX,Mexico,AMRO,4423,106885,611,17806
2020-05-29,MX,Mexico,AMRO,4566,111451,594,18400
2020-05-30,MX,Mexico,AMRO,4310,115761,623,19023
2020-05-31,MX,Mexico,AMRO,4468,120229,575,19598
2020-06-01,MX,Mexico,AMRO,2822,123051,609,20207
2020-06-02,MX,Mexico,AMRO,2199,125250,634,20841
2020-06-03,MX,Mexico,AMRO,5453,130703,691,21532
2020-06-04,MX,Mexico,AMRO,4837,135540,649,22181
2020-06-05,MX,Mexico,AMRO,5073,140613,676,22857
2020-06-06,MX,Mexico,AMRO,5013,145626,656,23513
2020-06-07,MX,Mexico,AMRO,5159,150785,597,24110
2020-06-08,MX,Mexico,AMRO,3149,153934,667,24777
2020-03-29,FM,Micronesia (Federated States of),WPRO,0,0,0,0
2020-03-30,FM,Micronesia (Federated States of),WPRO,0,0,0,0
2020-03-31,FM,Micronesia (Federated States of),WPRO,0,0,0,0
2020-04-01,FM,Micronesia (Federated States of),WPRO,0,0,0,0
2020-04-02,FM,Micronesia (Federated States of),WPRO,0,0,0,0
2020-04-03,FM,Micronesia (Federated States of),WPRO,0,0,0,0
2020-04-04,FM,Micronesia (Federated States of),WPRO,0,0,0,0
2020-04-05,FM,Micronesia (Federated States of),WPRO,0,0,0,0
2020-04-06,FM,Micronesia (Federated States of),WPRO,0,0,0,0
2020-04-07,FM,Micronesia (Federated States of),WPRO,0,0,0,0
2020-04-08,FM,Micronesia (Federated States of),WPRO,0,0,0,0
2020-04-09,FM,Micronesia (Federated States of),WPRO,0,0,0,0
2020-04-10,FM,Micronesia (Federated States of),WPRO,0,0,0,0
2020-04-11,FM,Micronesia (Federated States of),WPRO,0,0,0,0
2020-04-12,FM,Micronesia (Federated States of),WPRO,0,0,0,0
2020-04-13,FM,Micronesia (Federated States of),WPRO,0,0,0,0
2020-04-14,FM,Micronesia (Federated States of),WPRO,0,0,0,0
2020-04-15,FM,Micronesia (Federated States of),WPRO,0,0,0,0
2020-04-16,FM,Micronesia (Federated States of),WPRO,0,0,0,0
2020-04-17,FM,Micronesia (Federated States of),WPRO,0,0,0,0
2020-04-18,FM,Micronesia (Federated States of),WPRO,0,0,0,0
2020-04-19,FM,Micronesia (Federated States of),WPRO,0,0,0,0
2020-04-20,FM,Micronesia (Federated States of),WPRO,0,0,0,0
2020-04-21,FM,Micronesia (Federated States of),WPRO,0,0,0,0
2020-04-22,FM,Micronesia (Federated States of),WPRO,0,0,0,0
2020-04-23,FM,Micronesia (Federated States of),WPRO,0,0,0,0
2020-04-24,FM,Micronesia (Federated States of),WPRO,0,0,0,0
2020-04-25,FM,Micronesia (Federated States of),WPRO,0,0,0,0
2020-04-26,FM,Micronesia (Federated States of),WPRO,0,0,0,0
2020-04-27,FM,Micronesia (Federated States of),WPRO,0,0,0,0
2020-04-28,FM,Micronesia (Federated States of),WPRO,0,0,0,0
2020-04-29,FM,Micronesia (Federated States of),WPRO,0,0,0,0
2020-04-30,FM,Micronesia (Federated States of),WPRO,0,0,0,0
2020-05-01,FM,Micronesia (Federated States of),WPRO,0,0,0,0
2020-05-02,FM,Micronesia (Federated States of),WPRO,0,0,0,0
2020-05-03,FM,Micronesia (Federated States of),WPRO,0,0,0,0
2020-05-04,FM,Micronesia (Federated States of),WPRO,0,0,0,0
2020-05-05,FM,Micronesia (Federated States of),WPRO,0,0,0,0
2020-05-06,FM,Micronesia (Federated States of),WPRO,0,0,0,0
2020-05-07,FM,Micronesia (Federated States of),WPRO,0,0,0,0
2020-05-08,FM,Micronesia (Federated States of),WPRO,0,0,0,0
2020-05-09,FM,Micronesia (Federated States of),WPRO,0,0,0,0
2020-05-10,FM,Micronesia (Federated States of),WPRO,0,0,0,0
2020-05-11,FM,Micronesia (Federated States of),WPRO,0,0,0,0
2020-05-12,FM,Micronesia (Federated States of),WPRO,0,0,0,0
2020-05-13,FM,Micronesia (Federated States of),WPRO,0,0,0,0
2020-05-14,FM,Micronesia (Federated States of),WPRO,0,0,0,0
2020-05-15,FM,Micronesia (Federated States of),WPRO,0,0,0,0
2020-05-16,FM,Micronesia (Federated States of),WPRO,0,0,0,0
2020-05-17,FM,Micronesia (Federated States of),WPRO,0,0,0,0
2020-05-18,FM,Micronesia (Federated States of),WPRO,0,0,0,0
2020-05-19,FM,Micronesia (Federated States of),WPRO,0,0,0,0
2020-05-20,FM,Micronesia (Federated States of),WPRO,0,0,0,0
2020-05-21,FM,Micronesia (Federated States of),WPRO,0,0,0,0
2020-05-22,FM,Micronesia (Federated States of),WPRO,0,0,0,0
2020-05-23,FM,Micronesia (Federated States of),WPRO,0,0,0,0
2020-05-24,FM,Micronesia (Federated States of),WPRO,0,0,0,0
2020-05-25,FM,Micronesia (Federated States of),WPRO,0,0,0,0
2020-05-26,FM,Micronesia (Federated States of),WPRO,0,0,0,0
2020-05-27,FM,Micronesia (Federated States of),WPRO,0,0,0,0
2020-05-28,FM,Micronesia (Federated States of),WPRO,0,0,0,0
2020-05-29,FM,Micronesia (Federated States of),WPRO,0,0,0,0
2020-05-30,FM,Micronesia (Federated States of),WPRO,0,0,0,0
2020-05-31,FM,Micronesia (Federated States of),WPRO,0,0,0,0
2020-06-01,FM,Micronesia (Federated States of),WPRO,0,0,0,0
2020-06-02,FM,Micronesia (Federated States of),WPRO,0,0,0,0
2020-06-03,FM,Micronesia (Federated States of),WPRO,0,0,0,0
2020-06-04,FM,Micronesia (Federated States of),WPRO,0,0,0,0
2020-06-05,FM,Micronesia (Federated States of),WPRO,0,0,0,0
2020-06-06,FM,Micronesia (Federated States of),WPRO,0,0,0,0
2020-06-07,FM,Micronesia (Federated States of),WPRO,0,0,0,0
2020-06-08,FM,Micronesia (Federated States of),WPRO,0,0,0,0
2020-03-29,MC,Monaco,EURO,2,27,0,0
2020-03-30,MC,Monaco,EURO,1,28,0,0
2020-03-31,MC,Monaco,EURO,1,29,0,0
2020-04-01,MC,Monaco,EURO,2,31,0,0
2020-04-02,MC,Monaco,EURO,2,33,0,0
2020-04-03,MC,Monaco,EURO,1,34,0,0
2020-04-04,MC,Monaco,EURO,3,37,0,0
2020-04-05,MC,Monaco,EURO,4,41,0,0
2020-04-06,MC,Monaco,EURO,1,42,0,0
2020-04-07,MC,Monaco,EURO,0,42,0,0
2020-04-08,MC,Monaco,EURO,2,44,0,0
2020-04-09,MC,Monaco,EURO,1,45,0,0
2020-04-10,MC,Monaco,EURO,4,49,0,0
2020-04-11,MC,Monaco,EURO,4,53,1,1
2020-04-12,MC,Monaco,EURO,0,53,0,1
2020-04-13,MC,Monaco,EURO,0,53,0,1
2020-04-14,MC,Monaco,EURO,0,53,0,1
2020-04-15,MC,Monaco,EURO,0,53,0,1
2020-04-16,MC,Monaco,EURO,0,53,0,1
2020-04-17,MC,Monaco,EURO,0,53,0,1
2020-04-18,MC,Monaco,EURO,1,54,0,1
2020-04-19,MC,Monaco,EURO,0,54,0,1
2020-04-20,MC,Monaco,EURO,0,54,0,1
2020-04-21,MC,Monaco,EURO,0,54,0,1
2020-04-22,MC,Monaco,EURO,0,54,0,1
2020-04-23,MC,Monaco,EURO,1,55,0,1
2020-04-24,MC,Monaco,EURO,1,56,0,1
2020-04-25,MC,Monaco,EURO,0,56,0,1
2020-04-26,MC,Monaco,EURO,0,56,0,1
2020-04-27,MC,Monaco,EURO,0,56,0,1
2020-04-28,MC,Monaco,EURO,0,56,0,1
2020-04-29,MC,Monaco,EURO,0,56,0,1
2020-04-30,MC,Monaco,EURO,0,56,0,1
2020-05-01,MC,Monaco,EURO,0,56,0,1
2020-05-02,MC,Monaco,EURO,0,56,0,1
2020-05-03,MC,Monaco,EURO,0,56,0,1
2020-05-04,MC,Monaco,EURO,0,56,0,1
2020-05-05,MC,Monaco,EURO,0,56,0,1
2020-05-06,MC,Monaco,EURO,0,56,0,1
2020-05-07,MC,Monaco,EURO,0,56,0,1
2020-05-08,MC,Monaco,EURO,0,56,0,1
2020-05-09,MC,Monaco,EURO,0,56,0,1
2020-05-10,MC,Monaco,EURO,0,56,0,1
2020-05-11,MC,Monaco,EURO,0,56,0,1
2020-05-12,MC,Monaco,EURO,0,56,0,1
2020-05-13,MC,Monaco,EURO,0,56,0,1
2020-05-14,MC,Monaco,EURO,0,56,0,1
2020-05-15,MC,Monaco,EURO,0,56,0,1
2020-05-16,MC,Monaco,EURO,1,57,0,1
2020-05-17,MC,Monaco,EURO,0,57,0,1
2020-05-18,MC,Monaco,EURO,0,57,0,1
2020-05-19,MC,Monaco,EURO,0,57,0,1
2020-05-20,MC,Monaco,EURO,2,59,0,1
2020-05-21,MC,Monaco,EURO,0,59,0,1
2020-05-22,MC,Monaco,EURO,0,59,0,1
2020-05-23,MC,Monaco,EURO,0,59,0,1
2020-05-24,MC,Monaco,EURO,0,59,0,1
2020-05-25,MC,Monaco,EURO,0,59,0,1
2020-05-26,MC,Monaco,EURO,0,59,0,1
2020-05-27,MC,Monaco,EURO,0,59,0,1
2020-05-28,MC,Monaco,EURO,0,59,0,1
2020-05-29,MC,Monaco,EURO,0,59,0,1
2020-05-30,MC,Monaco,EURO,0,59,0,1
2020-05-31,MC,Monaco,EURO,0,59,0,1
2020-06-01,MC,Monaco,EURO,0,59,0,1
2020-06-02,MC,Monaco,EURO,0,59,0,1
2020-06-03,MC,Monaco,EURO,0,59,0,1
2020-06-04,MC,Monaco,EURO,0,59,0,1
2020-06-05,MC,Monaco,EURO,0,59,0,1
2020-06-06,MC,Monaco,EURO,0,59,0,1
2020-06-07,MC,Monaco,EURO,0,59,0,1
2020-06-08,MC,Monaco,EURO,0,59,0,1
2020-03-29,MN,Mongolia,WPRO,0,12,0,0
2020-03-30,MN,Mongolia,WPRO,0,12,0,0
2020-03-31,MN,Mongolia,WPRO,0,12,0,0
2020-04-01,MN,Mongolia,WPRO,2,14,0,0
2020-04-02,MN,Mongolia,WPRO,0,14,0,0
2020-04-03,MN,Mongolia,WPRO,0,14,0,0
2020-04-04,MN,Mongolia,WPRO,0,14,0,0
2020-04-05,MN,Mongolia,WPRO,0,14,0,0
2020-04-06,MN,Mongolia,WPRO,0,14,0,0
2020-04-07,MN,Mongolia,WPRO,0,14,0,0
2020-04-08,MN,Mongolia,WPRO,0,14,0,0
2020-04-09,MN,Mongolia,WPRO,2,16,0,0
2020-04-10,MN,Mongolia,WPRO,0,16,0,0
2020-04-11,MN,Mongolia,WPRO,0,16,0,0
2020-04-12,MN,Mongolia,WPRO,0,16,0,0
2020-04-13,MN,Mongolia,WPRO,0,16,0,0
2020-04-14,MN,Mongolia,WPRO,14,30,0,0
2020-04-15,MN,Mongolia,WPRO,0,30,0,0
2020-04-16,MN,Mongolia,WPRO,1,31,0,0
2020-04-17,MN,Mongolia,WPRO,0,31,0,0
2020-04-18,MN,Mongolia,WPRO,0,31,0,0
2020-04-19,MN,Mongolia,WPRO,1,32,0,0
2020-04-20,MN,Mongolia,WPRO,1,33,0,0
2020-04-21,MN,Mongolia,WPRO,1,34,0,0
2020-04-22,MN,Mongolia,WPRO,1,35,0,0
2020-04-23,MN,Mongolia,WPRO,0,35,0,0
2020-04-24,MN,Mongolia,WPRO,0,35,0,0
2020-04-25,MN,Mongolia,WPRO,1,36,0,0
2020-04-26,MN,Mongolia,WPRO,2,38,0,0
2020-04-27,MN,Mongolia,WPRO,0,38,0,0
2020-04-28,MN,Mongolia,WPRO,0,38,0,0
2020-04-29,MN,Mongolia,WPRO,0,38,0,0
2020-04-30,MN,Mongolia,WPRO,0,38,0,0
2020-05-01,MN,Mongolia,WPRO,0,38,0,0
2020-05-02,MN,Mongolia,WPRO,0,38,0,0
2020-05-03,MN,Mongolia,WPRO,1,39,0,0
2020-05-04,MN,Mongolia,WPRO,1,40,0,0
2020-05-05,MN,Mongolia,WPRO,1,41,0,0
2020-05-06,MN,Mongolia,WPRO,0,41,0,0
2020-05-07,MN,Mongolia,WPRO,0,41,0,0
2020-05-08,MN,Mongolia,WPRO,1,42,0,0
2020-05-09,MN,Mongolia,WPRO,0,42,0,0
2020-05-10,MN,Mongolia,WPRO,0,42,0,0
2020-05-11,MN,Mongolia,WPRO,0,42,0,0
2020-05-12,MN,Mongolia,WPRO,0,42,0,0
2020-05-13,MN,Mongolia,WPRO,0,42,0,0
2020-05-14,MN,Mongolia,WPRO,19,61,0,0
2020-05-15,MN,Mongolia,WPRO,37,98,0,0
2020-05-16,MN,Mongolia,WPRO,37,135,0,0
2020-05-17,MN,Mongolia,WPRO,1,136,0,0
2020-05-18,MN,Mongolia,WPRO,4,140,0,0
2020-05-19,MN,Mongolia,WPRO,0,140,0,0
2020-05-20,MN,Mongolia,WPRO,0,140,0,0
2020-05-21,MN,Mongolia,WPRO,0,140,0,0
2020-05-22,MN,Mongolia,WPRO,1,141,0,0
2020-05-23,MN,Mongolia,WPRO,0,141,0,0
2020-05-24,MN,Mongolia,WPRO,0,141,0,0
2020-05-25,MN,Mongolia,WPRO,0,141,0,0
2020-05-26,MN,Mongolia,WPRO,0,141,0,0
2020-05-27,MN,Mongolia,WPRO,7,148,0,0
2020-05-28,MN,Mongolia,WPRO,13,161,0,0
2020-05-29,MN,Mongolia,WPRO,18,179,0,0
2020-05-30,MN,Mongolia,WPRO,0,179,0,0
2020-05-31,MN,Mongolia,WPRO,0,179,0,0
2020-06-01,MN,Mongolia,WPRO,6,185,0,0
2020-06-02,MN,Mongolia,WPRO,0,185,0,0
2020-06-03,MN,Mongolia,WPRO,0,185,0,0
2020-06-04,MN,Mongolia,WPRO,1,186,0,0
2020-06-05,MN,Mongolia,WPRO,0,186,0,0
2020-06-06,MN,Mongolia,WPRO,5,191,0,0
2020-06-07,MN,Mongolia,WPRO,2,193,0,0
2020-06-08,MN,Mongolia,WPRO,0,193,0,0
2020-03-29,ME,Montenegro,EURO,12,82,0,1
2020-03-30,ME,Montenegro,EURO,3,85,0,1
2020-03-31,ME,Montenegro,EURO,6,91,1,2
2020-04-01,ME,Montenegro,EURO,14,105,0,2
2020-04-02,ME,Montenegro,EURO,15,120,0,2
2020-04-03,ME,Montenegro,EURO,20,140,0,2
2020-04-04,ME,Montenegro,EURO,20,160,0,2
2020-04-05,ME,Montenegro,EURO,37,197,0,2
2020-04-06,ME,Montenegro,EURO,6,203,0,2
2020-04-07,ME,Montenegro,EURO,20,223,0,2
2020-04-08,ME,Montenegro,EURO,16,239,0,2
2020-04-09,ME,Montenegro,EURO,9,248,0,2
2020-04-10,ME,Montenegro,EURO,4,252,0,2
2020-04-11,ME,Montenegro,EURO,3,255,0,2
2020-04-12,ME,Montenegro,EURO,7,262,0,2
2020-04-13,ME,Montenegro,EURO,5,267,0,2
2020-04-14,ME,Montenegro,EURO,6,273,1,3
2020-04-15,ME,Montenegro,EURO,5,278,1,4
2020-04-16,ME,Montenegro,EURO,10,288,0,4
2020-04-17,ME,Montenegro,EURO,2,290,0,4
2020-04-18,ME,Montenegro,EURO,13,303,0,4
2020-04-19,ME,Montenegro,EURO,2,305,1,5
2020-04-20,ME,Montenegro,EURO,3,308,0,5
2020-04-21,ME,Montenegro,EURO,3,311,0,5
2020-04-22,ME,Montenegro,EURO,2,313,0,5
2020-04-23,ME,Montenegro,EURO,1,314,0,5
2020-04-24,ME,Montenegro,EURO,2,316,0,5
2020-04-25,ME,Montenegro,EURO,3,319,0,5
2020-04-26,ME,Montenegro,EURO,0,319,1,6
2020-04-27,ME,Montenegro,EURO,2,321,0,6
2020-04-28,ME,Montenegro,EURO,0,321,1,7
2020-04-29,ME,Montenegro,EURO,0,321,0,7
2020-04-30,ME,Montenegro,EURO,0,321,0,7
2020-05-01,ME,Montenegro,EURO,1,322,0,7
2020-05-02,ME,Montenegro,EURO,0,322,0,7
2020-05-03,ME,Montenegro,EURO,0,322,0,7
2020-05-04,ME,Montenegro,EURO,0,322,1,8
2020-05-05,ME,Montenegro,EURO,1,323,0,8
2020-05-06,ME,Montenegro,EURO,1,324,0,8
2020-05-07,ME,Montenegro,EURO,0,324,0,8
2020-05-08,ME,Montenegro,EURO,0,324,0,8
2020-05-09,ME,Montenegro,EURO,0,324,0,8
2020-05-10,ME,Montenegro,EURO,0,324,0,8
2020-05-11,ME,Montenegro,EURO,0,324,1,9
2020-05-12,ME,Montenegro,EURO,0,324,0,9
2020-05-13,ME,Montenegro,EURO,0,324,0,9
2020-05-14,ME,Montenegro,EURO,0,324,0,9
2020-05-15,ME,Montenegro,EURO,0,324,0,9
2020-05-16,ME,Montenegro,EURO,0,324,0,9
2020-05-17,ME,Montenegro,EURO,0,324,0,9
2020-05-18,ME,Montenegro,EURO,0,324,0,9
2020-05-19,ME,Montenegro,EURO,0,324,0,9
2020-05-20,ME,Montenegro,EURO,0,324,0,9
2020-05-21,ME,Montenegro,EURO,0,324,0,9
2020-05-22,ME,Montenegro,EURO,0,324,0,9
2020-05-23,ME,Montenegro,EURO,0,324,0,9
2020-05-24,ME,Montenegro,EURO,0,324,0,9
2020-05-25,ME,Montenegro,EURO,0,324,0,9
2020-05-26,ME,Montenegro,EURO,0,324,0,9
2020-05-27,ME,Montenegro,EURO,0,324,0,9
2020-05-28,ME,Montenegro,EURO,0,324,0,9
2020-05-29,ME,Montenegro,EURO,0,324,0,9
2020-05-30,ME,Montenegro,EURO,0,324,0,9
2020-05-31,ME,Montenegro,EURO,0,324,0,9
2020-06-01,ME,Montenegro,EURO,0,324,0,9
2020-06-02,ME,Montenegro,EURO,0,324,0,9
2020-06-03,ME,Montenegro,EURO,0,324,0,9
2020-06-04,ME,Montenegro,EURO,0,324,0,9
2020-06-05,ME,Montenegro,EURO,0,324,0,9
2020-06-06,ME,Montenegro,EURO,0,324,0,9
2020-06-07,ME,Montenegro,EURO,0,324,0,9
2020-06-08,ME,Montenegro,EURO,0,324,0,9
2020-03-29,MS,Montserrat,AMRO,0,5,0,0
2020-03-30,MS,Montserrat,AMRO,0,5,0,0
2020-03-31,MS,Montserrat,AMRO,0,5,0,0
2020-04-01,MS,Montserrat,AMRO,0,5,0,0
2020-04-02,MS,Montserrat,AMRO,0,5,0,0
2020-04-03,MS,Montserrat,AMRO,0,5,0,0
2020-04-04,MS,Montserrat,AMRO,0,5,0,0
2020-04-05,MS,Montserrat,AMRO,1,6,0,0
2020-04-06,MS,Montserrat,AMRO,0,6,0,0
2020-04-07,MS,Montserrat,AMRO,0,6,0,0
2020-04-08,MS,Montserrat,AMRO,0,6,0,0
2020-04-09,MS,Montserrat,AMRO,2,8,0,0
2020-04-10,MS,Montserrat,AMRO,0,8,0,0
2020-04-11,MS,Montserrat,AMRO,1,9,0,0
2020-04-12,MS,Montserrat,AMRO,0,9,0,0
2020-04-13,MS,Montserrat,AMRO,0,9,0,0
2020-04-14,MS,Montserrat,AMRO,2,11,0,0
2020-04-15,MS,Montserrat,AMRO,0,11,0,0
2020-04-16,MS,Montserrat,AMRO,0,11,0,0
2020-04-17,MS,Montserrat,AMRO,0,11,0,0
2020-04-18,MS,Montserrat,AMRO,0,11,0,0
2020-04-19,MS,Montserrat,AMRO,0,11,0,0
2020-04-20,MS,Montserrat,AMRO,0,11,0,0
2020-04-21,MS,Montserrat,AMRO,0,11,0,0
2020-04-22,MS,Montserrat,AMRO,0,11,0,0
2020-04-23,MS,Montserrat,AMRO,0,11,0,0
2020-04-24,MS,Montserrat,AMRO,0,11,0,0
2020-04-25,MS,Montserrat,AMRO,0,11,0,0
2020-04-26,MS,Montserrat,AMRO,0,11,1,1
2020-04-27,MS,Montserrat,AMRO,0,11,0,1
2020-04-28,MS,Montserrat,AMRO,0,11,0,1
2020-04-29,MS,Montserrat,AMRO,0,11,0,1
2020-04-30,MS,Montserrat,AMRO,0,11,0,1
2020-05-01,MS,Montserrat,AMRO,0,11,0,1
2020-05-02,MS,Montserrat,AMRO,0,11,0,1
2020-05-03,MS,Montserrat,AMRO,0,11,0,1
2020-05-04,MS,Montserrat,AMRO,0,11,0,1
2020-05-05,MS,Montserrat,AMRO,0,11,0,1
2020-05-06,MS,Montserrat,AMRO,0,11,0,1
2020-05-07,MS,Montserrat,AMRO,0,11,0,1
2020-05-08,MS,Montserrat,AMRO,0,11,0,1
2020-05-09,MS,Montserrat,AMRO,0,11,0,1
2020-05-10,MS,Montserrat,AMRO,0,11,0,1
2020-05-11,MS,Montserrat,AMRO,0,11,0,1
2020-05-12,MS,Montserrat,AMRO,0,11,0,1
2020-05-13,MS,Montserrat,AMRO,0,11,0,1
2020-05-14,MS,Montserrat,AMRO,0,11,0,1
2020-05-15,MS,Montserrat,AMRO,0,11,0,1
2020-05-16,MS,Montserrat,AMRO,0,11,0,1
2020-05-17,MS,Montserrat,AMRO,0,11,0,1
2020-05-18,MS,Montserrat,AMRO,0,11,0,1
2020-05-19,MS,Montserrat,AMRO,0,11,0,1
2020-05-20,MS,Montserrat,AMRO,0,11,0,1
2020-05-21,MS,Montserrat,AMRO,0,11,0,1
2020-05-22,MS,Montserrat,AMRO,0,11,0,1
2020-05-23,MS,Montserrat,AMRO,0,11,0,1
2020-05-24,MS,Montserrat,AMRO,0,11,0,1
2020-05-25,MS,Montserrat,AMRO,0,11,0,1
2020-05-26,MS,Montserrat,AMRO,0,11,0,1
2020-05-27,MS,Montserrat,AMRO,0,11,0,1
2020-05-28,MS,Montserrat,AMRO,0,11,0,1
2020-05-29,MS,Montserrat,AMRO,0,11,0,1
2020-05-30,MS,Montserrat,AMRO,0,11,0,1
2020-05-31,MS,Montserrat,AMRO,0,11,0,1
2020-06-01,MS,Montserrat,AMRO,0,11,0,1
2020-06-02,MS,Montserrat,AMRO,0,11,0,1
2020-06-03,MS,Montserrat,AMRO,0,11,0,1
2020-06-04,MS,Montserrat,AMRO,0,11,0,1
2020-06-05,MS,Montserrat,AMRO,0,11,0,1
2020-06-06,MS,Montserrat,AMRO,0,11,0,1
2020-06-07,MS,Montserrat,AMRO,0,11,0,1
2020-06-08,MS,Montserrat,AMRO,0,11,0,1
2020-03-29,MA,Morocco,EMRO,45,390,2,25
2020-03-30,MA,Morocco,EMRO,73,463,1,26
2020-03-31,MA,Morocco,EMRO,93,556,7,33
2020-04-01,MA,Morocco,EMRO,61,617,3,36
2020-04-02,MA,Morocco,EMRO,37,654,3,39
2020-04-03,MA,Morocco,EMRO,54,708,5,44
2020-04-04,MA,Morocco,EMRO,83,791,4,48
2020-04-05,MA,Morocco,EMRO,128,919,11,59
2020-04-06,MA,Morocco,EMRO,102,1021,11,70
2020-04-07,MA,Morocco,EMRO,99,1120,10,80
2020-04-08,MA,Morocco,EMRO,64,1184,10,90
2020-04-09,MA,Morocco,EMRO,91,1275,3,93
2020-04-10,MA,Morocco,EMRO,99,1374,4,97
2020-04-11,MA,Morocco,EMRO,74,1448,10,107
2020-04-12,MA,Morocco,EMRO,97,1545,4,111
2020-04-13,MA,Morocco,EMRO,116,1661,7,118
2020-04-14,MA,Morocco,EMRO,102,1763,8,126
2020-04-15,MA,Morocco,EMRO,125,1888,0,126
2020-04-16,MA,Morocco,EMRO,136,2024,1,127
2020-04-17,MA,Morocco,EMRO,259,2283,3,130
2020-04-18,MA,Morocco,EMRO,281,2564,5,135
2020-04-19,MA,Morocco,EMRO,121,2685,2,137
2020-04-20,MA,Morocco,EMRO,170,2855,4,141
2020-04-21,MA,Morocco,EMRO,191,3046,2,143
2020-04-22,MA,Morocco,EMRO,163,3209,2,145
2020-04-23,MA,Morocco,EMRO,237,3446,4,149
2020-04-24,MA,Morocco,EMRO,122,3568,6,155
2020-04-25,MA,Morocco,EMRO,190,3758,3,158
2020-04-26,MA,Morocco,EMRO,139,3897,1,159
2020-04-27,MA,Morocco,EMRO,168,4065,2,161
2020-04-28,MA,Morocco,EMRO,55,4120,1,162
2020-04-29,MA,Morocco,EMRO,132,4252,3,165
2020-04-30,MA,Morocco,EMRO,69,4321,3,168
2020-05-01,MA,Morocco,EMRO,102,4423,2,170
2020-05-02,MA,Morocco,EMRO,146,4569,1,171
2020-05-03,MA,Morocco,EMRO,160,4729,2,173
2020-05-04,MA,Morocco,EMRO,174,4903,1,174
2020-05-05,MA,Morocco,EMRO,150,5053,5,179
2020-05-06,MA,Morocco,EMRO,166,5219,2,181
2020-05-07,MA,Morocco,EMRO,189,5408,2,183
2020-05-08,MA,Morocco,EMRO,140,5548,0,183
2020-05-09,MA,Morocco,EMRO,163,5711,3,186
2020-05-10,MA,Morocco,EMRO,199,5910,0,186
2020-05-11,MA,Morocco,EMRO,153,6063,2,188
2020-05-12,MA,Morocco,EMRO,218,6281,0,188
2020-05-13,MA,Morocco,EMRO,137,6418,0,188
2020-05-14,MA,Morocco,EMRO,94,6512,0,188
2020-05-15,MA,Morocco,EMRO,95,6607,2,190
2020-05-16,MA,Morocco,EMRO,45,6652,0,190
2020-05-17,MA,Morocco,EMRO,89,6741,2,192
2020-05-18,MA,Morocco,EMRO,129,6870,0,192
2020-05-19,MA,Morocco,EMRO,82,6952,0,192
2020-05-20,MA,Morocco,EMRO,71,7023,1,193
2020-05-21,MA,Morocco,EMRO,110,7133,1,194
2020-05-22,MA,Morocco,EMRO,78,7211,2,196
2020-05-23,MA,Morocco,EMRO,121,7332,1,197
2020-05-24,MA,Morocco,EMRO,74,7406,1,198
2020-05-25,MA,Morocco,EMRO,27,7433,1,199
2020-05-26,MA,Morocco,EMRO,99,7532,1,200
2020-05-27,MA,Morocco,EMRO,45,7577,2,202
2020-05-28,MA,Morocco,EMRO,24,7601,0,202
2020-05-29,MA,Morocco,EMRO,42,7643,0,202
2020-05-30,MA,Morocco,EMRO,71,7714,0,202
2020-05-31,MA,Morocco,EMRO,66,7780,2,204
2020-06-01,MA,Morocco,EMRO,27,7807,1,205
2020-06-02,MA,Morocco,EMRO,26,7833,0,205
2020-06-03,MA,Morocco,EMRO,33,7866,1,206
2020-06-04,MA,Morocco,EMRO,56,7922,0,206
2020-06-05,MA,Morocco,EMRO,81,8003,2,208
2020-06-06,MA,Morocco,EMRO,68,8071,0,208
2020-06-07,MA,Morocco,EMRO,80,8151,0,208
2020-06-08,MA,Morocco,EMRO,73,8224,0,208
2020-03-29,MZ,Mozambique,AFRO,0,8,0,1
2020-03-30,MZ,Mozambique,AFRO,0,8,0,1
2020-03-31,MZ,Mozambique,AFRO,0,8,0,1
2020-04-01,MZ,Mozambique,AFRO,0,8,0,1
2020-04-02,MZ,Mozambique,AFRO,2,10,0,1
2020-04-03,MZ,Mozambique,AFRO,0,10,0,1
2020-04-04,MZ,Mozambique,AFRO,0,10,0,1
2020-04-05,MZ,Mozambique,AFRO,0,10,0,1
2020-04-06,MZ,Mozambique,AFRO,0,10,0,1
2020-04-07,MZ,Mozambique,AFRO,0,10,0,1
2020-04-08,MZ,Mozambique,AFRO,0,10,0,1
2020-04-09,MZ,Mozambique,AFRO,7,17,0,1
2020-04-10,MZ,Mozambique,AFRO,0,17,0,1
2020-04-11,MZ,Mozambique,AFRO,3,20,0,1
2020-04-12,MZ,Mozambique,AFRO,0,20,0,1
2020-04-13,MZ,Mozambique,AFRO,1,21,0,1
2020-04-14,MZ,Mozambique,AFRO,0,21,0,1
2020-04-15,MZ,Mozambique,AFRO,7,28,0,1
2020-04-16,MZ,Mozambique,AFRO,2,30,0,1
2020-04-17,MZ,Mozambique,AFRO,1,31,0,1
2020-04-18,MZ,Mozambique,AFRO,0,31,0,1
2020-04-19,MZ,Mozambique,AFRO,4,35,0,1
2020-04-20,MZ,Mozambique,AFRO,0,35,0,1
2020-04-21,MZ,Mozambique,AFRO,4,39,0,1
2020-04-22,MZ,Mozambique,AFRO,0,39,0,1
2020-04-23,MZ,Mozambique,AFRO,2,41,0,1
2020-04-24,MZ,Mozambique,AFRO,5,46,0,1
2020-04-25,MZ,Mozambique,AFRO,19,65,0,1
2020-04-26,MZ,Mozambique,AFRO,5,70,0,1
2020-04-27,MZ,Mozambique,AFRO,6,76,0,1
2020-04-28,MZ,Mozambique,AFRO,0,76,0,1
2020-04-29,MZ,Mozambique,AFRO,0,76,0,1
2020-04-30,MZ,Mozambique,AFRO,0,76,0,1
2020-05-01,MZ,Mozambique,AFRO,3,79,0,1
2020-05-02,MZ,Mozambique,AFRO,1,80,0,1
2020-05-03,MZ,Mozambique,AFRO,0,80,0,1
2020-05-04,MZ,Mozambique,AFRO,1,81,0,1
2020-05-05,MZ,Mozambique,AFRO,0,81,0,1
2020-05-06,MZ,Mozambique,AFRO,0,81,0,1
2020-05-07,MZ,Mozambique,AFRO,0,81,0,1
2020-05-08,MZ,Mozambique,AFRO,0,81,0,1
2020-05-09,MZ,Mozambique,AFRO,1,82,0,1
2020-05-10,MZ,Mozambique,AFRO,5,87,0,1
2020-05-11,MZ,Mozambique,AFRO,4,91,0,1
2020-05-12,MZ,Mozambique,AFRO,12,103,0,1
2020-05-13,MZ,Mozambique,AFRO,1,104,0,1
2020-05-14,MZ,Mozambique,AFRO,3,107,0,1
2020-05-15,MZ,Mozambique,AFRO,8,115,0,1
2020-05-16,MZ,Mozambique,AFRO,4,119,0,1
2020-05-17,MZ,Mozambique,AFRO,10,129,0,1
2020-05-18,MZ,Mozambique,AFRO,8,137,0,1
2020-05-19,MZ,Mozambique,AFRO,8,145,0,1
2020-05-20,MZ,Mozambique,AFRO,1,146,0,1
2020-05-21,MZ,Mozambique,AFRO,10,156,0,1
2020-05-22,MZ,Mozambique,AFRO,6,162,0,1
2020-05-23,MZ,Mozambique,AFRO,2,164,0,1
2020-05-24,MZ,Mozambique,AFRO,4,168,0,1
2020-05-25,MZ,Mozambique,AFRO,26,194,0,1
2020-05-26,MZ,Mozambique,AFRO,15,209,0,1
2020-05-27,MZ,Mozambique,AFRO,4,213,0,1
2020-05-28,MZ,Mozambique,AFRO,14,227,0,1
2020-05-29,MZ,Mozambique,AFRO,7,234,1,2
2020-05-30,MZ,Mozambique,AFRO,0,234,0,2
2020-05-31,MZ,Mozambique,AFRO,10,244,0,2
2020-06-01,MZ,Mozambique,AFRO,10,254,0,2
2020-06-02,MZ,Mozambique,AFRO,0,254,0,2
2020-06-03,MZ,Mozambique,AFRO,53,307,0,2
2020-06-04,MZ,Mozambique,AFRO,9,316,0,2
2020-06-05,MZ,Mozambique,AFRO,36,352,0,2
2020-06-06,MZ,Mozambique,AFRO,2,354,0,2
2020-06-07,MZ,Mozambique,AFRO,57,411,0,2
2020-06-08,MZ,Mozambique,AFRO,15,426,0,2
2020-03-29,MM,Myanmar,SEARO,0,8,0,0
2020-03-30,MM,Myanmar,SEARO,2,10,0,0
2020-03-31,MM,Myanmar,SEARO,4,14,1,1
2020-04-01,MM,Myanmar,SEARO,1,15,0,1
2020-04-02,MM,Myanmar,SEARO,1,16,0,1
2020-04-03,MM,Myanmar,SEARO,4,20,0,1
2020-04-04,MM,Myanmar,SEARO,1,21,0,1
2020-04-05,MM,Myanmar,SEARO,0,21,0,1
2020-04-06,MM,Myanmar,SEARO,0,21,0,1
2020-04-07,MM,Myanmar,SEARO,1,22,0,1
2020-04-08,MM,Myanmar,SEARO,0,22,2,3
2020-04-09,MM,Myanmar,SEARO,0,22,0,3
2020-04-10,MM,Myanmar,SEARO,5,27,0,3
2020-04-11,MM,Myanmar,SEARO,1,28,0,3
2020-04-12,MM,Myanmar,SEARO,10,38,0,3
2020-04-13,MM,Myanmar,SEARO,3,41,1,4
2020-04-14,MM,Myanmar,SEARO,21,62,0,4
2020-04-15,MM,Myanmar,SEARO,12,74,0,4
2020-04-16,MM,Myanmar,SEARO,11,85,0,4
2020-04-17,MM,Myanmar,SEARO,0,85,0,4
2020-04-18,MM,Myanmar,SEARO,9,94,1,5
2020-04-19,MM,Myanmar,SEARO,13,107,0,5
2020-04-20,MM,Myanmar,SEARO,4,111,0,5
2020-04-21,MM,Myanmar,SEARO,8,119,0,5
2020-04-22,MM,Myanmar,SEARO,2,121,0,5
2020-04-23,MM,Myanmar,SEARO,6,127,0,5
2020-04-24,MM,Myanmar,SEARO,12,139,0,5
2020-04-25,MM,Myanmar,SEARO,5,144,0,5
2020-04-26,MM,Myanmar,SEARO,2,146,0,5
2020-04-27,MM,Myanmar,SEARO,0,146,0,5
2020-04-28,MM,Myanmar,SEARO,0,146,0,5
2020-04-29,MM,Myanmar,SEARO,4,150,0,5
2020-04-30,MM,Myanmar,SEARO,0,150,1,6
2020-05-01,MM,Myanmar,SEARO,1,151,0,6
2020-05-02,MM,Myanmar,SEARO,0,151,0,6
2020-05-03,MM,Myanmar,SEARO,0,151,0,6
2020-05-04,MM,Myanmar,SEARO,10,161,0,6
2020-05-05,MM,Myanmar,SEARO,0,161,0,6
2020-05-06,MM,Myanmar,SEARO,0,161,0,6
2020-05-07,MM,Myanmar,SEARO,1,162,0,6
2020-05-08,MM,Myanmar,SEARO,14,176,0,6
2020-05-09,MM,Myanmar,SEARO,1,177,0,6
2020-05-10,MM,Myanmar,SEARO,1,178,0,6
2020-05-11,MM,Myanmar,SEARO,2,180,0,6
2020-05-12,MM,Myanmar,SEARO,0,180,0,6
2020-05-13,MM,Myanmar,SEARO,0,180,0,6
2020-05-14,MM,Myanmar,SEARO,1,181,0,6
2020-05-15,MM,Myanmar,SEARO,0,181,0,6
2020-05-16,MM,Myanmar,SEARO,1,182,0,6
2020-05-17,MM,Myanmar,SEARO,2,184,0,6
2020-05-18,MM,Myanmar,SEARO,4,188,0,6
2020-05-19,MM,Myanmar,SEARO,5,193,0,6
2020-05-20,MM,Myanmar,SEARO,6,199,0,6
2020-05-21,MM,Myanmar,SEARO,0,199,0,6
2020-05-22,MM,Myanmar,SEARO,0,199,0,6
2020-05-23,MM,Myanmar,SEARO,2,201,0,6
2020-05-24,MM,Myanmar,SEARO,0,201,0,6
2020-05-25,MM,Myanmar,SEARO,2,203,0,6
2020-05-26,MM,Myanmar,SEARO,3,206,0,6
2020-05-27,MM,Myanmar,SEARO,0,206,0,6
2020-05-28,MM,Myanmar,SEARO,0,206,0,6
2020-05-29,MM,Myanmar,SEARO,1,207,0,6
2020-05-30,MM,Myanmar,SEARO,17,224,0,6
2020-05-31,MM,Myanmar,SEARO,0,224,0,6
2020-06-01,MM,Myanmar,SEARO,4,228,0,6
2020-06-02,MM,Myanmar,SEARO,4,232,0,6
2020-06-03,MM,Myanmar,SEARO,1,233,0,6
2020-06-04,MM,Myanmar,SEARO,1,234,0,6
2020-06-05,MM,Myanmar,SEARO,2,236,0,6
2020-06-06,MM,Myanmar,SEARO,4,240,0,6
2020-06-07,MM,Myanmar,SEARO,2,242,0,6
2020-06-08,MM,Myanmar,SEARO,1,243,0,6
2020-03-29,,Namibia,AFRO,3,11,0,1
2020-03-30,,Namibia,AFRO,0,11,0,1
2020-03-31,,Namibia,AFRO,0,11,0,1
2020-04-01,,Namibia,AFRO,0,11,0,1
2020-04-02,,Namibia,AFRO,2,13,0,1
2020-04-03,,Namibia,AFRO,0,13,0,1
2020-04-04,,Namibia,AFRO,1,14,0,1
2020-04-05,,Namibia,AFRO,2,16,0,1
2020-04-06,,Namibia,AFRO,0,16,0,1
2020-04-07,,Namibia,AFRO,0,16,0,1
2020-04-08,,Namibia,AFRO,0,16,0,1
2020-04-09,,Namibia,AFRO,0,16,0,1
2020-04-10,,Namibia,AFRO,0,16,0,1
2020-04-11,,Namibia,AFRO,0,16,0,1
2020-04-12,,Namibia,AFRO,0,16,0,1
2020-04-13,,Namibia,AFRO,0,16,0,1
2020-04-14,,Namibia,AFRO,0,16,0,1
2020-04-15,,Namibia,AFRO,0,16,0,1
2020-04-16,,Namibia,AFRO,0,16,0,1
2020-04-17,,Namibia,AFRO,0,16,0,1
2020-04-18,,Namibia,AFRO,0,16,0,1
2020-04-19,,Namibia,AFRO,0,16,0,1
2020-04-20,,Namibia,AFRO,0,16,0,1
2020-04-21,,Namibia,AFRO,0,16,0,1
2020-04-22,,Namibia,AFRO,0,16,0,1
2020-04-23,,Namibia,AFRO,0,16,0,1
2020-04-24,,Namibia,AFRO,0,16,0,1
2020-04-25,,Namibia,AFRO,0,16,0,1
2020-04-26,,Namibia,AFRO,0,16,0,1
2020-04-27,,Namibia,AFRO,0,16,0,1
2020-04-28,,Namibia,AFRO,0,16,0,1
2020-04-29,,Namibia,AFRO,0,16,0,1
2020-04-30,,Namibia,AFRO,0,16,0,1
2020-05-01,,Namibia,AFRO,0,16,0,1
2020-05-02,,Namibia,AFRO,0,16,0,1
2020-05-03,,Namibia,AFRO,0,16,0,1
2020-05-04,,Namibia,AFRO,0,16,0,1
2020-05-05,,Namibia,AFRO,0,16,0,1
2020-05-06,,Namibia,AFRO,0,16,0,1
2020-05-07,,Namibia,AFRO,0,16,0,1
2020-05-08,,Namibia,AFRO,0,16,0,1
2020-05-09,,Namibia,AFRO,0,16,0,1
2020-05-10,,Namibia,AFRO,0,16,0,1
2020-05-11,,Namibia,AFRO,0,16,0,1
2020-05-12,,Namibia,AFRO,0,16,0,1
2020-05-13,,Namibia,AFRO,0,16,0,1
2020-05-14,,Namibia,AFRO,0,16,0,1
2020-05-15,,Namibia,AFRO,0,16,0,1
2020-05-16,,Namibia,AFRO,0,16,0,1
2020-05-17,,Namibia,AFRO,0,16,0,1
2020-05-18,,Namibia,AFRO,0,16,0,1
2020-05-19,,Namibia,AFRO,0,16,0,1
2020-05-20,,Namibia,AFRO,0,16,0,1
2020-05-21,,Namibia,AFRO,0,16,0,1
2020-05-22,,Namibia,AFRO,2,18,0,1
2020-05-23,,Namibia,AFRO,1,19,0,1
2020-05-24,,Namibia,AFRO,1,20,0,1
2020-05-25,,Namibia,AFRO,1,21,0,1
2020-05-26,,Namibia,AFRO,0,21,0,1
2020-05-27,,Namibia,AFRO,0,21,0,1
2020-05-28,,Namibia,AFRO,1,22,0,1
2020-05-29,,Namibia,AFRO,1,23,0,1
2020-05-30,,Namibia,AFRO,0,23,0,1
2020-05-31,,Namibia,AFRO,0,23,0,1
2020-06-01,,Namibia,AFRO,1,24,0,1
2020-06-02,,Namibia,AFRO,1,25,0,1
2020-06-03,,Namibia,AFRO,0,25,0,1
2020-06-04,,Namibia,AFRO,0,25,0,1
2020-06-05,,Namibia,AFRO,0,25,0,1
2020-06-06,,Namibia,AFRO,0,25,0,1
2020-06-07,,Namibia,AFRO,4,29,0,1
2020-06-08,,Namibia,AFRO,0,29,0,1
2020-03-29,NR,Nauru,WPRO,0,0,0,0
2020-03-30,NR,Nauru,WPRO,0,0,0,0
2020-03-31,NR,Nauru,WPRO,0,0,0,0
2020-04-01,NR,Nauru,WPRO,0,0,0,0
2020-04-02,NR,Nauru,WPRO,0,0,0,0
2020-04-03,NR,Nauru,WPRO,0,0,0,0
2020-04-04,NR,Nauru,WPRO,0,0,0,0
2020-04-05,NR,Nauru,WPRO,0,0,0,0
2020-04-06,NR,Nauru,WPRO,0,0,0,0
2020-04-07,NR,Nauru,WPRO,0,0,0,0
2020-04-08,NR,Nauru,WPRO,0,0,0,0
2020-04-09,NR,Nauru,WPRO,0,0,0,0
2020-04-10,NR,Nauru,WPRO,0,0,0,0
2020-04-11,NR,Nauru,WPRO,0,0,0,0
2020-04-12,NR,Nauru,WPRO,0,0,0,0
2020-04-13,NR,Nauru,WPRO,0,0,0,0
2020-04-14,NR,Nauru,WPRO,0,0,0,0
2020-04-15,NR,Nauru,WPRO,0,0,0,0
2020-04-16,NR,Nauru,WPRO,0,0,0,0
2020-04-17,NR,Nauru,WPRO,0,0,0,0
2020-04-18,NR,Nauru,WPRO,0,0,0,0
2020-04-19,NR,Nauru,WPRO,0,0,0,0
2020-04-20,NR,Nauru,WPRO,0,0,0,0
2020-04-21,NR,Nauru,WPRO,0,0,0,0
2020-04-22,NR,Nauru,WPRO,0,0,0,0
2020-04-23,NR,Nauru,WPRO,0,0,0,0
2020-04-24,NR,Nauru,WPRO,0,0,0,0
2020-04-25,NR,Nauru,WPRO,0,0,0,0
2020-04-26,NR,Nauru,WPRO,0,0,0,0
2020-04-27,NR,Nauru,WPRO,0,0,0,0
2020-04-28,NR,Nauru,WPRO,0,0,0,0
2020-04-29,NR,Nauru,WPRO,0,0,0,0
2020-04-30,NR,Nauru,WPRO,0,0,0,0
2020-05-01,NR,Nauru,WPRO,0,0,0,0
2020-05-02,NR,Nauru,WPRO,0,0,0,0
2020-05-03,NR,Nauru,WPRO,0,0,0,0
2020-05-04,NR,Nauru,WPRO,0,0,0,0
2020-05-05,NR,Nauru,WPRO,0,0,0,0
2020-05-06,NR,Nauru,WPRO,0,0,0,0
2020-05-07,NR,Nauru,WPRO,0,0,0,0
2020-05-08,NR,Nauru,WPRO,0,0,0,0
2020-05-09,NR,Nauru,WPRO,0,0,0,0
2020-05-10,NR,Nauru,WPRO,0,0,0,0
2020-05-11,NR,Nauru,WPRO,0,0,0,0
2020-05-12,NR,Nauru,WPRO,0,0,0,0
2020-05-13,NR,Nauru,WPRO,0,0,0,0
2020-05-14,NR,Nauru,WPRO,0,0,0,0
2020-05-15,NR,Nauru,WPRO,0,0,0,0
2020-05-16,NR,Nauru,WPRO,0,0,0,0
2020-05-17,NR,Nauru,WPRO,0,0,0,0
2020-05-18,NR,Nauru,WPRO,0,0,0,0
2020-05-19,NR,Nauru,WPRO,0,0,0,0
2020-05-20,NR,Nauru,WPRO,0,0,0,0
2020-05-21,NR,Nauru,WPRO,0,0,0,0
2020-05-22,NR,Nauru,WPRO,0,0,0,0
2020-05-23,NR,Nauru,WPRO,0,0,0,0
2020-05-24,NR,Nauru,WPRO,0,0,0,0
2020-05-25,NR,Nauru,WPRO,0,0,0,0
2020-05-26,NR,Nauru,WPRO,0,0,0,0
2020-05-27,NR,Nauru,WPRO,0,0,0,0
2020-05-28,NR,Nauru,WPRO,0,0,0,0
2020-05-29,NR,Nauru,WPRO,0,0,0,0
2020-05-30,NR,Nauru,WPRO,0,0,0,0
2020-05-31,NR,Nauru,WPRO,0,0,0,0
2020-06-01,NR,Nauru,WPRO,0,0,0,0
2020-06-02,NR,Nauru,WPRO,0,0,0,0
2020-06-03,NR,Nauru,WPRO,0,0,0,0
2020-06-04,NR,Nauru,WPRO,0,0,0,0
2020-06-05,NR,Nauru,WPRO,0,0,0,0
2020-06-06,NR,Nauru,WPRO,0,0,0,0
2020-06-07,NR,Nauru,WPRO,0,0,0,0
2020-06-08,NR,Nauru,WPRO,0,0,0,0
2020-03-29,NP,Nepal,SEARO,2,5,0,0
2020-03-30,NP,Nepal,SEARO,0,5,0,0
2020-03-31,NP,Nepal,SEARO,0,5,0,0
2020-04-01,NP,Nepal,SEARO,0,5,0,0
2020-04-02,NP,Nepal,SEARO,1,6,0,0
2020-04-03,NP,Nepal,SEARO,0,6,0,0
2020-04-04,NP,Nepal,SEARO,3,9,0,0
2020-04-05,NP,Nepal,SEARO,0,9,0,0
2020-04-06,NP,Nepal,SEARO,0,9,0,0
2020-04-07,NP,Nepal,SEARO,0,9,0,0
2020-04-08,NP,Nepal,SEARO,0,9,0,0
2020-04-09,NP,Nepal,SEARO,0,9,0,0
2020-04-10,NP,Nepal,SEARO,0,9,0,0
2020-04-11,NP,Nepal,SEARO,0,9,0,0
2020-04-12,NP,Nepal,SEARO,3,12,0,0
2020-04-13,NP,Nepal,SEARO,2,14,0,0
2020-04-14,NP,Nepal,SEARO,2,16,0,0
2020-04-15,NP,Nepal,SEARO,0,16,0,0
2020-04-16,NP,Nepal,SEARO,0,16,0,0
2020-04-17,NP,Nepal,SEARO,0,16,0,0
2020-04-18,NP,Nepal,SEARO,14,30,0,0
2020-04-19,NP,Nepal,SEARO,1,31,0,0
2020-04-20,NP,Nepal,SEARO,0,31,0,0
2020-04-21,NP,Nepal,SEARO,11,42,0,0
2020-04-22,NP,Nepal,SEARO,0,42,0,0
2020-04-23,NP,Nepal,SEARO,3,45,0,0
2020-04-24,NP,Nepal,SEARO,3,48,0,0
2020-04-25,NP,Nepal,SEARO,1,49,0,0
2020-04-26,NP,Nepal,SEARO,2,51,0,0
2020-04-27,NP,Nepal,SEARO,1,52,0,0
2020-04-28,NP,Nepal,SEARO,2,54,0,0
2020-04-29,NP,Nepal,SEARO,3,57,0,0
2020-04-30,NP,Nepal,SEARO,0,57,0,0
2020-05-01,NP,Nepal,SEARO,2,59,0,0
2020-05-02,NP,Nepal,SEARO,0,59,0,0
2020-05-03,NP,Nepal,SEARO,16,75,0,0
2020-05-04,NP,Nepal,SEARO,0,75,0,0
2020-05-05,NP,Nepal,SEARO,7,82,0,0
2020-05-06,NP,Nepal,SEARO,17,99,0,0
2020-05-07,NP,Nepal,SEARO,2,101,0,0
2020-05-08,NP,Nepal,SEARO,1,102,0,0
2020-05-09,NP,Nepal,SEARO,7,109,0,0
2020-05-10,NP,Nepal,SEARO,1,110,0,0
2020-05-11,NP,Nepal,SEARO,24,134,0,0
2020-05-12,NP,Nepal,SEARO,83,217,0,0
2020-05-13,NP,Nepal,SEARO,26,243,0,0
2020-05-14,NP,Nepal,SEARO,6,249,0,0
2020-05-15,NP,Nepal,SEARO,18,267,0,0
2020-05-16,NP,Nepal,SEARO,24,291,1,1
2020-05-17,NP,Nepal,SEARO,4,295,1,2
2020-05-18,NP,Nepal,SEARO,80,375,0,2
2020-05-19,NP,Nepal,SEARO,27,402,0,2
2020-05-20,NP,Nepal,SEARO,25,427,0,2
2020-05-21,NP,Nepal,SEARO,30,457,1,3
2020-05-22,NP,Nepal,SEARO,59,516,0,3
2020-05-23,NP,Nepal,SEARO,68,584,0,3
2020-05-24,NP,Nepal,SEARO,19,603,0,3
2020-05-25,NP,Nepal,SEARO,79,682,1,4
2020-05-26,NP,Nepal,SEARO,90,772,0,4
2020-05-27,NP,Nepal,SEARO,114,886,0,4
2020-05-28,NP,Nepal,SEARO,156,1042,1,5
2020-05-29,NP,Nepal,SEARO,170,1212,1,6
2020-05-30,NP,Nepal,SEARO,189,1401,0,6
2020-05-31,NP,Nepal,SEARO,171,1572,2,8
2020-06-01,NP,Nepal,SEARO,239,1811,0,8
2020-06-02,NP,Nepal,SEARO,288,2099,0,8
2020-06-03,NP,Nepal,SEARO,201,2300,1,9
2020-06-04,NP,Nepal,SEARO,334,2634,1,10
2020-06-05,NP,Nepal,SEARO,278,2912,2,12
2020-06-06,NP,Nepal,SEARO,323,3235,2,14
2020-06-07,NP,Nepal,SEARO,213,3448,0,14
2020-06-08,NP,Nepal,SEARO,314,3762,1,15
2020-03-29,NL,Netherlands,EURO,1146,9650,89,631
2020-03-30,NL,Netherlands,EURO,1092,10742,125,756
2020-03-31,NL,Netherlands,EURO,873,11615,90,846
2020-04-01,NL,Netherlands,EURO,834,12449,172,1018
2020-04-02,NL,Netherlands,EURO,1008,13457,134,1152
2020-04-03,NL,Netherlands,EURO,1083,14540,164,1316
2020-04-04,NL,Netherlands,EURO,1020,15560,142,1458
2020-04-05,NL,Netherlands,EURO,1002,16562,177,1635
2020-04-06,NL,Netherlands,EURO,1099,17661,105,1740
2020-04-07,NL,Netherlands,EURO,945,18606,101,1841
2020-04-08,NL,Netherlands,EURO,782,19388,232,2073
2020-04-09,NL,Netherlands,EURO,959,20347,148,2221
2020-04-10,NL,Netherlands,EURO,1208,21555,145,2366
2020-04-11,NL,Netherlands,EURO,1327,22882,114,2480
2020-04-12,NL,Netherlands,EURO,1301,24183,134,2614
2020-04-13,NL,Netherlands,EURO,1171,25354,94,2708
2020-04-14,NL,Netherlands,EURO,959,26313,85,2793
2020-04-15,NL,Netherlands,EURO,862,27175,122,2915
2020-04-16,NL,Netherlands,EURO,730,27905,185,3100
2020-04-17,NL,Netherlands,EURO,1069,28974,185,3285
2020-04-18,NL,Netherlands,EURO,1234,30208,144,3429
2020-04-19,NL,Netherlands,EURO,1186,31394,144,3573
2020-04-20,NL,Netherlands,EURO,1023,32417,80,3653
2020-04-21,NL,Netherlands,EURO,748,33165,65,3718
2020-04-22,NL,Netherlands,EURO,716,33881,162,3880
2020-04-23,NL,Netherlands,EURO,708,34589,141,4021
2020-04-24,NL,Netherlands,EURO,874,35463,129,4150
2020-04-25,NL,Netherlands,EURO,805,36268,111,4261
2020-04-26,NL,Netherlands,EURO,647,36915,120,4381
2020-04-27,NL,Netherlands,EURO,651,37566,65,4446
2020-04-28,NL,Netherlands,EURO,405,37971,43,4489
2020-04-29,NL,Netherlands,EURO,193,38164,58,4547
2020-04-30,NL,Netherlands,EURO,388,38552,136,4683
2020-05-01,NL,Netherlands,EURO,507,39059,82,4765
2020-05-02,NL,Netherlands,EURO,478,39537,100,4865
2020-05-03,NL,Netherlands,EURO,437,39974,93,4958
2020-05-04,NL,Netherlands,EURO,338,40312,68,5026
2020-05-05,NL,Netherlands,EURO,201,40513,27,5053
2020-05-06,NL,Netherlands,EURO,319,40832,82,5135
2020-05-07,NL,Netherlands,EURO,319,41151,40,5175
2020-05-08,NL,Netherlands,EURO,361,41512,84,5259
2020-05-09,NL,Netherlands,EURO,319,41831,72,5331
2020-05-10,NL,Netherlands,EURO,288,42119,64,5395
2020-05-11,NL,Netherlands,EURO,242,42361,18,5413
2020-05-12,NL,Netherlands,EURO,179,42540,16,5429
2020-05-13,NL,Netherlands,EURO,195,42735,55,5484
2020-05-14,NL,Netherlands,EURO,223,42958,49,5533
2020-05-15,NL,Netherlands,EURO,274,43232,29,5562
2020-05-16,NL,Netherlands,EURO,202,43434,54,5616
2020-05-17,NL,Netherlands,EURO,194,43628,25,5641
2020-05-18,NL,Netherlands,EURO,125,43753,11,5652
2020-05-19,NL,Netherlands,EURO,148,43901,16,5668
2020-05-20,NL,Netherlands,EURO,111,44012,21,5689
2020-05-21,NL,Netherlands,EURO,187,44199,32,5721
2020-05-22,NL,Netherlands,EURO,254,44453,28,5749
2020-05-23,NL,Netherlands,EURO,184,44637,13,5762
2020-05-24,NL,Netherlands,EURO,177,44814,22,5784
2020-05-25,NL,Netherlands,EURO,173,44987,11,5795
2020-05-26,NL,Netherlands,EURO,213,45200,8,5803
2020-05-27,NL,Netherlands,EURO,129,45329,23,5826
2020-05-28,NL,Netherlands,EURO,194,45523,15,5841
2020-05-29,NL,Netherlands,EURO,178,45701,31,5872
2020-05-30,NL,Netherlands,EURO,178,45879,25,5897
2020-05-31,NL,Netherlands,EURO,141,46020,21,5918
2020-06-01,NL,Netherlands,EURO,176,46196,3,5921
2020-06-02,NL,Netherlands,EURO,104,46300,6,5927
2020-06-03,NL,Netherlands,EURO,95,46395,4,5931
2020-06-04,NL,Netherlands,EURO,93,46488,12,5943
2020-06-05,NL,Netherlands,EURO,188,46676,15,5958
2020-06-06,NL,Netherlands,EURO,217,46893,13,5971
2020-06-07,NL,Netherlands,EURO,190,47083,7,5978
2020-06-08,NL,Netherlands,EURO,239,47322,3,5981
2020-03-29,NC,New Caledonia,WPRO,0,15,0,0
2020-03-30,NC,New Caledonia,WPRO,0,15,0,0
2020-03-31,NC,New Caledonia,WPRO,0,15,0,0
2020-04-01,NC,New Caledonia,WPRO,1,16,0,0
2020-04-02,NC,New Caledonia,WPRO,0,16,0,0
2020-04-03,NC,New Caledonia,WPRO,2,18,0,0
2020-04-04,NC,New Caledonia,WPRO,0,18,0,0
2020-04-05,NC,New Caledonia,WPRO,0,18,0,0
2020-04-06,NC,New Caledonia,WPRO,0,18,0,0
2020-04-07,NC,New Caledonia,WPRO,0,18,0,0
2020-04-08,NC,New Caledonia,WPRO,0,18,0,0
2020-04-09,NC,New Caledonia,WPRO,0,18,0,0
2020-04-10,NC,New Caledonia,WPRO,0,18,0,0
2020-04-11,NC,New Caledonia,WPRO,0,18,0,0
2020-04-12,NC,New Caledonia,WPRO,0,18,0,0
2020-04-13,NC,New Caledonia,WPRO,0,18,0,0
2020-04-14,NC,New Caledonia,WPRO,0,18,0,0
2020-04-15,NC,New Caledonia,WPRO,0,18,0,0
2020-04-16,NC,New Caledonia,WPRO,0,18,0,0
2020-04-17,NC,New Caledonia,WPRO,0,18,0,0
2020-04-18,NC,New Caledonia,WPRO,0,18,0,0
2020-04-19,NC,New Caledonia,WPRO,0,18,0,0
2020-04-20,NC,New Caledonia,WPRO,0,18,0,0
2020-04-21,NC,New Caledonia,WPRO,0,18,0,0
2020-04-22,NC,New Caledonia,WPRO,0,18,0,0
2020-04-23,NC,New Caledonia,WPRO,0,18,0,0
2020-04-24,NC,New Caledonia,WPRO,0,18,0,0
2020-04-25,NC,New Caledonia,WPRO,0,18,0,0
2020-04-26,NC,New Caledonia,WPRO,0,18,0,0
2020-04-27,NC,New Caledonia,WPRO,0,18,0,0
2020-04-28,NC,New Caledonia,WPRO,0,18,0,0
2020-04-29,NC,New Caledonia,WPRO,0,18,0,0
2020-04-30,NC,New Caledonia,WPRO,0,18,0,0
2020-05-01,NC,New Caledonia,WPRO,0,18,0,0
2020-05-02,NC,New Caledonia,WPRO,0,18,0,0
2020-05-03,NC,New Caledonia,WPRO,0,18,0,0
2020-05-04,NC,New Caledonia,WPRO,0,18,0,0
2020-05-05,NC,New Caledonia,WPRO,0,18,0,0
2020-05-06,NC,New Caledonia,WPRO,0,18,0,0
2020-05-07,NC,New Caledonia,WPRO,0,18,0,0
2020-05-08,NC,New Caledonia,WPRO,0,18,0,0
2020-05-09,NC,New Caledonia,WPRO,0,18,0,0
2020-05-10,NC,New Caledonia,WPRO,0,18,0,0
2020-05-11,NC,New Caledonia,WPRO,0,18,0,0
2020-05-12,NC,New Caledonia,WPRO,0,18,0,0
2020-05-13,NC,New Caledonia,WPRO,0,18,0,0
2020-05-14,NC,New Caledonia,WPRO,0,18,0,0
2020-05-15,NC,New Caledonia,WPRO,0,18,0,0
2020-05-16,NC,New Caledonia,WPRO,0,18,0,0
2020-05-17,NC,New Caledonia,WPRO,0,18,0,0
2020-05-18,NC,New Caledonia,WPRO,0,18,0,0
2020-05-19,NC,New Caledonia,WPRO,0,18,0,0
2020-05-20,NC,New Caledonia,WPRO,0,18,0,0
2020-05-21,NC,New Caledonia,WPRO,0,18,0,0
2020-05-22,NC,New Caledonia,WPRO,0,18,0,0
2020-05-23,NC,New Caledonia,WPRO,0,18,0,0
2020-05-24,NC,New Caledonia,WPRO,0,18,0,0
2020-05-25,NC,New Caledonia,WPRO,0,18,0,0
2020-05-26,NC,New Caledonia,WPRO,0,18,0,0
2020-05-27,NC,New Caledonia,WPRO,0,18,0,0
2020-05-28,NC,New Caledonia,WPRO,0,18,0,0
2020-05-29,NC,New Caledonia,WPRO,1,19,0,0
2020-05-30,NC,New Caledonia,WPRO,0,19,0,0
2020-05-31,NC,New Caledonia,WPRO,0,19,0,0
2020-06-01,NC,New Caledonia,WPRO,0,19,0,0
2020-06-02,NC,New Caledonia,WPRO,0,19,0,0
2020-06-03,NC,New Caledonia,WPRO,0,19,0,0
2020-06-04,NC,New Caledonia,WPRO,0,19,0,0
2020-06-05,NC,New Caledonia,WPRO,1,20,0,0
2020-06-06,NC,New Caledonia,WPRO,0,20,0,0
2020-06-07,NC,New Caledonia,WPRO,0,20,0,0
2020-06-08,NC,New Caledonia,WPRO,0,20,0,0
2020-03-29,NZ,New Zealand,WPRO,60,476,1,1
2020-03-30,NZ,New Zealand,WPRO,76,552,0,1
2020-03-31,NZ,New Zealand,WPRO,48,600,0,1
2020-04-01,NZ,New Zealand,WPRO,47,647,0,1
2020-04-02,NZ,New Zealand,WPRO,76,723,0,1
2020-04-03,NZ,New Zealand,WPRO,51,774,0,1
2020-04-04,NZ,New Zealand,WPRO,50,824,0,1
2020-04-05,NZ,New Zealand,WPRO,48,872,0,1
2020-04-06,NZ,New Zealand,WPRO,39,911,0,1
2020-04-07,NZ,New Zealand,WPRO,32,943,0,1
2020-04-08,NZ,New Zealand,WPRO,26,969,0,1
2020-04-09,NZ,New Zealand,WPRO,23,992,0,1
2020-04-10,NZ,New Zealand,WPRO,23,1015,1,2
2020-04-11,NZ,New Zealand,WPRO,20,1035,2,4
2020-04-12,NZ,New Zealand,WPRO,14,1049,0,4
2020-04-13,NZ,New Zealand,WPRO,15,1064,1,5
2020-04-14,NZ,New Zealand,WPRO,8,1072,4,9
2020-04-15,NZ,New Zealand,WPRO,6,1078,0,9
2020-04-16,NZ,New Zealand,WPRO,6,1084,0,9
2020-04-17,NZ,New Zealand,WPRO,2,1086,2,11
2020-04-18,NZ,New Zealand,WPRO,8,1094,0,11
2020-04-19,NZ,New Zealand,WPRO,4,1098,0,11
2020-04-20,NZ,New Zealand,WPRO,7,1105,1,12
2020-04-21,NZ,New Zealand,WPRO,2,1107,1,13
2020-04-22,NZ,New Zealand,WPRO,3,1110,1,14
2020-04-23,NZ,New Zealand,WPRO,2,1112,2,16
2020-04-24,NZ,New Zealand,WPRO,2,1114,1,17
2020-04-25,NZ,New Zealand,WPRO,3,1117,1,18
2020-04-26,NZ,New Zealand,WPRO,4,1121,0,18
2020-04-27,NZ,New Zealand,WPRO,1,1122,1,19
2020-04-28,NZ,New Zealand,WPRO,2,1124,0,19
2020-04-29,NZ,New Zealand,WPRO,2,1126,0,19
2020-04-30,NZ,New Zealand,WPRO,3,1129,0,19
2020-05-01,NZ,New Zealand,WPRO,3,1132,0,19
2020-05-02,NZ,New Zealand,WPRO,2,1134,1,20
2020-05-03,NZ,New Zealand,WPRO,2,1136,0,20
2020-05-04,NZ,New Zealand,WPRO,1,1137,0,20
2020-05-05,NZ,New Zealand,WPRO,0,1137,0,20
2020-05-06,NZ,New Zealand,WPRO,1,1138,1,21
2020-05-07,NZ,New Zealand,WPRO,1,1139,0,21
2020-05-08,NZ,New Zealand,WPRO,2,1141,0,21
2020-05-09,NZ,New Zealand,WPRO,1,1142,0,21
2020-05-10,NZ,New Zealand,WPRO,2,1144,0,21
2020-05-11,NZ,New Zealand,WPRO,3,1147,0,21
2020-05-12,NZ,New Zealand,WPRO,0,1147,0,21
2020-05-13,NZ,New Zealand,WPRO,0,1147,0,21
2020-05-14,NZ,New Zealand,WPRO,0,1147,0,21
2020-05-15,NZ,New Zealand,WPRO,1,1148,0,21
2020-05-16,NZ,New Zealand,WPRO,0,1148,0,21
2020-05-17,NZ,New Zealand,WPRO,1,1149,0,21
2020-05-18,NZ,New Zealand,WPRO,0,1149,0,21
2020-05-19,NZ,New Zealand,WPRO,4,1153,0,21
2020-05-20,NZ,New Zealand,WPRO,0,1153,0,21
2020-05-21,NZ,New Zealand,WPRO,0,1153,0,21
2020-05-22,NZ,New Zealand,WPRO,1,1154,0,21
2020-05-23,NZ,New Zealand,WPRO,0,1154,0,21
2020-05-24,NZ,New Zealand,WPRO,0,1154,0,21
2020-05-25,NZ,New Zealand,WPRO,0,1154,0,21
2020-05-26,NZ,New Zealand,WPRO,0,1154,0,21
2020-05-27,NZ,New Zealand,WPRO,0,1154,0,21
2020-05-28,NZ,New Zealand,WPRO,0,1154,1,22
2020-05-29,NZ,New Zealand,WPRO,0,1154,0,22
2020-05-30,NZ,New Zealand,WPRO,0,1154,0,22
2020-05-31,NZ,New Zealand,WPRO,0,1154,0,22
2020-06-01,NZ,New Zealand,WPRO,0,1154,0,22
2020-06-02,NZ,New Zealand,WPRO,0,1154,0,22
2020-06-03,NZ,New Zealand,WPRO,0,1154,0,22
2020-06-04,NZ,New Zealand,WPRO,0,1154,0,22
2020-06-05,NZ,New Zealand,WPRO,0,1154,0,22
2020-06-06,NZ,New Zealand,WPRO,0,1154,0,22
2020-06-07,NZ,New Zealand,WPRO,0,1154,0,22
2020-06-08,NZ,New Zealand,WPRO,0,1154,0,22
2020-03-29,NI,Nicaragua,AMRO,0,2,0,1
2020-03-30,NI,Nicaragua,AMRO,2,4,0,1
2020-03-31,NI,Nicaragua,AMRO,0,4,0,1
2020-04-01,NI,Nicaragua,AMRO,1,5,0,1
2020-04-02,NI,Nicaragua,AMRO,0,5,0,1
2020-04-03,NI,Nicaragua,AMRO,0,5,0,1
2020-04-04,NI,Nicaragua,AMRO,0,5,0,1
2020-04-05,NI,Nicaragua,AMRO,0,5,0,1
2020-04-06,NI,Nicaragua,AMRO,0,5,0,1
2020-04-07,NI,Nicaragua,AMRO,1,6,0,1
2020-04-08,NI,Nicaragua,AMRO,0,6,0,1
2020-04-09,NI,Nicaragua,AMRO,0,6,0,1
2020-04-10,NI,Nicaragua,AMRO,0,6,0,1
2020-04-11,NI,Nicaragua,AMRO,1,7,0,1
2020-04-12,NI,Nicaragua,AMRO,0,7,0,1
2020-04-13,NI,Nicaragua,AMRO,2,9,0,1
2020-04-14,NI,Nicaragua,AMRO,0,9,0,1
2020-04-15,NI,Nicaragua,AMRO,0,9,0,1
2020-04-16,NI,Nicaragua,AMRO,0,9,0,1
2020-04-17,NI,Nicaragua,AMRO,0,9,0,1
2020-04-18,NI,Nicaragua,AMRO,0,9,0,1
2020-04-19,NI,Nicaragua,AMRO,0,9,0,1
2020-04-20,NI,Nicaragua,AMRO,0,9,0,1
2020-04-21,NI,Nicaragua,AMRO,0,9,1,2
2020-04-22,NI,Nicaragua,AMRO,1,10,0,2
2020-04-23,NI,Nicaragua,AMRO,0,10,0,2
2020-04-24,NI,Nicaragua,AMRO,0,10,0,2
2020-04-25,NI,Nicaragua,AMRO,1,11,1,3
2020-04-26,NI,Nicaragua,AMRO,0,11,0,3
2020-04-27,NI,Nicaragua,AMRO,2,13,0,3
2020-04-28,NI,Nicaragua,AMRO,0,13,0,3
2020-04-29,NI,Nicaragua,AMRO,0,13,0,3
2020-04-30,NI,Nicaragua,AMRO,0,13,0,3
2020-05-01,NI,Nicaragua,AMRO,1,14,1,4
2020-05-02,NI,Nicaragua,AMRO,0,14,0,4
2020-05-03,NI,Nicaragua,AMRO,0,14,0,4
2020-05-04,NI,Nicaragua,AMRO,0,14,0,4
2020-05-05,NI,Nicaragua,AMRO,1,15,1,5
2020-05-06,NI,Nicaragua,AMRO,0,15,0,5
2020-05-07,NI,Nicaragua,AMRO,1,16,0,5
2020-05-08,NI,Nicaragua,AMRO,0,16,0,5
2020-05-09,NI,Nicaragua,AMRO,0,16,0,5
2020-05-10,NI,Nicaragua,AMRO,0,16,0,5
2020-05-11,NI,Nicaragua,AMRO,0,16,0,5
2020-05-12,NI,Nicaragua,AMRO,0,16,0,5
2020-05-13,NI,Nicaragua,AMRO,0,16,0,5
2020-05-14,NI,Nicaragua,AMRO,9,25,3,8
2020-05-15,NI,Nicaragua,AMRO,0,25,0,8
2020-05-16,NI,Nicaragua,AMRO,0,25,0,8
2020-05-17,NI,Nicaragua,AMRO,0,25,0,8
2020-05-18,NI,Nicaragua,AMRO,0,25,0,8
2020-05-19,NI,Nicaragua,AMRO,0,25,0,8
2020-05-20,NI,Nicaragua,AMRO,0,25,0,8
2020-05-21,NI,Nicaragua,AMRO,254,279,9,17
2020-05-22,NI,Nicaragua,AMRO,0,279,0,17
2020-05-23,NI,Nicaragua,AMRO,0,279,0,17
2020-05-24,NI,Nicaragua,AMRO,0,279,0,17
2020-05-25,NI,Nicaragua,AMRO,0,279,0,17
2020-05-26,NI,Nicaragua,AMRO,0,279,0,17
2020-05-27,NI,Nicaragua,AMRO,0,279,0,17
2020-05-28,NI,Nicaragua,AMRO,480,759,18,35
2020-05-29,NI,Nicaragua,AMRO,126,885,0,35
2020-05-30,NI,Nicaragua,AMRO,0,885,0,35
2020-05-31,NI,Nicaragua,AMRO,0,885,0,35
2020-06-01,NI,Nicaragua,AMRO,0,885,0,35
2020-06-02,NI,Nicaragua,AMRO,0,885,0,35
2020-06-03,NI,Nicaragua,AMRO,65,950,0,35
2020-06-04,NI,Nicaragua,AMRO,359,1309,11,46
2020-06-05,NI,Nicaragua,AMRO,0,1309,0,46
2020-06-06,NI,Nicaragua,AMRO,0,1309,0,46
2020-06-07,NI,Nicaragua,AMRO,0,1309,0,46
2020-06-08,NI,Nicaragua,AMRO,0,1309,0,46
2020-03-29,NE,Niger,AFRO,2,20,0,55
2020-03-30,NE,Niger,AFRO,6,26,0,55
2020-03-31,NE,Niger,AFRO,16,42,0,55
2020-04-01,NE,Niger,AFRO,31,73,0,55
2020-04-02,NE,Niger,AFRO,29,102,2,57
2020-04-03,NE,Niger,AFRO,22,124,0,57
2020-04-04,NE,Niger,AFRO,20,144,0,57
2020-04-05,NE,Niger,AFRO,0,144,0,57
2020-04-06,NE,Niger,AFRO,109,253,1,58
2020-04-07,NE,Niger,AFRO,25,278,0,58
2020-04-08,NE,Niger,AFRO,64,342,0,58
2020-04-09,NE,Niger,AFRO,68,410,0,58
2020-04-10,NE,Niger,AFRO,28,438,0,58
2020-04-11,NE,Niger,AFRO,53,491,0,58
2020-04-12,NE,Niger,AFRO,38,529,0,58
2020-04-13,NE,Niger,AFRO,19,548,0,58
2020-04-14,NE,Niger,AFRO,22,570,0,58
2020-04-15,NE,Niger,AFRO,14,584,0,58
2020-04-16,NE,Niger,AFRO,25,609,0,58
2020-04-17,NE,Niger,AFRO,18,627,0,58
2020-04-18,NE,Niger,AFRO,12,639,0,58
2020-04-19,NE,Niger,AFRO,9,648,0,58
2020-04-20,NE,Niger,AFRO,7,655,0,58
2020-04-21,NE,Niger,AFRO,2,657,0,58
2020-04-22,NE,Niger,AFRO,5,662,0,58
2020-04-23,NE,Niger,AFRO,9,671,0,58
2020-04-24,NE,Niger,AFRO,0,671,0,58
2020-04-25,NE,Niger,AFRO,10,681,0,58
2020-04-26,NE,Niger,AFRO,3,684,0,58
2020-04-27,NE,Niger,AFRO,12,696,0,58
2020-04-28,NE,Niger,AFRO,5,701,0,58
2020-04-29,NE,Niger,AFRO,8,709,0,58
2020-04-30,NE,Niger,AFRO,4,713,0,58
2020-05-01,NE,Niger,AFRO,6,719,0,58
2020-05-02,NE,Niger,AFRO,9,728,0,58
2020-05-03,NE,Niger,AFRO,8,736,2,60
2020-05-04,NE,Niger,AFRO,14,750,1,61
2020-05-05,NE,Niger,AFRO,5,755,1,62
2020-05-06,NE,Niger,AFRO,8,763,1,63
2020-05-07,NE,Niger,AFRO,7,770,0,63
2020-05-08,NE,Niger,AFRO,11,781,4,67
2020-05-09,NE,Niger,AFRO,14,795,2,69
2020-05-10,NE,Niger,AFRO,20,815,1,70
2020-05-11,NE,Niger,AFRO,6,821,0,70
2020-05-12,NE,Niger,AFRO,11,832,0,70
2020-05-13,NE,Niger,AFRO,22,854,1,71
2020-05-14,NE,Niger,AFRO,6,860,2,73
2020-05-15,NE,Niger,AFRO,16,876,1,74
2020-05-16,NE,Niger,AFRO,9,885,1,75
2020-05-17,NE,Niger,AFRO,4,889,0,75
2020-05-18,NE,Niger,AFRO,15,904,3,78
2020-05-19,NE,Niger,AFRO,5,909,1,79
2020-05-20,NE,Niger,AFRO,5,914,0,79
2020-05-21,NE,Niger,AFRO,6,920,3,82
2020-05-22,NE,Niger,AFRO,4,924,2,84
2020-05-23,NE,Niger,AFRO,13,937,0,84
2020-05-24,NE,Niger,AFRO,6,943,1,85
2020-05-25,NE,Niger,AFRO,2,945,0,85
2020-05-26,NE,Niger,AFRO,6,951,1,86
2020-05-27,NE,Niger,AFRO,1,952,1,87
2020-05-28,NE,Niger,AFRO,3,955,1,88
2020-05-29,NE,Niger,AFRO,0,955,0,88
2020-05-30,NE,Niger,AFRO,1,956,0,88
2020-05-31,NE,Niger,AFRO,0,956,0,88
2020-06-01,NE,Niger,AFRO,2,958,0,88
2020-06-02,NE,Niger,AFRO,0,958,1,89
2020-06-03,NE,Niger,AFRO,2,960,0,89
2020-06-04,NE,Niger,AFRO,1,961,0,89
2020-06-05,NE,Niger,AFRO,2,963,0,89
2020-06-06,NE,Niger,AFRO,3,966,0,89
2020-06-07,NE,Niger,AFRO,4,970,0,89
2020-06-08,NE,Niger,AFRO,3,973,0,89
2020-03-29,NG,Nigeria,AFRO,17,97,0,3
2020-03-30,NG,Nigeria,AFRO,14,111,0,3
2020-03-31,NG,Nigeria,AFRO,25,136,1,4
2020-04-01,NG,Nigeria,AFRO,15,151,0,4
2020-04-02,NG,Nigeria,AFRO,23,174,0,4
2020-04-03,NG,Nigeria,AFRO,10,184,0,4
2020-04-04,NG,Nigeria,AFRO,25,209,2,6
2020-04-05,NG,Nigeria,AFRO,5,214,1,7
2020-04-06,NG,Nigeria,AFRO,18,232,0,7
2020-04-07,NG,Nigeria,AFRO,6,238,0,7
2020-04-08,NG,Nigeria,AFRO,16,254,1,8
2020-04-09,NG,Nigeria,AFRO,22,276,0,8
2020-04-10,NG,Nigeria,AFRO,12,288,1,9
2020-04-11,NG,Nigeria,AFRO,17,305,0,9
2020-04-12,NG,Nigeria,AFRO,13,318,3,12
2020-04-13,NG,Nigeria,AFRO,5,323,0,12
2020-04-14,NG,Nigeria,AFRO,20,343,1,13
2020-04-15,NG,Nigeria,AFRO,30,373,0,13
2020-04-16,NG,Nigeria,AFRO,34,407,1,14
2020-04-17,NG,Nigeria,AFRO,35,442,1,15
2020-04-18,NG,Nigeria,AFRO,51,493,4,19
2020-04-19,NG,Nigeria,AFRO,48,541,2,21
2020-04-20,NG,Nigeria,AFRO,86,627,2,23
2020-04-21,NG,Nigeria,AFRO,38,665,1,24
2020-04-22,NG,Nigeria,AFRO,117,782,3,27
2020-04-23,NG,Nigeria,AFRO,91,873,3,30
2020-04-24,NG,Nigeria,AFRO,108,981,3,33
2020-04-25,NG,Nigeria,AFRO,114,1095,1,34
2020-04-26,NG,Nigeria,AFRO,87,1182,3,37
2020-04-27,NG,Nigeria,AFRO,91,1273,5,42
2020-04-28,NG,Nigeria,AFRO,64,1337,0,42
2020-04-29,NG,Nigeria,AFRO,195,1532,4,46
2020-04-30,NG,Nigeria,AFRO,196,1728,7,53
2020-05-01,NG,Nigeria,AFRO,204,1932,7,60
2020-05-02,NG,Nigeria,AFRO,238,2170,10,70
2020-05-03,NG,Nigeria,AFRO,218,2388,17,87
2020-05-04,NG,Nigeria,AFRO,170,2558,0,87
2020-05-05,NG,Nigeria,AFRO,244,2802,6,93
2020-05-06,NG,Nigeria,AFRO,148,2950,5,98
2020-05-07,NG,Nigeria,AFRO,195,3145,5,103
2020-05-08,NG,Nigeria,AFRO,381,3526,4,107
2020-05-09,NG,Nigeria,AFRO,386,3912,10,117
2020-05-10,NG,Nigeria,AFRO,239,4151,11,128
2020-05-11,NG,Nigeria,AFRO,248,4399,15,143
2020-05-12,NG,Nigeria,AFRO,242,4641,7,150
2020-05-13,NG,Nigeria,AFRO,146,4787,8,158
2020-05-14,NG,Nigeria,AFRO,184,4971,6,164
2020-05-15,NG,Nigeria,AFRO,191,5162,3,167
2020-05-16,NG,Nigeria,AFRO,288,5450,4,171
2020-05-17,NG,Nigeria,AFRO,171,5621,5,176
2020-05-18,NG,Nigeria,AFRO,338,5959,6,182
2020-05-19,NG,Nigeria,AFRO,216,6175,9,191
2020-05-20,NG,Nigeria,AFRO,226,6401,1,192
2020-05-21,NG,Nigeria,AFRO,276,6677,10,202
2020-05-22,NG,Nigeria,AFRO,339,7016,9,211
2020-05-23,NG,Nigeria,AFRO,245,7261,10,221
2020-05-24,NG,Nigeria,AFRO,265,7526,0,221
2020-05-25,NG,Nigeria,AFRO,313,7839,5,226
2020-05-26,NG,Nigeria,AFRO,229,8068,7,233
2020-05-27,NG,Nigeria,AFRO,276,8344,16,249
2020-05-28,NG,Nigeria,AFRO,389,8733,5,254
2020-05-29,NG,Nigeria,AFRO,182,8915,5,259
2020-05-30,NG,Nigeria,AFRO,387,9302,2,261
2020-05-31,NG,Nigeria,AFRO,553,9855,12,273
2020-06-01,NG,Nigeria,AFRO,307,10162,14,287
2020-06-02,NG,Nigeria,AFRO,416,10578,12,299
2020-06-03,NG,Nigeria,AFRO,241,10819,15,314
2020-06-04,NG,Nigeria,AFRO,347,11166,1,315
2020-06-05,NG,Nigeria,AFRO,350,11516,8,323
2020-06-06,NG,Nigeria,AFRO,328,11844,10,333
2020-06-07,NG,Nigeria,AFRO,389,12233,9,342
2020-06-08,NG,Nigeria,AFRO,253,12486,12,354
2020-03-29,NU,Niue,WPRO,0,0,0,0
2020-03-30,NU,Niue,WPRO,0,0,0,0
2020-03-31,NU,Niue,WPRO,0,0,0,0
2020-04-01,NU,Niue,WPRO,0,0,0,0
2020-04-02,NU,Niue,WPRO,0,0,0,0
2020-04-03,NU,Niue,WPRO,0,0,0,0
2020-04-04,NU,Niue,WPRO,0,0,0,0
2020-04-05,NU,Niue,WPRO,0,0,0,0
2020-04-06,NU,Niue,WPRO,0,0,0,0
2020-04-07,NU,Niue,WPRO,0,0,0,0
2020-04-08,NU,Niue,WPRO,0,0,0,0
2020-04-09,NU,Niue,WPRO,0,0,0,0
2020-04-10,NU,Niue,WPRO,0,0,0,0
2020-04-11,NU,Niue,WPRO,0,0,0,0
2020-04-12,NU,Niue,WPRO,0,0,0,0
2020-04-13,NU,Niue,WPRO,0,0,0,0
2020-04-14,NU,Niue,WPRO,0,0,0,0
2020-04-15,NU,Niue,WPRO,0,0,0,0
2020-04-16,NU,Niue,WPRO,0,0,0,0
2020-04-17,NU,Niue,WPRO,0,0,0,0
2020-04-18,NU,Niue,WPRO,0,0,0,0
2020-04-19,NU,Niue,WPRO,0,0,0,0
2020-04-20,NU,Niue,WPRO,0,0,0,0
2020-04-21,NU,Niue,WPRO,0,0,0,0
2020-04-22,NU,Niue,WPRO,0,0,0,0
2020-04-23,NU,Niue,WPRO,0,0,0,0
2020-04-24,NU,Niue,WPRO,0,0,0,0
2020-04-25,NU,Niue,WPRO,0,0,0,0
2020-04-26,NU,Niue,WPRO,0,0,0,0
2020-04-27,NU,Niue,WPRO,0,0,0,0
2020-04-28,NU,Niue,WPRO,0,0,0,0
2020-04-29,NU,Niue,WPRO,0,0,0,0
2020-04-30,NU,Niue,WPRO,0,0,0,0
2020-05-01,NU,Niue,WPRO,0,0,0,0
2020-05-02,NU,Niue,WPRO,0,0,0,0
2020-05-03,NU,Niue,WPRO,0,0,0,0
2020-05-04,NU,Niue,WPRO,0,0,0,0
2020-05-05,NU,Niue,WPRO,0,0,0,0
2020-05-06,NU,Niue,WPRO,0,0,0,0
2020-05-07,NU,Niue,WPRO,0,0,0,0
2020-05-08,NU,Niue,WPRO,0,0,0,0
2020-05-09,NU,Niue,WPRO,0,0,0,0
2020-05-10,NU,Niue,WPRO,0,0,0,0
2020-05-11,NU,Niue,WPRO,0,0,0,0
2020-05-12,NU,Niue,WPRO,0,0,0,0
2020-05-13,NU,Niue,WPRO,0,0,0,0
2020-05-14,NU,Niue,WPRO,0,0,0,0
2020-05-15,NU,Niue,WPRO,0,0,0,0
2020-05-16,NU,Niue,WPRO,0,0,0,0
2020-05-17,NU,Niue,WPRO,0,0,0,0
2020-05-18,NU,Niue,WPRO,0,0,0,0
2020-05-19,NU,Niue,WPRO,0,0,0,0
2020-05-20,NU,Niue,WPRO,0,0,0,0
2020-05-21,NU,Niue,WPRO,0,0,0,0
2020-05-22,NU,Niue,WPRO,0,0,0,0
2020-05-23,NU,Niue,WPRO,0,0,0,0
2020-05-24,NU,Niue,WPRO,0,0,0,0
2020-05-25,NU,Niue,WPRO,0,0,0,0
2020-05-26,NU,Niue,WPRO,0,0,0,0
2020-05-27,NU,Niue,WPRO,0,0,0,0
2020-05-28,NU,Niue,WPRO,0,0,0,0
2020-05-29,NU,Niue,WPRO,0,0,0,0
2020-05-30,NU,Niue,WPRO,0,0,0,0
2020-05-31,NU,Niue,WPRO,0,0,0,0
2020-06-01,NU,Niue,WPRO,0,0,0,0
2020-06-02,NU,Niue,WPRO,0,0,0,0
2020-06-03,NU,Niue,WPRO,0,0,0,0
2020-06-04,NU,Niue,WPRO,0,0,0,0
2020-06-05,NU,Niue,WPRO,0,0,0,0
2020-06-06,NU,Niue,WPRO,0,0,0,0
2020-06-07,NU,Niue,WPRO,0,0,0,0
2020-06-08,NU,Niue,WPRO,0,0,0,0
2020-03-29,MK,North Macedonia,EURO,18,259,0,4
2020-03-30,MK,North Macedonia,EURO,26,285,3,7
2020-03-31,MK,North Macedonia,EURO,44,329,2,9
2020-04-01,MK,North Macedonia,EURO,25,354,2,11
2020-04-02,MK,North Macedonia,EURO,30,384,0,11
2020-04-03,MK,North Macedonia,EURO,46,430,1,12
2020-04-04,MK,North Macedonia,EURO,53,483,5,17
2020-04-05,MK,North Macedonia,EURO,72,555,1,18
2020-04-06,MK,North Macedonia,EURO,15,570,3,21
2020-04-07,MK,North Macedonia,EURO,29,599,6,27
2020-04-08,MK,North Macedonia,EURO,18,617,2,29
2020-04-09,MK,North Macedonia,EURO,46,663,1,30
2020-04-10,MK,North Macedonia,EURO,48,711,2,32
2020-04-11,MK,North Macedonia,EURO,49,760,2,34
2020-04-12,MK,North Macedonia,EURO,68,828,0,34
2020-04-13,MK,North Macedonia,EURO,26,854,4,38
2020-04-14,MK,North Macedonia,EURO,54,908,6,44
2020-04-15,MK,North Macedonia,EURO,66,974,1,45
2020-04-16,MK,North Macedonia,EURO,107,1081,1,46
2020-04-17,MK,North Macedonia,EURO,36,1117,3,49
2020-04-18,MK,North Macedonia,EURO,53,1170,0,49
2020-04-19,MK,North Macedonia,EURO,37,1207,2,51
2020-04-20,MK,North Macedonia,EURO,18,1225,3,54
2020-04-21,MK,North Macedonia,EURO,6,1231,1,55
2020-04-22,MK,North Macedonia,EURO,28,1259,1,56
2020-04-23,MK,North Macedonia,EURO,41,1300,0,56
2020-04-24,MK,North Macedonia,EURO,26,1326,1,57
2020-04-25,MK,North Macedonia,EURO,41,1367,2,59
2020-04-26,MK,North Macedonia,EURO,19,1386,2,61
2020-04-27,MK,North Macedonia,EURO,13,1399,4,65
2020-04-28,MK,North Macedonia,EURO,22,1421,6,71
2020-04-29,MK,North Macedonia,EURO,21,1442,2,73
2020-04-30,MK,North Macedonia,EURO,23,1465,4,77
2020-05-01,MK,North Macedonia,EURO,29,1494,4,81
2020-05-02,MK,North Macedonia,EURO,12,1506,1,82
2020-05-03,MK,North Macedonia,EURO,5,1511,2,84
2020-05-04,MK,North Macedonia,EURO,7,1518,1,85
2020-05-05,MK,North Macedonia,EURO,8,1526,1,86
2020-05-06,MK,North Macedonia,EURO,13,1539,2,88
2020-05-07,MK,North Macedonia,EURO,33,1572,1,89
2020-05-08,MK,North Macedonia,EURO,14,1586,1,90
2020-05-09,MK,North Macedonia,EURO,36,1622,1,91
2020-05-10,MK,North Macedonia,EURO,20,1642,0,91
2020-05-11,MK,North Macedonia,EURO,22,1664,0,91
2020-05-12,MK,North Macedonia,EURO,10,1674,1,92
2020-05-13,MK,North Macedonia,EURO,20,1694,3,95
2020-05-14,MK,North Macedonia,EURO,29,1723,0,95
2020-05-15,MK,North Macedonia,EURO,17,1740,2,97
2020-05-16,MK,North Macedonia,EURO,22,1762,1,98
2020-05-17,MK,North Macedonia,EURO,30,1792,3,101
2020-05-18,MK,North Macedonia,EURO,25,1817,3,104
2020-05-19,MK,North Macedonia,EURO,22,1839,2,106
2020-05-20,MK,North Macedonia,EURO,19,1858,4,110
2020-05-21,MK,North Macedonia,EURO,40,1898,1,111
2020-05-22,MK,North Macedonia,EURO,23,1921,1,112
2020-05-23,MK,North Macedonia,EURO,20,1941,1,113
2020-05-24,MK,North Macedonia,EURO,37,1978,0,113
2020-05-25,MK,North Macedonia,EURO,21,1999,0,113
2020-05-26,MK,North Macedonia,EURO,15,2014,3,116
2020-05-27,MK,North Macedonia,EURO,25,2039,3,119
2020-05-28,MK,North Macedonia,EURO,38,2077,3,122
2020-05-29,MK,North Macedonia,EURO,52,2129,4,126
2020-05-30,MK,North Macedonia,EURO,35,2164,5,131
2020-05-31,MK,North Macedonia,EURO,62,2226,2,133
2020-06-01,MK,North Macedonia,EURO,89,2315,7,140
2020-06-02,MK,North Macedonia,EURO,76,2391,1,141
2020-06-03,MK,North Macedonia,EURO,100,2491,4,145
2020-06-04,MK,North Macedonia,EURO,119,2610,2,147
2020-06-05,MK,North Macedonia,EURO,180,2790,2,149
2020-06-06,MK,North Macedonia,EURO,124,2914,2,151
2020-06-07,MK,North Macedonia,EURO,111,3025,2,153
2020-06-08,MK,North Macedonia,EURO,127,3152,3,156
2020-03-29,MP,Northern Mariana Islands (Commonwealth of the),WPRO,0,0,0,0
2020-03-30,MP,Northern Mariana Islands (Commonwealth of the),WPRO,2,2,0,0
2020-03-31,MP,Northern Mariana Islands (Commonwealth of the),WPRO,0,2,0,0
2020-04-01,MP,Northern Mariana Islands (Commonwealth of the),WPRO,0,2,0,0
2020-04-02,MP,Northern Mariana Islands (Commonwealth of the),WPRO,4,6,0,0
2020-04-03,MP,Northern Mariana Islands (Commonwealth of the),WPRO,2,8,1,1
2020-04-04,MP,Northern Mariana Islands (Commonwealth of the),WPRO,0,8,0,1
2020-04-05,MP,Northern Mariana Islands (Commonwealth of the),WPRO,0,8,0,1
2020-04-06,MP,Northern Mariana Islands (Commonwealth of the),WPRO,0,8,0,1
2020-04-07,MP,Northern Mariana Islands (Commonwealth of the),WPRO,0,8,0,1
2020-04-08,MP,Northern Mariana Islands (Commonwealth of the),WPRO,0,8,1,2
2020-04-09,MP,Northern Mariana Islands (Commonwealth of the),WPRO,3,11,0,2
2020-04-10,MP,Northern Mariana Islands (Commonwealth of the),WPRO,0,11,0,2
2020-04-11,MP,Northern Mariana Islands (Commonwealth of the),WPRO,0,11,0,2
2020-04-12,MP,Northern Mariana Islands (Commonwealth of the),WPRO,0,11,0,2
2020-04-13,MP,Northern Mariana Islands (Commonwealth of the),WPRO,0,11,0,2
2020-04-14,MP,Northern Mariana Islands (Commonwealth of the),WPRO,0,11,0,2
2020-04-15,MP,Northern Mariana Islands (Commonwealth of the),WPRO,2,13,0,2
2020-04-16,MP,Northern Mariana Islands (Commonwealth of the),WPRO,0,13,0,2
2020-04-17,MP,Northern Mariana Islands (Commonwealth of the),WPRO,0,13,0,2
2020-04-18,MP,Northern Mariana Islands (Commonwealth of the),WPRO,1,14,0,2
2020-04-19,MP,Northern Mariana Islands (Commonwealth of the),WPRO,0,14,0,2
2020-04-20,MP,Northern Mariana Islands (Commonwealth of the),WPRO,0,14,0,2
2020-04-21,MP,Northern Mariana Islands (Commonwealth of the),WPRO,0,14,0,2
2020-04-22,MP,Northern Mariana Islands (Commonwealth of the),WPRO,0,14,0,2
2020-04-23,MP,Northern Mariana Islands (Commonwealth of the),WPRO,0,14,0,2
2020-04-24,MP,Northern Mariana Islands (Commonwealth of the),WPRO,0,14,0,2
2020-04-25,MP,Northern Mariana Islands (Commonwealth of the),WPRO,0,14,0,2
2020-04-26,MP,Northern Mariana Islands (Commonwealth of the),WPRO,0,14,0,2
2020-04-27,MP,Northern Mariana Islands (Commonwealth of the),WPRO,0,14,0,2
2020-04-28,MP,Northern Mariana Islands (Commonwealth of the),WPRO,0,14,0,2
2020-04-29,MP,Northern Mariana Islands (Commonwealth of the),WPRO,0,14,0,2
2020-04-30,MP,Northern Mariana Islands (Commonwealth of the),WPRO,0,14,0,2
2020-05-01,MP,Northern Mariana Islands (Commonwealth of the),WPRO,0,14,0,2
2020-05-02,MP,Northern Mariana Islands (Commonwealth of the),WPRO,0,14,0,2
2020-05-03,MP,Northern Mariana Islands (Commonwealth of the),WPRO,0,14,0,2
2020-05-04,MP,Northern Mariana Islands (Commonwealth of the),WPRO,0,14,0,2
2020-05-05,MP,Northern Mariana Islands (Commonwealth of the),WPRO,0,14,0,2
2020-05-06,MP,Northern Mariana Islands (Commonwealth of the),WPRO,0,14,0,2
2020-05-07,MP,Northern Mariana Islands (Commonwealth of the),WPRO,1,15,0,2
2020-05-08,MP,Northern Mariana Islands (Commonwealth of the),WPRO,0,15,0,2
2020-05-09,MP,Northern Mariana Islands (Commonwealth of the),WPRO,0,15,0,2
2020-05-10,MP,Northern Mariana Islands (Commonwealth of the),WPRO,1,16,0,2
2020-05-11,MP,Northern Mariana Islands (Commonwealth of the),WPRO,0,16,0,2
2020-05-12,MP,Northern Mariana Islands (Commonwealth of the),WPRO,3,19,0,2
2020-05-13,MP,Northern Mariana Islands (Commonwealth of the),WPRO,0,19,0,2
2020-05-14,MP,Northern Mariana Islands (Commonwealth of the),WPRO,0,19,0,2
2020-05-15,MP,Northern Mariana Islands (Commonwealth of the),WPRO,0,19,0,2
2020-05-16,MP,Northern Mariana Islands (Commonwealth of the),WPRO,0,19,0,2
2020-05-17,MP,Northern Mariana Islands (Commonwealth of the),WPRO,2,21,0,2
2020-05-18,MP,Northern Mariana Islands (Commonwealth of the),WPRO,0,21,0,2
2020-05-19,MP,Northern Mariana Islands (Commonwealth of the),WPRO,0,21,0,2
2020-05-20,MP,Northern Mariana Islands (Commonwealth of the),WPRO,0,21,0,2
2020-05-21,MP,Northern Mariana Islands (Commonwealth of the),WPRO,0,21,0,2
2020-05-22,MP,Northern Mariana Islands (Commonwealth of the),WPRO,1,22,0,2
2020-05-23,MP,Northern Mariana Islands (Commonwealth of the),WPRO,0,22,0,2
2020-05-24,MP,Northern Mariana Islands (Commonwealth of the),WPRO,0,22,0,2
2020-05-25,MP,Northern Mariana Islands (Commonwealth of the),WPRO,0,22,0,2
2020-05-26,MP,Northern Mariana Islands (Commonwealth of the),WPRO,0,22,0,2
2020-05-27,MP,Northern Mariana Islands (Commonwealth of the),WPRO,0,22,0,2
2020-05-28,MP,Northern Mariana Islands (Commonwealth of the),WPRO,0,22,0,2
2020-05-29,MP,Northern Mariana Islands (Commonwealth of the),WPRO,0,22,0,2
2020-05-30,MP,Northern Mariana Islands (Commonwealth of the),WPRO,0,22,0,2
2020-05-31,MP,Northern Mariana Islands (Commonwealth of the),WPRO,0,22,0,2
2020-06-01,MP,Northern Mariana Islands (Commonwealth of the),WPRO,0,22,0,2
2020-06-02,MP,Northern Mariana Islands (Commonwealth of the),WPRO,0,22,0,2
2020-06-03,MP,Northern Mariana Islands (Commonwealth of the),WPRO,1,23,0,2
2020-06-04,MP,Northern Mariana Islands (Commonwealth of the),WPRO,1,24,0,2
2020-06-05,MP,Northern Mariana Islands (Commonwealth of the),WPRO,2,26,0,2
2020-06-06,MP,Northern Mariana Islands (Commonwealth of the),WPRO,0,26,0,2
2020-06-07,MP,Northern Mariana Islands (Commonwealth of the),WPRO,0,26,0,2
2020-06-08,MP,Northern Mariana Islands (Commonwealth of the),WPRO,1,27,0,2
2020-03-29,NO,Norway,EURO,166,4529,4,20
2020-03-30,NO,Norway,EURO,106,4635,2,22
2020-03-31,NO,Norway,EURO,264,4899,4,26
2020-04-01,NO,Norway,EURO,208,5107,2,28
2020-04-02,NO,Norway,EURO,198,5305,4,32
2020-04-03,NO,Norway,EURO,198,5503,10,42
2020-04-04,NO,Norway,EURO,164,5667,2,44
2020-04-05,NO,Norway,EURO,88,5755,6,50
2020-04-06,NO,Norway,EURO,72,5827,8,58
2020-04-07,NO,Norway,EURO,159,5986,1,59
2020-04-08,NO,Norway,EURO,140,6126,10,69
2020-04-09,NO,Norway,EURO,106,6232,11,80
2020-04-10,NO,Norway,EURO,103,6335,8,88
2020-04-11,NO,Norway,EURO,68,6403,4,92
2020-04-12,NO,Norway,EURO,110,6513,6,98
2020-04-13,NO,Norway,EURO,77,6590,5,103
2020-04-14,NO,Norway,EURO,77,6667,11,114
2020-04-15,NO,Norway,EURO,122,6789,13,127
2020-04-16,NO,Norway,EURO,103,6892,3,130
2020-04-17,NO,Norway,EURO,80,6972,6,136
2020-04-18,NO,Norway,EURO,108,7080,0,136
2020-04-19,NO,Norway,EURO,49,7129,12,148
2020-04-20,NO,Norway,EURO,36,7165,6,154
2020-04-21,NO,Norway,EURO,84,7249,0,154
2020-04-22,NO,Norway,EURO,78,7327,9,163
2020-04-23,NO,Norway,EURO,77,7404,6,169
2020-04-24,NO,Norway,EURO,69,7473,11,180
2020-04-25,NO,Norway,EURO,53,7526,11,191
2020-04-26,NO,Norway,EURO,25,7551,2,193
2020-04-27,NO,Norway,EURO,37,7588,0,193
2020-04-28,NO,Norway,EURO,71,7659,0,193
2020-04-29,NO,Norway,EURO,50,7709,2,195
2020-04-30,NO,Norway,EURO,39,7748,7,202
2020-05-01,NO,Norway,EURO,39,7787,2,204
2020-05-02,NO,Norway,EURO,43,7830,0,204
2020-05-03,NO,Norway,EURO,23,7853,0,204
2020-05-04,NO,Norway,EURO,44,7897,4,208
2020-05-05,NO,Norway,EURO,45,7942,0,208
2020-05-06,NO,Norway,EURO,44,7986,1,209
2020-05-07,NO,Norway,EURO,39,8025,0,209
2020-05-08,NO,Norway,EURO,29,8054,0,209
2020-05-09,NO,Norway,EURO,42,8096,4,213
2020-05-10,NO,Norway,EURO,11,8107,0,213
2020-05-11,NO,Norway,EURO,12,8119,4,217
2020-05-12,NO,Norway,EURO,25,8144,7,224
2020-05-13,NO,Norway,EURO,19,8163,4,228
2020-05-14,NO,Norway,EURO,19,8182,1,229
2020-05-15,NO,Norway,EURO,24,8206,3,232
2020-05-16,NO,Norway,EURO,23,8229,0,232
2020-05-17,NO,Norway,EURO,13,8242,0,232
2020-05-18,NO,Norway,EURO,4,8246,0,232
2020-05-19,NO,Norway,EURO,17,8263,1,233
2020-05-20,NO,Norway,EURO,20,8283,0,233
2020-05-21,NO,Norway,EURO,19,8302,1,234
2020-05-22,NO,Norway,EURO,14,8316,0,234
2020-05-23,NO,Norway,EURO,26,8342,1,235
2020-05-24,NO,Norway,EURO,6,8348,0,235
2020-05-25,NO,Norway,EURO,6,8354,0,235
2020-05-26,NO,Norway,EURO,18,8372,0,235
2020-05-27,NO,Norway,EURO,12,8384,0,235
2020-05-28,NO,Norway,EURO,18,8402,0,235
2020-05-29,NO,Norway,EURO,16,8418,1,236
2020-05-30,NO,Norway,EURO,0,8418,0,236
2020-05-31,NO,Norway,EURO,16,8434,0,236
2020-06-01,NO,Norway,EURO,6,8440,0,236
2020-06-02,NO,Norway,EURO,7,8447,1,237
2020-06-03,NO,Norway,EURO,31,8478,0,237
2020-06-04,NO,Norway,EURO,12,8490,1,238
2020-06-05,NO,Norway,EURO,17,8507,0,238
2020-06-06,NO,Norway,EURO,30,8537,0,238
2020-06-07,NO,Norway,EURO,8,8545,0,238
2020-06-08,NO,Norway,EURO,9,8554,1,239
2020-03-29,PS,"occupied Palestinian territory, including east Jerusalem",EMRO,6,97,0,1
2020-03-30,PS,"occupied Palestinian territory, including east Jerusalem",EMRO,11,108,0,1
2020-03-31,PS,"occupied Palestinian territory, including east Jerusalem",EMRO,7,115,0,1
2020-04-01,PS,"occupied Palestinian territory, including east Jerusalem",EMRO,2,117,0,1
2020-04-02,PS,"occupied Palestinian territory, including east Jerusalem",EMRO,17,134,0,1
2020-04-03,PS,"occupied Palestinian territory, including east Jerusalem",EMRO,31,165,0,1
2020-04-04,PS,"occupied Palestinian territory, including east Jerusalem",EMRO,29,194,0,1
2020-04-05,PS,"occupied Palestinian territory, including east Jerusalem",EMRO,23,217,0,1
2020-04-06,PS,"occupied Palestinian territory, including east Jerusalem",EMRO,17,234,0,1
2020-04-07,PS,"occupied Palestinian territory, including east Jerusalem",EMRO,20,254,0,1
2020-04-08,PS,"occupied Palestinian territory, including east Jerusalem",EMRO,7,261,0,1
2020-04-09,PS,"occupied Palestinian territory, including east Jerusalem",EMRO,2,263,0,1
2020-04-10,PS,"occupied Palestinian territory, including east Jerusalem",EMRO,0,263,0,1
2020-04-11,PS,"occupied Palestinian territory, including east Jerusalem",EMRO,4,267,1,2
2020-04-12,PS,"occupied Palestinian territory, including east Jerusalem",EMRO,1,268,0,2
2020-04-13,PS,"occupied Palestinian territory, including east Jerusalem",EMRO,3,271,0,2
2020-04-14,PS,"occupied Palestinian territory, including east Jerusalem",EMRO,3,274,0,2
2020-04-15,PS,"occupied Palestinian territory, including east Jerusalem",EMRO,14,288,0,2
2020-04-16,PS,"occupied Palestinian territory, including east Jerusalem",EMRO,3,291,0,2
2020-04-17,PS,"occupied Palestinian territory, including east Jerusalem",EMRO,4,295,0,2
2020-04-18,PS,"occupied Palestinian territory, including east Jerusalem",EMRO,12,307,0,2
2020-04-19,PS,"occupied Palestinian territory, including east Jerusalem",EMRO,6,313,0,2
2020-04-20,PS,"occupied Palestinian territory, including east Jerusalem",EMRO,9,322,0,2
2020-04-21,PS,"occupied Palestinian territory, including east Jerusalem",EMRO,7,329,0,2
2020-04-22,PS,"occupied Palestinian territory, including east Jerusalem",EMRO,5,334,0,2
2020-04-23,PS,"occupied Palestinian territory, including east Jerusalem",EMRO,1,335,0,2
2020-04-24,PS,"occupied Palestinian territory, including east Jerusalem",EMRO,1,336,0,2
2020-04-25,PS,"occupied Palestinian territory, including east Jerusalem",EMRO,4,340,0,2
2020-04-26,PS,"occupied Palestinian territory, including east Jerusalem",EMRO,2,342,0,2
2020-04-27,PS,"occupied Palestinian territory, including east Jerusalem",EMRO,0,342,0,2
2020-04-28,PS,"occupied Palestinian territory, including east Jerusalem",EMRO,0,342,0,2
2020-04-29,PS,"occupied Palestinian territory, including east Jerusalem",EMRO,1,343,0,2
2020-04-30,PS,"occupied Palestinian territory, including east Jerusalem",EMRO,1,344,0,2
2020-05-01,PS,"occupied Palestinian territory, including east Jerusalem",EMRO,0,344,0,2
2020-05-02,PS,"occupied Palestinian territory, including east Jerusalem",EMRO,9,353,0,2
2020-05-03,PS,"occupied Palestinian territory, including east Jerusalem",EMRO,0,353,0,2
2020-05-04,PS,"occupied Palestinian territory, including east Jerusalem",EMRO,0,353,0,2
2020-05-05,PS,"occupied Palestinian territory, including east Jerusalem",EMRO,179,532,2,4
2020-05-06,PS,"occupied Palestinian territory, including east Jerusalem",EMRO,11,543,0,4
2020-05-07,PS,"occupied Palestinian territory, including east Jerusalem",EMRO,3,546,0,4
2020-05-08,PS,"occupied Palestinian territory, including east Jerusalem",EMRO,1,547,0,4
2020-05-09,PS,"occupied Palestinian territory, including east Jerusalem",EMRO,0,547,0,4
2020-05-10,PS,"occupied Palestinian territory, including east Jerusalem",EMRO,0,547,0,4
2020-05-11,PS,"occupied Palestinian territory, including east Jerusalem",EMRO,0,547,0,4
2020-05-12,PS,"occupied Palestinian territory, including east Jerusalem",EMRO,0,547,0,4
2020-05-13,PS,"occupied Palestinian territory, including east Jerusalem",EMRO,0,547,0,4
2020-05-14,PS,"occupied Palestinian territory, including east Jerusalem",EMRO,1,548,0,4
2020-05-15,PS,"occupied Palestinian territory, including east Jerusalem",EMRO,0,548,0,4
2020-05-16,PS,"occupied Palestinian territory, including east Jerusalem",EMRO,6,554,0,4
2020-05-17,PS,"occupied Palestinian territory, including east Jerusalem",EMRO,1,555,0,4
2020-05-18,PS,"occupied Palestinian territory, including east Jerusalem",EMRO,5,560,0,4
2020-05-19,PS,"occupied Palestinian territory, including east Jerusalem",EMRO,7,567,0,4
2020-05-20,PS,"occupied Palestinian territory, including east Jerusalem",EMRO,3,570,0,4
2020-05-21,PS,"occupied Palestinian territory, including east Jerusalem",EMRO,7,577,0,4
2020-05-22,PS,"occupied Palestinian territory, including east Jerusalem",EMRO,25,602,0,4
2020-05-23,PS,"occupied Palestinian territory, including east Jerusalem",EMRO,0,602,0,4
2020-05-24,PS,"occupied Palestinian territory, including east Jerusalem",EMRO,0,602,1,5
2020-05-25,PS,"occupied Palestinian territory, including east Jerusalem",EMRO,0,602,0,5
2020-05-26,PS,"occupied Palestinian territory, including east Jerusalem",EMRO,0,602,0,5
2020-05-27,PS,"occupied Palestinian territory, including east Jerusalem",EMRO,3,605,0,5
2020-05-28,PS,"occupied Palestinian territory, including east Jerusalem",EMRO,8,613,0,5
2020-05-29,PS,"occupied Palestinian territory, including east Jerusalem",EMRO,12,625,0,5
2020-05-30,PS,"occupied Palestinian territory, including east Jerusalem",EMRO,0,625,0,5
2020-05-31,PS,"occupied Palestinian territory, including east Jerusalem",EMRO,1,626,0,5
2020-06-01,PS,"occupied Palestinian territory, including east Jerusalem",EMRO,1,627,0,5
2020-06-02,PS,"occupied Palestinian territory, including east Jerusalem",EMRO,1,628,0,5
2020-06-03,PS,"occupied Palestinian territory, including east Jerusalem",EMRO,2,630,0,5
2020-06-04,PS,"occupied Palestinian territory, including east Jerusalem",EMRO,6,636,0,5
2020-06-05,PS,"occupied Palestinian territory, including east Jerusalem",EMRO,7,643,0,5
2020-06-06,PS,"occupied Palestinian territory, including east Jerusalem",EMRO,0,643,0,5
2020-06-07,PS,"occupied Palestinian territory, including east Jerusalem",EMRO,0,643,0,5
2020-06-08,PS,"occupied Palestinian territory, including east Jerusalem",EMRO,0,643,0,5
2020-03-29,OM,Oman,EMRO,21,152,0,0
2020-03-30,OM,Oman,EMRO,15,167,0,0
2020-03-31,OM,Oman,EMRO,12,179,0,0
2020-04-01,OM,Oman,EMRO,13,192,0,0
2020-04-02,OM,Oman,EMRO,18,210,1,1
2020-04-03,OM,Oman,EMRO,21,231,0,1
2020-04-04,OM,Oman,EMRO,21,252,0,1
2020-04-05,OM,Oman,EMRO,25,277,1,2
2020-04-06,OM,Oman,EMRO,21,298,0,2
2020-04-07,OM,Oman,EMRO,33,331,0,2
2020-04-08,OM,Oman,EMRO,40,371,0,2
2020-04-09,OM,Oman,EMRO,48,419,0,2
2020-04-10,OM,Oman,EMRO,38,457,1,3
2020-04-11,OM,Oman,EMRO,27,484,0,3
2020-04-12,OM,Oman,EMRO,62,546,0,3
2020-04-13,OM,Oman,EMRO,53,599,1,4
2020-04-14,OM,Oman,EMRO,128,727,0,4
2020-04-15,OM,Oman,EMRO,86,813,0,4
2020-04-16,OM,Oman,EMRO,97,910,0,4
2020-04-17,OM,Oman,EMRO,109,1019,0,4
2020-04-18,OM,Oman,EMRO,50,1069,2,6
2020-04-19,OM,Oman,EMRO,111,1180,0,6
2020-04-20,OM,Oman,EMRO,86,1266,0,6
2020-04-21,OM,Oman,EMRO,144,1410,1,7
2020-04-22,OM,Oman,EMRO,98,1508,1,8
2020-04-23,OM,Oman,EMRO,106,1614,0,8
2020-04-24,OM,Oman,EMRO,102,1716,0,8
2020-04-25,OM,Oman,EMRO,74,1790,2,10
2020-04-26,OM,Oman,EMRO,115,1905,0,10
2020-04-27,OM,Oman,EMRO,93,1998,0,10
2020-04-28,OM,Oman,EMRO,51,2049,0,10
2020-04-29,OM,Oman,EMRO,82,2131,0,10
2020-04-30,OM,Oman,EMRO,143,2274,0,10
2020-05-01,OM,Oman,EMRO,74,2348,1,11
2020-05-02,OM,Oman,EMRO,99,2447,0,11
2020-05-03,OM,Oman,EMRO,36,2483,1,12
2020-05-04,OM,Oman,EMRO,85,2568,0,12
2020-05-05,OM,Oman,EMRO,69,2637,0,12
2020-05-06,OM,Oman,EMRO,98,2735,1,13
2020-05-07,OM,Oman,EMRO,168,2903,0,13
2020-05-08,OM,Oman,EMRO,55,2958,2,15
2020-05-09,OM,Oman,EMRO,154,3112,1,16
2020-05-10,OM,Oman,EMRO,112,3224,1,17
2020-05-11,OM,Oman,EMRO,176,3400,0,17
2020-05-12,OM,Oman,EMRO,174,3574,0,17
2020-05-13,OM,Oman,EMRO,147,3721,0,17
2020-05-14,OM,Oman,EMRO,298,4019,0,17
2020-05-15,OM,Oman,EMRO,322,4341,1,18
2020-05-16,OM,Oman,EMRO,284,4625,2,20
2020-05-17,OM,Oman,EMRO,404,5029,1,21
2020-05-18,OM,Oman,EMRO,157,5186,1,22
2020-05-19,OM,Oman,EMRO,193,5379,1,23
2020-05-20,OM,Oman,EMRO,292,5671,4,27
2020-05-21,OM,Oman,EMRO,372,6043,3,30
2020-05-22,OM,Oman,EMRO,327,6370,1,31
2020-05-23,OM,Oman,EMRO,424,6794,3,34
2020-05-24,OM,Oman,EMRO,463,7257,2,36
2020-05-25,OM,Oman,EMRO,513,7770,1,37
2020-05-26,OM,Oman,EMRO,0,7770,0,37
2020-05-27,OM,Oman,EMRO,348,8118,0,37
2020-05-28,OM,Oman,EMRO,255,8373,2,39
2020-05-29,OM,Oman,EMRO,636,9009,1,40
2020-05-30,OM,Oman,EMRO,811,9820,1,41
2020-05-31,OM,Oman,EMRO,603,10423,1,42
2020-06-01,OM,Oman,EMRO,1014,11437,7,49
2020-06-02,OM,Oman,EMRO,786,12223,1,50
2020-06-03,OM,Oman,EMRO,576,12799,9,59
2020-06-04,OM,Oman,EMRO,738,13537,8,67
2020-06-05,OM,Oman,EMRO,779,14316,0,67
2020-06-06,OM,Oman,EMRO,770,15086,5,72
2020-06-07,OM,Oman,EMRO,930,16016,0,72
2020-06-08,OM,Oman,EMRO,866,16882,3,75
2020-03-29, ,Other,Other,0,712,0,10
2020-03-30, ,Other,Other,0,712,0,10
2020-03-31, ,Other,Other,0,712,1,11
2020-04-01, ,Other,Other,0,712,0,11
2020-04-02, ,Other,Other,0,712,0,11
2020-04-03, ,Other,Other,0,712,0,11
2020-04-04, ,Other,Other,0,712,0,11
2020-04-05, ,Other,Other,0,712,0,11
2020-04-06, ,Other,Other,0,712,0,11
2020-04-07, ,Other,Other,0,712,0,11
2020-04-08, ,Other,Other,0,712,0,11
2020-04-09, ,Other,Other,0,712,0,11
2020-04-10, ,Other,Other,0,712,0,11
2020-04-11, ,Other,Other,0,712,0,11
2020-04-12, ,Other,Other,0,712,0,11
2020-04-13, ,Other,Other,0,712,1,12
2020-04-14, ,Other,Other,0,712,0,12
2020-04-15, ,Other,Other,0,712,0,12
2020-04-16, ,Other,Other,0,712,0,12
2020-04-17, ,Other,Other,0,712,1,13
2020-04-18, ,Other,Other,0,712,0,13
2020-04-19, ,Other,Other,0,712,0,13
2020-04-20, ,Other,Other,0,712,0,13
2020-04-21, ,Other,Other,0,712,0,13
2020-04-22, ,Other,Other,0,712,0,13
2020-04-23, ,Other,Other,0,712,0,13
2020-04-24, ,Other,Other,0,712,0,13
2020-04-25, ,Other,Other,0,712,0,13
2020-04-26, ,Other,Other,0,712,0,13
2020-04-27, ,Other,Other,0,712,0,13
2020-04-28, ,Other,Other,0,712,0,13
2020-04-29, ,Other,Other,0,712,0,13
2020-04-30, ,Other,Other,0,712,0,13
2020-05-01, ,Other,Other,0,712,0,13
2020-05-02, ,Other,Other,0,712,0,13
2020-05-03, ,Other,Other,0,712,0,13
2020-05-04, ,Other,Other,0,712,0,13
2020-05-05, ,Other,Other,0,712,0,13
2020-05-06, ,Other,Other,0,712,0,13
2020-05-07, ,Other,Other,0,712,0,13
2020-05-08, ,Other,Other,0,712,0,13
2020-05-09, ,Other,Other,0,712,0,13
2020-05-10, ,Other,Other,0,712,0,13
2020-05-11, ,Other,Other,0,712,0,13
2020-05-12, ,Other,Other,0,712,0,13
2020-05-13, ,Other,Other,0,712,0,13
2020-05-14, ,Other,Other,0,712,0,13
2020-05-15, ,Other,Other,0,712,0,13
2020-05-16, ,Other,Other,0,712,0,13
2020-05-17, ,Other,Other,0,712,0,13
2020-05-18, ,Other,Other,0,712,0,13
2020-05-19, ,Other,Other,0,712,0,13
2020-05-20, ,Other,Other,0,712,0,13
2020-05-21, ,Other,Other,0,712,0,13
2020-05-22, ,Other,Other,0,712,0,13
2020-05-23, ,Other,Other,29,741,0,13
2020-05-24, ,Other,Other,0,741,0,13
2020-05-25, ,Other,Other,0,741,0,13
2020-05-26, ,Other,Other,0,741,0,13
2020-05-27, ,Other,Other,0,741,0,13
2020-05-28, ,Other,Other,0,741,0,13
2020-05-29, ,Other,Other,0,741,0,13
2020-05-30, ,Other,Other,0,741,0,13
2020-05-31, ,Other,Other,0,741,0,13
2020-06-01, ,Other,Other,0,741,0,13
2020-06-02, ,Other,Other,0,741,0,13
2020-06-03, ,Other,Other,0,741,0,13
2020-06-04, ,Other,Other,0,741,0,13
2020-06-05, ,Other,Other,0,741,0,13
2020-06-06, ,Other,Other,0,741,0,13
2020-06-07, ,Other,Other,0,741,0,13
2020-06-08, ,Other,Other,0,741,0,13
2020-03-29,PK,Pakistan,EMRO,178,1235,1,9
2020-03-30,PK,Pakistan,EMRO,173,1408,2,11
2020-03-31,PK,Pakistan,EMRO,118,1526,2,13
2020-04-01,PK,Pakistan,EMRO,99,1625,5,18
2020-04-02,PK,Pakistan,EMRO,240,1865,7,25
2020-04-03,PK,Pakistan,EMRO,174,2039,1,26
2020-04-04,PK,Pakistan,EMRO,252,2291,5,31
2020-04-05,PK,Pakistan,EMRO,159,2450,4,35
2020-04-06,PK,Pakistan,EMRO,258,2708,5,40
2020-04-07,PK,Pakistan,EMRO,351,3059,5,45
2020-04-08,PK,Pakistan,EMRO,446,3505,6,51
2020-04-09,PK,Pakistan,EMRO,500,4005,3,54
2020-04-10,PK,Pakistan,EMRO,182,4187,4,58
2020-04-11,PK,Pakistan,EMRO,302,4489,5,63
2020-04-12,PK,Pakistan,EMRO,206,4695,3,66
2020-04-13,PK,Pakistan,EMRO,316,5011,20,86
2020-04-14,PK,Pakistan,EMRO,219,5230,5,91
2020-04-15,PK,Pakistan,EMRO,266,5496,2,93
2020-04-16,PK,Pakistan,EMRO,341,5837,3,96
2020-04-17,PK,Pakistan,EMRO,546,6383,15,111
2020-04-18,PK,Pakistan,EMRO,536,6919,17,128
2020-04-19,PK,Pakistan,EMRO,106,7025,7,135
2020-04-20,PK,Pakistan,EMRO,613,7638,8,143
2020-04-21,PK,Pakistan,EMRO,710,8348,25,168
2020-04-22,PK,Pakistan,EMRO,70,8418,8,176
2020-04-23,PK,Pakistan,EMRO,1147,9565,25,201
2020-04-24,PK,Pakistan,EMRO,511,10076,11,212
2020-04-25,PK,Pakistan,EMRO,981,11057,23,235
2020-04-26,PK,Pakistan,EMRO,883,11940,18,253
2020-04-27,PK,Pakistan,EMRO,704,12644,15,268
2020-04-28,PK,Pakistan,EMRO,684,13328,13,281
2020-04-29,PK,Pakistan,EMRO,587,13915,11,292
2020-04-30,PK,Pakistan,EMRO,697,14612,20,312
2020-05-01,PK,Pakistan,EMRO,857,15469,31,343
2020-05-02,PK,Pakistan,EMRO,1004,16473,18,361
2020-05-03,PK,Pakistan,EMRO,1226,17699,47,408
2020-05-04,PK,Pakistan,EMRO,1323,19022,29,437
2020-05-05,PK,Pakistan,EMRO,1062,20084,20,457
2020-05-06,PK,Pakistan,EMRO,857,20941,19,476
2020-05-07,PK,Pakistan,EMRO,1108,22049,38,514
2020-05-08,PK,Pakistan,EMRO,1165,23214,12,526
2020-05-09,PK,Pakistan,EMRO,1430,24644,59,585
2020-05-10,PK,Pakistan,EMRO,1791,26435,14,599
2020-05-11,PK,Pakistan,EMRO,2301,28736,37,636
2020-05-12,PK,Pakistan,EMRO,1598,30334,23,659
2020-05-13,PK,Pakistan,EMRO,607,30941,8,667
2020-05-14,PK,Pakistan,EMRO,1733,32674,57,724
2020-05-15,PK,Pakistan,EMRO,2624,35298,37,761
2020-05-16,PK,Pakistan,EMRO,490,35788,9,770
2020-05-17,PK,Pakistan,EMRO,1430,37218,33,803
2020-05-18,PK,Pakistan,EMRO,1581,38799,31,834
2020-05-19,PK,Pakistan,EMRO,1352,40151,39,873
2020-05-20,PK,Pakistan,EMRO,1974,42125,30,903
2020-05-21,PK,Pakistan,EMRO,1841,43966,36,939
2020-05-22,PK,Pakistan,EMRO,4125,48091,78,1017
2020-05-23,PK,Pakistan,EMRO,0,48091,0,1017
2020-05-24,PK,Pakistan,EMRO,4346,52437,84,1101
2020-05-25,PK,Pakistan,EMRO,2164,54601,32,1133
2020-05-26,PK,Pakistan,EMRO,1748,56349,34,1167
2020-05-27,PK,Pakistan,EMRO,1356,57705,30,1197
2020-05-28,PK,Pakistan,EMRO,1446,59151,28,1225
2020-05-29,PK,Pakistan,EMRO,2076,61227,35,1260
2020-05-30,PK,Pakistan,EMRO,2801,64028,57,1317
2020-05-31,PK,Pakistan,EMRO,2429,66457,78,1395
2020-06-01,PK,Pakistan,EMRO,3039,69496,88,1483
2020-06-02,PK,Pakistan,EMRO,2964,72460,60,1543
2020-06-03,PK,Pakistan,EMRO,3938,76398,78,1621
2020-06-04,PK,Pakistan,EMRO,4065,80463,67,1688
2020-06-05,PK,Pakistan,EMRO,4801,85264,82,1770
2020-06-06,PK,Pakistan,EMRO,3985,89249,68,1838
2020-06-07,PK,Pakistan,EMRO,4734,93983,97,1935
2020-06-08,PK,Pakistan,EMRO,4960,98943,67,2002
2020-03-29,PW,Palau,WPRO,0,0,0,0
2020-03-30,PW,Palau,WPRO,0,0,0,0
2020-03-31,PW,Palau,WPRO,0,0,0,0
2020-04-01,PW,Palau,WPRO,0,0,0,0
2020-04-02,PW,Palau,WPRO,0,0,0,0
2020-04-03,PW,Palau,WPRO,0,0,0,0
2020-04-04,PW,Palau,WPRO,0,0,0,0
2020-04-05,PW,Palau,WPRO,0,0,0,0
2020-04-06,PW,Palau,WPRO,0,0,0,0
2020-04-07,PW,Palau,WPRO,0,0,0,0
2020-04-08,PW,Palau,WPRO,0,0,0,0
2020-04-09,PW,Palau,WPRO,0,0,0,0
2020-04-10,PW,Palau,WPRO,0,0,0,0
2020-04-11,PW,Palau,WPRO,0,0,0,0
2020-04-12,PW,Palau,WPRO,0,0,0,0
2020-04-13,PW,Palau,WPRO,0,0,0,0
2020-04-14,PW,Palau,WPRO,0,0,0,0
2020-04-15,PW,Palau,WPRO,0,0,0,0
2020-04-16,PW,Palau,WPRO,0,0,0,0
2020-04-17,PW,Palau,WPRO,0,0,0,0
2020-04-18,PW,Palau,WPRO,0,0,0,0
2020-04-19,PW,Palau,WPRO,0,0,0,0
2020-04-20,PW,Palau,WPRO,0,0,0,0
2020-04-21,PW,Palau,WPRO,0,0,0,0
2020-04-22,PW,Palau,WPRO,0,0,0,0
2020-04-23,PW,Palau,WPRO,0,0,0,0
2020-04-24,PW,Palau,WPRO,0,0,0,0
2020-04-25,PW,Palau,WPRO,0,0,0,0
2020-04-26,PW,Palau,WPRO,0,0,0,0
2020-04-27,PW,Palau,WPRO,0,0,0,0
2020-04-28,PW,Palau,WPRO,0,0,0,0
2020-04-29,PW,Palau,WPRO,0,0,0,0
2020-04-30,PW,Palau,WPRO,0,0,0,0
2020-05-01,PW,Palau,WPRO,0,0,0,0
2020-05-02,PW,Palau,WPRO,0,0,0,0
2020-05-03,PW,Palau,WPRO,0,0,0,0
2020-05-04,PW,Palau,WPRO,0,0,0,0
2020-05-05,PW,Palau,WPRO,0,0,0,0
2020-05-06,PW,Palau,WPRO,0,0,0,0
2020-05-07,PW,Palau,WPRO,0,0,0,0
2020-05-08,PW,Palau,WPRO,0,0,0,0
2020-05-09,PW,Palau,WPRO,0,0,0,0
2020-05-10,PW,Palau,WPRO,0,0,0,0
2020-05-11,PW,Palau,WPRO,0,0,0,0
2020-05-12,PW,Palau,WPRO,0,0,0,0
2020-05-13,PW,Palau,WPRO,0,0,0,0
2020-05-14,PW,Palau,WPRO,0,0,0,0
2020-05-15,PW,Palau,WPRO,0,0,0,0
2020-05-16,PW,Palau,WPRO,0,0,0,0
2020-05-17,PW,Palau,WPRO,0,0,0,0
2020-05-18,PW,Palau,WPRO,0,0,0,0
2020-05-19,PW,Palau,WPRO,0,0,0,0
2020-05-20,PW,Palau,WPRO,0,0,0,0
2020-05-21,PW,Palau,WPRO,0,0,0,0
2020-05-22,PW,Palau,WPRO,0,0,0,0
2020-05-23,PW,Palau,WPRO,0,0,0,0
2020-05-24,PW,Palau,WPRO,0,0,0,0
2020-05-25,PW,Palau,WPRO,0,0,0,0
2020-05-26,PW,Palau,WPRO,0,0,0,0
2020-05-27,PW,Palau,WPRO,0,0,0,0
2020-05-28,PW,Palau,WPRO,0,0,0,0
2020-05-29,PW,Palau,WPRO,0,0,0,0
2020-05-30,PW,Palau,WPRO,0,0,0,0
2020-05-31,PW,Palau,WPRO,0,0,0,0
2020-06-01,PW,Palau,WPRO,0,0,0,0
2020-06-02,PW,Palau,WPRO,0,0,0,0
2020-06-03,PW,Palau,WPRO,0,0,0,0
2020-06-04,PW,Palau,WPRO,0,0,0,0
2020-06-05,PW,Palau,WPRO,0,0,0,0
2020-06-06,PW,Palau,WPRO,0,0,0,0
2020-06-07,PW,Palau,WPRO,0,0,0,0
2020-06-08,PW,Palau,WPRO,0,0,0,0
2020-03-29,PA,Panama,AMRO,112,786,5,14
2020-03-30,PA,Panama,AMRO,115,901,3,17
2020-03-31,PA,Panama,AMRO,88,989,7,24
2020-04-01,PA,Panama,AMRO,86,1075,2,26
2020-04-02,PA,Panama,AMRO,106,1181,4,30
2020-04-03,PA,Panama,AMRO,136,1317,2,32
2020-04-04,PA,Panama,AMRO,158,1475,5,37
2020-04-05,PA,Panama,AMRO,198,1673,4,41
2020-04-06,PA,Panama,AMRO,128,1801,5,46
2020-04-07,PA,Panama,AMRO,187,1988,8,54
2020-04-08,PA,Panama,AMRO,112,2100,1,55
2020-04-09,PA,Panama,AMRO,149,2249,4,59
2020-04-10,PA,Panama,AMRO,279,2528,4,63
2020-04-11,PA,Panama,AMRO,224,2752,3,66
2020-04-12,PA,Panama,AMRO,222,2974,8,74
2020-04-13,PA,Panama,AMRO,260,3234,5,79
2020-04-14,PA,Panama,AMRO,166,3400,8,87
2020-04-15,PA,Panama,AMRO,72,3472,7,94
2020-04-16,PA,Panama,AMRO,102,3574,1,95
2020-04-17,PA,Panama,AMRO,177,3751,8,103
2020-04-18,PA,Panama,AMRO,265,4016,6,109
2020-04-19,PA,Panama,AMRO,194,4210,6,115
2020-04-20,PA,Panama,AMRO,63,4273,5,120
2020-04-21,PA,Panama,AMRO,194,4467,6,126
2020-04-22,PA,Panama,AMRO,191,4658,10,136
2020-04-23,PA,Panama,AMRO,163,4821,5,141
2020-04-24,PA,Panama,AMRO,171,4992,3,144
2020-04-25,PA,Panama,AMRO,174,5166,2,146
2020-04-26,PA,Panama,AMRO,172,5338,8,154
2020-04-27,PA,Panama,AMRO,200,5538,5,159
2020-04-28,PA,Panama,AMRO,241,5779,6,165
2020-04-29,PA,Panama,AMRO,242,6021,2,167
2020-04-30,PA,Panama,AMRO,179,6200,9,176
2020-05-01,PA,Panama,AMRO,178,6378,2,178
2020-05-02,PA,Panama,AMRO,154,6532,10,188
2020-05-03,PA,Panama,AMRO,188,6720,4,192
2020-05-04,PA,Panama,AMRO,370,7090,5,197
2020-05-05,PA,Panama,AMRO,107,7197,3,200
2020-05-06,PA,Panama,AMRO,190,7387,3,203
2020-05-07,PA,Panama,AMRO,136,7523,7,210
2020-05-08,PA,Panama,AMRO,208,7731,8,218
2020-05-09,PA,Panama,AMRO,137,7868,7,225
2020-05-10,PA,Panama,AMRO,202,8070,6,231
2020-05-11,PA,Panama,AMRO,212,8282,6,237
2020-05-12,PA,Panama,AMRO,166,8448,7,244
2020-05-13,PA,Panama,AMRO,168,8616,5,249
2020-05-14,PA,Panama,AMRO,0,8616,0,249
2020-05-15,PA,Panama,AMRO,328,8944,7,256
2020-05-16,PA,Panama,AMRO,174,9118,4,260
2020-05-17,PA,Panama,AMRO,150,9268,6,266
2020-05-18,PA,Panama,AMRO,181,9449,3,269
2020-05-19,PA,Panama,AMRO,157,9606,6,275
2020-05-20,PA,Panama,AMRO,120,9726,4,279
2020-05-21,PA,Panama,AMRO,141,9867,2,281
2020-05-22,PA,Panama,AMRO,110,9977,6,287
2020-05-23,PA,Panama,AMRO,139,10116,4,291
2020-05-24,PA,Panama,AMRO,151,10267,4,295
2020-05-25,PA,Panama,AMRO,310,10577,4,299
2020-05-26,PA,Panama,AMRO,349,10926,7,306
2020-05-27,PA,Panama,AMRO,257,11183,4,310
2020-05-28,PA,Panama,AMRO,264,11447,3,313
2020-05-29,PA,Panama,AMRO,281,11728,2,315
2020-05-30,PA,Panama,AMRO,403,12131,5,320
2020-05-31,PA,Panama,AMRO,400,12531,6,326
2020-06-01,PA,Panama,AMRO,487,13018,4,330
2020-06-02,PA,Panama,AMRO,445,13463,6,336
2020-06-03,PA,Panama,AMRO,374,13837,8,344
2020-06-04,PA,Panama,AMRO,258,14095,8,352
2020-06-05,PA,Panama,AMRO,514,14609,5,357
2020-06-06,PA,Panama,AMRO,435,15044,6,363
2020-06-07,PA,Panama,AMRO,419,15463,7,370
2020-06-08,PA,Panama,AMRO,541,16004,16,386
2020-03-29,PG,Papua New Guinea,WPRO,0,1,0,0
2020-03-30,PG,Papua New Guinea,WPRO,0,1,0,0
2020-03-31,PG,Papua New Guinea,WPRO,0,1,0,0
2020-04-01,PG,Papua New Guinea,WPRO,0,1,0,0
2020-04-02,PG,Papua New Guinea,WPRO,0,1,0,0
2020-04-03,PG,Papua New Guinea,WPRO,0,1,0,0
2020-04-04,PG,Papua New Guinea,WPRO,0,1,0,0
2020-04-05,PG,Papua New Guinea,WPRO,0,1,0,0
2020-04-06,PG,Papua New Guinea,WPRO,0,1,0,0
2020-04-07,PG,Papua New Guinea,WPRO,0,1,0,0
2020-04-08,PG,Papua New Guinea,WPRO,0,1,0,0
2020-04-09,PG,Papua New Guinea,WPRO,1,2,0,0
2020-04-10,PG,Papua New Guinea,WPRO,0,2,0,0
2020-04-11,PG,Papua New Guinea,WPRO,0,2,0,0
2020-04-12,PG,Papua New Guinea,WPRO,0,2,0,0
2020-04-13,PG,Papua New Guinea,WPRO,0,2,0,0
2020-04-14,PG,Papua New Guinea,WPRO,0,2,0,0
2020-04-15,PG,Papua New Guinea,WPRO,0,2,0,0
2020-04-16,PG,Papua New Guinea,WPRO,0,2,0,0
2020-04-17,PG,Papua New Guinea,WPRO,5,7,0,0
2020-04-18,PG,Papua New Guinea,WPRO,0,7,0,0
2020-04-19,PG,Papua New Guinea,WPRO,0,7,0,0
2020-04-20,PG,Papua New Guinea,WPRO,0,7,0,0
2020-04-21,PG,Papua New Guinea,WPRO,0,7,0,0
2020-04-22,PG,Papua New Guinea,WPRO,0,7,0,0
2020-04-23,PG,Papua New Guinea,WPRO,1,8,0,0
2020-04-24,PG,Papua New Guinea,WPRO,0,8,0,0
2020-04-25,PG,Papua New Guinea,WPRO,0,8,0,0
2020-04-26,PG,Papua New Guinea,WPRO,0,8,0,0
2020-04-27,PG,Papua New Guinea,WPRO,0,8,0,0
2020-04-28,PG,Papua New Guinea,WPRO,0,8,0,0
2020-04-29,PG,Papua New Guinea,WPRO,0,8,0,0
2020-04-30,PG,Papua New Guinea,WPRO,0,8,0,0
2020-05-01,PG,Papua New Guinea,WPRO,0,8,0,0
2020-05-02,PG,Papua New Guinea,WPRO,0,8,0,0
2020-05-03,PG,Papua New Guinea,WPRO,0,8,0,0
2020-05-04,PG,Papua New Guinea,WPRO,0,8,0,0
2020-05-05,PG,Papua New Guinea,WPRO,0,8,0,0
2020-05-06,PG,Papua New Guinea,WPRO,0,8,0,0
2020-05-07,PG,Papua New Guinea,WPRO,0,8,0,0
2020-05-08,PG,Papua New Guinea,WPRO,0,8,0,0
2020-05-09,PG,Papua New Guinea,WPRO,0,8,0,0
2020-05-10,PG,Papua New Guinea,WPRO,0,8,0,0
2020-05-11,PG,Papua New Guinea,WPRO,0,8,0,0
2020-05-12,PG,Papua New Guinea,WPRO,0,8,0,0
2020-05-13,PG,Papua New Guinea,WPRO,0,8,0,0
2020-05-14,PG,Papua New Guinea,WPRO,0,8,0,0
2020-05-15,PG,Papua New Guinea,WPRO,0,8,0,0
2020-05-16,PG,Papua New Guinea,WPRO,0,8,0,0
2020-05-17,PG,Papua New Guinea,WPRO,0,8,0,0
2020-05-18,PG,Papua New Guinea,WPRO,0,8,0,0
2020-05-19,PG,Papua New Guinea,WPRO,0,8,0,0
2020-05-20,PG,Papua New Guinea,WPRO,0,8,0,0
2020-05-21,PG,Papua New Guinea,WPRO,0,8,0,0
2020-05-22,PG,Papua New Guinea,WPRO,0,8,0,0
2020-05-23,PG,Papua New Guinea,WPRO,0,8,0,0
2020-05-24,PG,Papua New Guinea,WPRO,0,8,0,0
2020-05-25,PG,Papua New Guinea,WPRO,0,8,0,0
2020-05-26,PG,Papua New Guinea,WPRO,0,8,0,0
2020-05-27,PG,Papua New Guinea,WPRO,0,8,0,0
2020-05-28,PG,Papua New Guinea,WPRO,0,8,0,0
2020-05-29,PG,Papua New Guinea,WPRO,0,8,0,0
2020-05-30,PG,Papua New Guinea,WPRO,0,8,0,0
2020-05-31,PG,Papua New Guinea,WPRO,0,8,0,0
2020-06-01,PG,Papua New Guinea,WPRO,0,8,0,0
2020-06-02,PG,Papua New Guinea,WPRO,0,8,0,0
2020-06-03,PG,Papua New Guinea,WPRO,0,8,0,0
2020-06-04,PG,Papua New Guinea,WPRO,0,8,0,0
2020-06-05,PG,Papua New Guinea,WPRO,0,8,0,0
2020-06-06,PG,Papua New Guinea,WPRO,0,8,0,0
2020-06-07,PG,Papua New Guinea,WPRO,0,8,0,0
2020-06-08,PG,Papua New Guinea,WPRO,0,8,0,0
2020-03-29,PY,Paraguay,AMRO,4,56,0,3
2020-03-30,PY,Paraguay,AMRO,3,59,0,3
2020-03-31,PY,Paraguay,AMRO,5,64,0,3
2020-04-01,PY,Paraguay,AMRO,1,65,0,3
2020-04-02,PY,Paraguay,AMRO,4,69,0,3
2020-04-03,PY,Paraguay,AMRO,8,77,0,3
2020-04-04,PY,Paraguay,AMRO,15,92,0,3
2020-04-05,PY,Paraguay,AMRO,4,96,0,3
2020-04-06,PY,Paraguay,AMRO,8,104,0,3
2020-04-07,PY,Paraguay,AMRO,9,113,2,5
2020-04-08,PY,Paraguay,AMRO,2,115,0,5
2020-04-09,PY,Paraguay,AMRO,4,119,0,5
2020-04-10,PY,Paraguay,AMRO,5,124,0,5
2020-04-11,PY,Paraguay,AMRO,5,129,1,6
2020-04-12,PY,Paraguay,AMRO,4,133,0,6
2020-04-13,PY,Paraguay,AMRO,1,134,0,6
2020-04-14,PY,Paraguay,AMRO,13,147,0,6
2020-04-15,PY,Paraguay,AMRO,12,159,1,7
2020-04-16,PY,Paraguay,AMRO,2,161,1,8
2020-04-17,PY,Paraguay,AMRO,13,174,0,8
2020-04-18,PY,Paraguay,AMRO,25,199,0,8
2020-04-19,PY,Paraguay,AMRO,3,202,0,8
2020-04-20,PY,Paraguay,AMRO,4,206,0,8
2020-04-21,PY,Paraguay,AMRO,2,208,0,8
2020-04-22,PY,Paraguay,AMRO,0,208,0,8
2020-04-23,PY,Paraguay,AMRO,5,213,1,9
2020-04-24,PY,Paraguay,AMRO,0,213,0,9
2020-04-25,PY,Paraguay,AMRO,7,220,0,9
2020-04-26,PY,Paraguay,AMRO,3,223,0,9
2020-04-27,PY,Paraguay,AMRO,5,228,0,9
2020-04-28,PY,Paraguay,AMRO,0,228,0,9
2020-04-29,PY,Paraguay,AMRO,2,230,0,9
2020-04-30,PY,Paraguay,AMRO,9,239,0,9
2020-05-01,PY,Paraguay,AMRO,10,249,0,9
2020-05-02,PY,Paraguay,AMRO,17,266,1,10
2020-05-03,PY,Paraguay,AMRO,67,333,0,10
2020-05-04,PY,Paraguay,AMRO,37,370,0,10
2020-05-05,PY,Paraguay,AMRO,26,396,0,10
2020-05-06,PY,Paraguay,AMRO,35,431,0,10
2020-05-07,PY,Paraguay,AMRO,9,440,0,10
2020-05-08,PY,Paraguay,AMRO,22,462,0,10
2020-05-09,PY,Paraguay,AMRO,101,563,0,10
2020-05-10,PY,Paraguay,AMRO,126,689,0,10
2020-05-11,PY,Paraguay,AMRO,24,713,0,10
2020-05-12,PY,Paraguay,AMRO,11,724,0,10
2020-05-13,PY,Paraguay,AMRO,13,737,0,10
2020-05-14,PY,Paraguay,AMRO,3,740,1,11
2020-05-15,PY,Paraguay,AMRO,14,754,0,11
2020-05-16,PY,Paraguay,AMRO,5,759,0,11
2020-05-17,PY,Paraguay,AMRO,19,778,0,11
2020-05-18,PY,Paraguay,AMRO,8,786,0,11
2020-05-19,PY,Paraguay,AMRO,2,788,0,11
2020-05-20,PY,Paraguay,AMRO,41,829,0,11
2020-05-21,PY,Paraguay,AMRO,4,833,0,11
2020-05-22,PY,Paraguay,AMRO,3,836,0,11
2020-05-23,PY,Paraguay,AMRO,2,838,0,11
2020-05-24,PY,Paraguay,AMRO,12,850,0,11
2020-05-25,PY,Paraguay,AMRO,12,862,0,11
2020-05-26,PY,Paraguay,AMRO,3,865,0,11
2020-05-27,PY,Paraguay,AMRO,12,877,0,11
2020-05-28,PY,Paraguay,AMRO,7,884,0,11
2020-05-29,PY,Paraguay,AMRO,16,900,0,11
2020-05-30,PY,Paraguay,AMRO,17,917,0,11
2020-05-31,PY,Paraguay,AMRO,47,964,0,11
2020-06-01,PY,Paraguay,AMRO,22,986,0,11
2020-06-02,PY,Paraguay,AMRO,9,995,0,11
2020-06-03,PY,Paraguay,AMRO,18,1013,0,11
2020-06-04,PY,Paraguay,AMRO,57,1070,0,11
2020-06-05,PY,Paraguay,AMRO,16,1086,0,11
2020-06-06,PY,Paraguay,AMRO,1,1087,0,11
2020-06-07,PY,Paraguay,AMRO,3,1090,0,11
2020-06-08,PY,Paraguay,AMRO,45,1135,0,11
2020-03-29,PE,Peru,AMRO,55,635,8,71
2020-03-30,PE,Peru,AMRO,36,671,15,86
2020-03-31,PE,Peru,AMRO,181,852,9,95
2020-04-01,PE,Peru,AMRO,213,1065,18,113
2020-04-02,PE,Peru,AMRO,258,1323,25,138
2020-04-03,PE,Peru,AMRO,0,1323,23,161
2020-04-04,PE,Peru,AMRO,91,1414,22,183
2020-04-05,PE,Peru,AMRO,181,1595,26,209
2020-04-06,PE,Peru,AMRO,151,1746,49,258
2020-04-07,PE,Peru,AMRO,535,2281,59,317
2020-04-08,PE,Peru,AMRO,280,2561,43,360
2020-04-09,PE,Peru,AMRO,393,2954,63,423
2020-04-10,PE,Peru,AMRO,1388,4342,48,471
2020-04-11,PE,Peru,AMRO,914,5256,98,569
2020-04-12,PE,Peru,AMRO,641,5897,81,650
2020-04-13,PE,Peru,AMRO,951,6848,103,753
2020-04-14,PE,Peru,AMRO,671,7519,93,846
2020-04-15,PE,Peru,AMRO,0,7519,106,952
2020-04-16,PE,Peru,AMRO,2784,10303,109,1061
2020-04-17,PE,Peru,AMRO,1172,11475,139,1200
2020-04-18,PE,Peru,AMRO,2014,13489,133,1333
2020-04-19,PE,Peru,AMRO,0,13489,157,1490
2020-04-20,PE,Peru,AMRO,931,14420,138,1628
2020-04-21,PE,Peru,AMRO,1208,15628,158,1786
2020-04-22,PE,Peru,AMRO,697,16325,204,1990
2020-04-23,PE,Peru,AMRO,1512,17837,209,2199
2020-04-24,PE,Peru,AMRO,1413,19250,219,2418
2020-04-25,PE,Peru,AMRO,1664,20914,246,2664
2020-04-26,PE,Peru,AMRO,734,21648,246,2910
2020-04-27,PE,Peru,AMRO,3683,25331,288,3198
2020-04-28,PE,Peru,AMRO,2186,27517,290,3488
2020-04-29,PE,Peru,AMRO,1182,28699,305,3793
2020-04-30,PE,Peru,AMRO,2491,31190,313,4106
2020-05-01,PE,Peru,AMRO,2741,33931,344,4450
2020-05-02,PE,Peru,AMRO,3045,36976,332,4782
2020-05-03,PE,Peru,AMRO,3483,40459,399,5181
2020-05-04,PE,Peru,AMRO,2075,42534,408,5589
2020-05-05,PE,Peru,AMRO,3394,45928,415,6004
2020-05-06,PE,Peru,AMRO,1444,47372,438,6442
2020-05-07,PE,Peru,AMRO,3817,51189,429,6871
2020-05-08,PE,Peru,AMRO,3628,54817,457,7328
2020-05-09,PE,Peru,AMRO,3709,58526,481,7809
2020-05-10,PE,Peru,AMRO,3321,61847,454,8263
2020-05-11,PE,Peru,AMRO,3168,65015,477,8740
2020-05-12,PE,Peru,AMRO,2292,67307,518,9258
2020-05-13,PE,Peru,AMRO,1515,68822,520,9778
2020-05-14,PE,Peru,AMRO,3237,72059,516,10294
2020-05-15,PE,Peru,AMRO,4247,76306,466,10760
2020-05-16,PE,Peru,AMRO,4298,80604,517,11277
2020-05-17,PE,Peru,AMRO,3891,84495,547,11824
2020-05-18,PE,Peru,AMRO,4046,88541,509,12333
2020-05-19,PE,Peru,AMRO,3732,92273,502,12835
2020-05-20,PE,Peru,AMRO,2660,94933,534,13369
2020-05-21,PE,Peru,AMRO,4550,99483,615,13984
2020-05-22,PE,Peru,AMRO,4537,104020,528,14512
2020-05-23,PE,Peru,AMRO,4749,108769,544,15056
2020-05-24,PE,Peru,AMRO,2929,111698,527,15583
2020-05-25,PE,Peru,AMRO,4056,115754,518,16101
2020-05-26,PE,Peru,AMRO,4205,119959,543,16644
2020-05-27,PE,Peru,AMRO,4020,123979,572,17216
2020-05-28,PE,Peru,AMRO,5772,129751,580,17796
2020-05-29,PE,Peru,AMRO,6154,135905,544,18340
2020-05-30,PE,Peru,AMRO,5874,141779,589,18929
2020-05-31,PE,Peru,AMRO,6506,148285,554,19483
2020-06-01,PE,Peru,AMRO,7386,155671,633,20116
2020-06-02,PE,Peru,AMRO,8805,164476,599,20715
2020-06-03,PE,Peru,AMRO,5563,170039,569,21284
2020-06-04,PE,Peru,AMRO,4845,174884,662,21946
2020-06-05,PE,Peru,AMRO,4030,178914,539,22485
2020-06-06,PE,Peru,AMRO,4284,183198,549,23034
2020-06-07,PE,Peru,AMRO,4202,187400,617,23651
2020-06-08,PE,Peru,AMRO,4358,191758,588,24239
2020-03-29,PH,Philippines,WPRO,272,1075,14,68
2020-03-30,PH,Philippines,WPRO,343,1418,3,71
2020-03-31,PH,Philippines,WPRO,128,1546,17,88
2020-04-01,PH,Philippines,WPRO,538,2084,0,88
2020-04-02,PH,Philippines,WPRO,227,2311,8,96
2020-04-03,PH,Philippines,WPRO,322,2633,11,107
2020-04-04,PH,Philippines,WPRO,385,3018,29,136
2020-04-05,PH,Philippines,WPRO,76,3094,8,144
2020-04-06,PH,Philippines,WPRO,152,3246,8,152
2020-04-07,PH,Philippines,WPRO,414,3660,11,163
2020-04-08,PH,Philippines,WPRO,104,3764,14,177
2020-04-09,PH,Philippines,WPRO,106,3870,5,182
2020-04-10,PH,Philippines,WPRO,206,4076,21,203
2020-04-11,PH,Philippines,WPRO,119,4195,18,221
2020-04-12,PH,Philippines,WPRO,233,4428,26,247
2020-04-13,PH,Philippines,WPRO,220,4648,50,297
2020-04-14,PH,Philippines,WPRO,284,4932,18,315
2020-04-15,PH,Philippines,WPRO,291,5223,20,335
2020-04-16,PH,Philippines,WPRO,230,5453,14,349
2020-04-17,PH,Philippines,WPRO,207,5660,13,362
2020-04-18,PH,Philippines,WPRO,218,5878,25,387
2020-04-19,PH,Philippines,WPRO,209,6087,10,397
2020-04-20,PH,Philippines,WPRO,172,6259,12,409
2020-04-21,PH,Philippines,WPRO,200,6459,19,428
2020-04-22,PH,Philippines,WPRO,140,6599,9,437
2020-04-23,PH,Philippines,WPRO,111,6710,9,446
2020-04-24,PH,Philippines,WPRO,271,6981,16,462
2020-04-25,PH,Philippines,WPRO,211,7192,15,477
2020-04-26,PH,Philippines,WPRO,102,7294,17,494
2020-04-27,PH,Philippines,WPRO,285,7579,7,501
2020-04-28,PH,Philippines,WPRO,198,7777,10,511
2020-04-29,PH,Philippines,WPRO,181,7958,19,530
2020-04-30,PH,Philippines,WPRO,254,8212,28,558
2020-05-01,PH,Philippines,WPRO,276,8488,10,568
2020-05-02,PH,Philippines,WPRO,284,8772,11,579
2020-05-03,PH,Philippines,WPRO,156,8928,24,603
2020-05-04,PH,Philippines,WPRO,295,9223,4,607
2020-05-05,PH,Philippines,WPRO,262,9485,16,623
2020-05-06,PH,Philippines,WPRO,199,9684,14,637
2020-05-07,PH,Philippines,WPRO,320,10004,21,658
2020-05-08,PH,Philippines,WPRO,339,10343,27,685
2020-05-09,PH,Philippines,WPRO,120,10463,11,696
2020-05-10,PH,Philippines,WPRO,147,10610,8,704
2020-05-11,PH,Philippines,WPRO,184,10794,15,719
2020-05-12,PH,Philippines,WPRO,292,11086,7,726
2020-05-13,PH,Philippines,WPRO,264,11350,25,751
2020-05-14,PH,Philippines,WPRO,268,11618,21,772
2020-05-15,PH,Philippines,WPRO,258,11876,18,790
2020-05-16,PH,Philippines,WPRO,215,12091,16,806
2020-05-17,PH,Philippines,WPRO,214,12305,11,817
2020-05-18,PH,Philippines,WPRO,208,12513,7,824
2020-05-19,PH,Philippines,WPRO,205,12718,7,831
2020-05-20,PH,Philippines,WPRO,224,12942,6,837
2020-05-21,PH,Philippines,WPRO,279,13221,5,842
2020-05-22,PH,Philippines,WPRO,213,13434,4,846
2020-05-23,PH,Philippines,WPRO,163,13597,11,857
2020-05-24,PH,Philippines,WPRO,180,13777,6,863
2020-05-25,PH,Philippines,WPRO,258,14035,5,868
2020-05-26,PH,Philippines,WPRO,284,14319,5,873
2020-05-27,PH,Philippines,WPRO,350,14669,13,886
2020-05-28,PH,Philippines,WPRO,380,15049,18,904
2020-05-29,PH,Philippines,WPRO,539,15588,17,921
2020-05-30,PH,Philippines,WPRO,1046,16634,21,942
2020-05-31,PH,Philippines,WPRO,590,17224,8,950
2020-06-01,PH,Philippines,WPRO,862,18086,7,957
2020-06-02,PH,Philippines,WPRO,552,18638,3,960
2020-06-03,PH,Philippines,WPRO,359,18997,6,966
2020-06-04,PH,Philippines,WPRO,751,19748,8,974
2020-06-05,PH,Philippines,WPRO,634,20382,10,984
2020-06-06,PH,Philippines,WPRO,244,20626,3,987
2020-06-07,PH,Philippines,WPRO,714,21340,7,994
2020-06-08,PH,Philippines,WPRO,555,21895,9,1003
2020-03-29,PN,Pitcairn Islands,WPRO,0,0,0,0
2020-03-30,PN,Pitcairn Islands,WPRO,0,0,0,0
2020-03-31,PN,Pitcairn Islands,WPRO,0,0,0,0
2020-04-01,PN,Pitcairn Islands,WPRO,0,0,0,0
2020-04-02,PN,Pitcairn Islands,WPRO,0,0,0,0
2020-04-03,PN,Pitcairn Islands,WPRO,0,0,0,0
2020-04-04,PN,Pitcairn Islands,WPRO,0,0,0,0
2020-04-05,PN,Pitcairn Islands,WPRO,0,0,0,0
2020-04-06,PN,Pitcairn Islands,WPRO,0,0,0,0
2020-04-07,PN,Pitcairn Islands,WPRO,0,0,0,0
2020-04-08,PN,Pitcairn Islands,WPRO,0,0,0,0
2020-04-09,PN,Pitcairn Islands,WPRO,0,0,0,0
2020-04-10,PN,Pitcairn Islands,WPRO,0,0,0,0
2020-04-11,PN,Pitcairn Islands,WPRO,0,0,0,0
2020-04-12,PN,Pitcairn Islands,WPRO,0,0,0,0
2020-04-13,PN,Pitcairn Islands,WPRO,0,0,0,0
2020-04-14,PN,Pitcairn Islands,WPRO,0,0,0,0
2020-04-15,PN,Pitcairn Islands,WPRO,0,0,0,0
2020-04-16,PN,Pitcairn Islands,WPRO,0,0,0,0
2020-04-17,PN,Pitcairn Islands,WPRO,0,0,0,0
2020-04-18,PN,Pitcairn Islands,WPRO,0,0,0,0
2020-04-19,PN,Pitcairn Islands,WPRO,0,0,0,0
2020-04-20,PN,Pitcairn Islands,WPRO,0,0,0,0
2020-04-21,PN,Pitcairn Islands,WPRO,0,0,0,0
2020-04-22,PN,Pitcairn Islands,WPRO,0,0,0,0
2020-04-23,PN,Pitcairn Islands,WPRO,0,0,0,0
2020-04-24,PN,Pitcairn Islands,WPRO,0,0,0,0
2020-04-25,PN,Pitcairn Islands,WPRO,0,0,0,0
2020-04-26,PN,Pitcairn Islands,WPRO,0,0,0,0
2020-04-27,PN,Pitcairn Islands,WPRO,0,0,0,0
2020-04-28,PN,Pitcairn Islands,WPRO,0,0,0,0
2020-04-29,PN,Pitcairn Islands,WPRO,0,0,0,0
2020-04-30,PN,Pitcairn Islands,WPRO,0,0,0,0
2020-05-01,PN,Pitcairn Islands,WPRO,0,0,0,0
2020-05-02,PN,Pitcairn Islands,WPRO,0,0,0,0
2020-05-03,PN,Pitcairn Islands,WPRO,0,0,0,0
2020-05-04,PN,Pitcairn Islands,WPRO,0,0,0,0
2020-05-05,PN,Pitcairn Islands,WPRO,0,0,0,0
2020-05-06,PN,Pitcairn Islands,WPRO,0,0,0,0
2020-05-07,PN,Pitcairn Islands,WPRO,0,0,0,0
2020-05-08,PN,Pitcairn Islands,WPRO,0,0,0,0
2020-05-09,PN,Pitcairn Islands,WPRO,0,0,0,0
2020-05-10,PN,Pitcairn Islands,WPRO,0,0,0,0
2020-05-11,PN,Pitcairn Islands,WPRO,0,0,0,0
2020-05-12,PN,Pitcairn Islands,WPRO,0,0,0,0
2020-05-13,PN,Pitcairn Islands,WPRO,0,0,0,0
2020-05-14,PN,Pitcairn Islands,WPRO,0,0,0,0
2020-05-15,PN,Pitcairn Islands,WPRO,0,0,0,0
2020-05-16,PN,Pitcairn Islands,WPRO,0,0,0,0
2020-05-17,PN,Pitcairn Islands,WPRO,0,0,0,0
2020-05-18,PN,Pitcairn Islands,WPRO,0,0,0,0
2020-05-19,PN,Pitcairn Islands,WPRO,0,0,0,0
2020-05-20,PN,Pitcairn Islands,WPRO,0,0,0,0
2020-05-21,PN,Pitcairn Islands,WPRO,0,0,0,0
2020-05-22,PN,Pitcairn Islands,WPRO,0,0,0,0
2020-05-23,PN,Pitcairn Islands,WPRO,0,0,0,0
2020-05-24,PN,Pitcairn Islands,WPRO,0,0,0,0
2020-05-25,PN,Pitcairn Islands,WPRO,0,0,0,0
2020-05-26,PN,Pitcairn Islands,WPRO,0,0,0,0
2020-05-27,PN,Pitcairn Islands,WPRO,0,0,0,0
2020-05-28,PN,Pitcairn Islands,WPRO,0,0,0,0
2020-05-29,PN,Pitcairn Islands,WPRO,0,0,0,0
2020-05-30,PN,Pitcairn Islands,WPRO,0,0,0,0
2020-05-31,PN,Pitcairn Islands,WPRO,0,0,0,0
2020-06-01,PN,Pitcairn Islands,WPRO,0,0,0,0
2020-06-02,PN,Pitcairn Islands,WPRO,0,0,0,0
2020-06-03,PN,Pitcairn Islands,WPRO,0,0,0,0
2020-06-04,PN,Pitcairn Islands,WPRO,0,0,0,0
2020-06-05,PN,Pitcairn Islands,WPRO,0,0,0,0
2020-06-06,PN,Pitcairn Islands,WPRO,0,0,0,0
2020-06-07,PN,Pitcairn Islands,WPRO,0,0,0,0
2020-06-08,PN,Pitcairn Islands,WPRO,0,0,0,0
2020-03-29,PL,Poland,EURO,249,1638,2,18
2020-03-30,PL,Poland,EURO,224,1862,4,22
2020-03-31,PL,Poland,EURO,193,2055,9,31
2020-04-01,PL,Poland,EURO,256,2311,2,33
2020-04-02,PL,Poland,EURO,243,2554,10,43
2020-04-03,PL,Poland,EURO,392,2946,14,57
2020-04-04,PL,Poland,EURO,437,3383,14,71
2020-04-05,PL,Poland,EURO,244,3627,8,79
2020-04-06,PL,Poland,EURO,475,4102,15,94
2020-04-07,PL,Poland,EURO,311,4413,9,103
2020-04-08,PL,Poland,EURO,435,4848,26,129
2020-04-09,PL,Poland,EURO,356,5204,29,158
2020-04-10,PL,Poland,EURO,370,5574,16,174
2020-04-11,PL,Poland,EURO,380,5954,7,181
2020-04-12,PL,Poland,EURO,401,6355,27,208
2020-04-13,PL,Poland,EURO,318,6673,23,231
2020-04-14,PL,Poland,EURO,260,6933,13,244
2020-04-15,PL,Poland,EURO,269,7202,18,262
2020-04-16,PL,Poland,EURO,380,7582,22,284
2020-04-17,PL,Poland,EURO,336,7918,28,312
2020-04-18,PL,Poland,EURO,461,8379,18,330
2020-04-19,PL,Poland,EURO,363,8742,15,345
2020-04-20,PL,Poland,EURO,545,9287,13,358
2020-04-21,PL,Poland,EURO,306,9593,20,378
2020-04-22,PL,Poland,EURO,263,9856,20,398
2020-04-23,PL,Poland,EURO,313,10169,25,423
2020-04-24,PL,Poland,EURO,342,10511,28,451
2020-04-25,PL,Poland,EURO,381,10892,40,491
2020-04-26,PL,Poland,EURO,381,11273,30,521
2020-04-27,PL,Poland,EURO,344,11617,12,533
2020-04-28,PL,Poland,EURO,285,11902,27,560
2020-04-29,PL,Poland,EURO,316,12218,34,594
2020-04-30,PL,Poland,EURO,422,12640,28,622
2020-05-01,PL,Poland,EURO,237,12877,20,642
2020-05-02,PL,Poland,EURO,228,13105,7,649
2020-05-03,PL,Poland,EURO,270,13375,12,661
2020-05-04,PL,Poland,EURO,318,13693,15,676
2020-05-05,PL,Poland,EURO,313,14006,19,695
2020-05-06,PL,Poland,EURO,425,14431,19,714
2020-05-07,PL,Poland,EURO,309,14740,18,732
2020-05-08,PL,Poland,EURO,307,15047,22,754
2020-05-09,PL,Poland,EURO,319,15366,20,774
2020-05-10,PL,Poland,EURO,285,15651,9,783
2020-05-11,PL,Poland,EURO,345,15996,15,798
2020-05-12,PL,Poland,EURO,330,16326,11,809
2020-05-13,PL,Poland,EURO,595,16921,28,837
2020-05-14,PL,Poland,EURO,283,17204,23,860
2020-05-15,PL,Poland,EURO,411,17615,22,882
2020-05-16,PL,Poland,EURO,401,18016,24,906
2020-05-17,PL,Poland,EURO,241,18257,8,914
2020-05-18,PL,Poland,EURO,272,18529,10,924
2020-05-19,PL,Poland,EURO,356,18885,11,935
2020-05-20,PL,Poland,EURO,383,19268,12,947
2020-05-21,PL,Poland,EURO,471,19739,14,961
2020-05-22,PL,Poland,EURO,404,20143,10,971
2020-05-23,PL,Poland,EURO,476,20619,10,981
2020-05-24,PL,Poland,EURO,312,20931,11,992
2020-05-25,PL,Poland,EURO,395,21326,3,995
2020-05-26,PL,Poland,EURO,305,21631,11,1006
2020-05-27,PL,Poland,EURO,443,22074,17,1023
2020-05-28,PL,Poland,EURO,399,22473,4,1027
2020-05-29,PL,Poland,EURO,352,22825,10,1037
2020-05-30,PL,Poland,EURO,330,23155,13,1050
2020-05-31,PL,Poland,EURO,416,23571,10,1060
2020-06-01,PL,Poland,EURO,215,23786,3,1063
2020-06-02,PL,Poland,EURO,379,24165,10,1073
2020-06-03,PL,Poland,EURO,230,24395,18,1091
2020-06-04,PL,Poland,EURO,292,24687,23,1114
2020-06-05,PL,Poland,EURO,361,25048,2,1116
2020-06-06,PL,Poland,EURO,362,25410,20,1136
2020-06-07,PL,Poland,EURO,576,25986,14,1150
2020-06-08,PL,Poland,EURO,575,26561,4,1154
2020-03-29,PT,Portugal,EURO,723,4435,25,107
2020-03-30,PT,Portugal,EURO,563,4998,20,127
2020-03-31,PT,Portugal,EURO,453,5451,23,150
2020-04-01,PT,Portugal,EURO,933,6384,29,179
2020-04-02,PT,Portugal,EURO,865,7249,35,214
2020-04-03,PT,Portugal,EURO,718,7967,26,240
2020-04-04,PT,Portugal,EURO,741,8708,37,277
2020-04-05,PT,Portugal,EURO,709,9417,25,302
2020-04-06,PT,Portugal,EURO,587,10004,28,330
2020-04-07,PT,Portugal,EURO,489,10493,26,356
2020-04-08,PT,Portugal,EURO,760,11253,41,397
2020-04-09,PT,Portugal,EURO,696,11949,40,437
2020-04-10,PT,Portugal,EURO,756,12705,34,471
2020-04-11,PT,Portugal,EURO,666,13371,28,499
2020-04-12,PT,Portugal,EURO,548,13919,38,537
2020-04-13,PT,Portugal,EURO,566,14485,31,568
2020-04-14,PT,Portugal,EURO,441,14926,34,602
2020-04-15,PT,Portugal,EURO,676,15602,35,637
2020-04-16,PT,Portugal,EURO,707,16309,34,671
2020-04-17,PT,Portugal,EURO,678,16987,31,702
2020-04-18,PT,Portugal,EURO,697,17684,28,730
2020-04-19,PT,Portugal,EURO,715,18399,33,763
2020-04-20,PT,Portugal,EURO,350,18749,30,793
2020-04-21,PT,Portugal,EURO,417,19166,26,819
2020-04-22,PT,Portugal,EURO,610,19776,28,847
2020-04-23,PT,Portugal,EURO,514,20290,24,871
2020-04-24,PT,Portugal,EURO,499,20789,37,908
2020-04-25,PT,Portugal,EURO,561,21350,21,929
2020-04-26,PT,Portugal,EURO,475,21825,30,959
2020-04-27,PT,Portugal,EURO,263,22088,23,982
2020-04-28,PT,Portugal,EURO,260,22348,24,1006
2020-04-29,PT,Portugal,EURO,467,22815,20,1026
2020-04-30,PT,Portugal,EURO,453,23268,27,1053
2020-05-01,PT,Portugal,EURO,423,23691,14,1067
2020-05-02,PT,Portugal,EURO,406,24097,20,1087
2020-05-03,PT,Portugal,EURO,243,24340,17,1104
2020-05-04,PT,Portugal,EURO,204,24544,20,1124
2020-05-05,PT,Portugal,EURO,175,24719,22,1146
2020-05-06,PT,Portugal,EURO,456,25175,10,1156
2020-05-07,PT,Portugal,EURO,406,25581,15,1171
2020-05-08,PT,Portugal,EURO,377,25958,16,1187
2020-05-09,PT,Portugal,EURO,406,26364,9,1196
2020-05-10,PT,Portugal,EURO,329,26693,11,1207
2020-05-11,PT,Portugal,EURO,175,26868,10,1217
2020-05-12,PT,Portugal,EURO,176,27044,9,1226
2020-05-13,PT,Portugal,EURO,327,27371,16,1242
2020-05-14,PT,Portugal,EURO,252,27623,10,1252
2020-05-15,PT,Portugal,EURO,258,27881,5,1257
2020-05-16,PT,Portugal,EURO,298,28179,10,1267
2020-05-17,PT,Portugal,EURO,273,28452,10,1277
2020-05-18,PT,Portugal,EURO,230,28682,13,1290
2020-05-19,PT,Portugal,EURO,215,28897,5,1295
2020-05-20,PT,Portugal,EURO,325,29222,10,1305
2020-05-21,PT,Portugal,EURO,363,29585,11,1316
2020-05-22,PT,Portugal,EURO,310,29895,11,1327
2020-05-23,PT,Portugal,EURO,334,30229,5,1332
2020-05-24,PT,Portugal,EURO,358,30587,10,1342
2020-05-25,PT,Portugal,EURO,159,30746,10,1352
2020-05-26,PT,Portugal,EURO,158,30904,11,1363
2020-05-27,PT,Portugal,EURO,265,31169,9,1372
2020-05-28,PT,Portugal,EURO,328,31497,10,1382
2020-05-29,PT,Portugal,EURO,292,31789,9,1391
2020-05-30,PT,Portugal,EURO,345,32134,11,1402
2020-05-31,PT,Portugal,EURO,317,32451,11,1413
2020-06-01,PT,Portugal,EURO,254,32705,9,1422
2020-06-02,PT,Portugal,EURO,160,32865,10,1432
2020-06-03,PT,Portugal,EURO,328,33193,12,1444
2020-06-04,PT,Portugal,EURO,304,33497,6,1450
2020-06-05,PT,Portugal,EURO,390,33887,5,1455
2020-06-06,PT,Portugal,EURO,329,34216,7,1462
2020-06-07,PT,Portugal,EURO,402,34618,8,1470
2020-06-08,PT,Portugal,EURO,236,34854,5,1475
2020-03-29,PR,Puerto Rico,AMRO,24,296,3,16
2020-03-30,PR,Puerto Rico,AMRO,13,309,3,19
2020-03-31,PR,Puerto Rico,AMRO,88,397,3,22
2020-04-01,PR,Puerto Rico,AMRO,57,454,1,23
2020-04-02,PR,Puerto Rico,AMRO,73,527,2,25
2020-04-03,PR,Puerto Rico,AMRO,47,574,0,25
2020-04-04,PR,Puerto Rico,AMRO,42,616,5,30
2020-04-05,PR,Puerto Rico,AMRO,15,631,4,34
2020-04-06,PR,Puerto Rico,AMRO,3,634,2,36
2020-04-07,PR,Puerto Rico,AMRO,45,679,3,39
2020-04-08,PR,Puerto Rico,AMRO,32,711,3,42
2020-04-09,PR,Puerto Rico,AMRO,26,737,3,45
2020-04-10,PR,Puerto Rico,AMRO,36,773,4,49
2020-04-11,PR,Puerto Rico,AMRO,3,776,6,55
2020-04-12,PR,Puerto Rico,AMRO,13,789,3,58
2020-04-13,PR,Puerto Rico,AMRO,4,793,0,58
2020-04-14,PR,Puerto Rico,AMRO,25,818,6,64
2020-04-15,PR,Puerto Rico,AMRO,21,839,3,67
2020-04-16,PR,Puerto Rico,AMRO,26,865,4,71
2020-04-17,PR,Puerto Rico,AMRO,29,894,4,75
2020-04-18,PR,Puerto Rico,AMRO,22,916,2,77
2020-04-19,PR,Puerto Rico,AMRO,11,927,2,79
2020-04-20,PR,Puerto Rico,AMRO,2,929,3,82
2020-04-21,PR,Puerto Rico,AMRO,17,946,1,83
2020-04-22,PR,Puerto Rico,AMRO,20,966,5,88
2020-04-23,PR,Puerto Rico,AMRO,32,998,4,92
2020-04-24,PR,Puerto Rico,AMRO,18,1016,2,94
2020-04-25,PR,Puerto Rico,AMRO,17,1033,3,97
2020-04-26,PR,Puerto Rico,AMRO,3,1036,1,98
2020-04-27,PR,Puerto Rico,AMRO,2,1038,5,103
2020-04-28,PR,Puerto Rico,AMRO,13,1051,0,103
2020-04-29,PR,Puerto Rico,AMRO,20,1071,2,105
2020-04-30,PR,Puerto Rico,AMRO,17,1088,0,105
2020-05-01,PR,Puerto Rico,AMRO,19,1107,1,106
2020-05-02,PR,Puerto Rico,AMRO,14,1121,3,109
2020-05-03,PR,Puerto Rico,AMRO,7,1128,4,113
2020-05-04,PR,Puerto Rico,AMRO,4,1132,2,115
2020-05-05,PR,Puerto Rico,AMRO,10,1142,3,118
2020-05-06,PR,Puerto Rico,AMRO,23,1165,2,120
2020-05-07,PR,Puerto Rico,AMRO,24,1189,1,121
2020-05-08,PR,Puerto Rico,AMRO,16,1205,2,123
2020-05-09,PR,Puerto Rico,AMRO,26,1231,0,123
2020-05-10,PR,Puerto Rico,AMRO,5,1236,0,123
2020-05-11,PR,Puerto Rico,AMRO,0,1236,2,125
2020-05-12,PR,Puerto Rico,AMRO,16,1252,0,125
2020-05-13,PR,Puerto Rico,AMRO,21,1273,0,125
2020-05-14,PR,Puerto Rico,AMRO,9,1282,1,126
2020-05-15,PR,Puerto Rico,AMRO,13,1295,0,126
2020-05-16,PR,Puerto Rico,AMRO,10,1305,1,127
2020-05-17,PR,Puerto Rico,AMRO,4,1309,1,128
2020-05-18,PR,Puerto Rico,AMRO,1,1310,1,129
2020-05-19,PR,Puerto Rico,AMRO,12,1322,1,130
2020-05-20,PR,Puerto Rico,AMRO,12,1334,2,132
2020-05-21,PR,Puerto Rico,AMRO,14,1348,2,134
2020-05-22,PR,Puerto Rico,AMRO,6,1354,1,135
2020-05-23,PR,Puerto Rico,AMRO,11,1365,1,136
2020-05-24,PR,Puerto Rico,AMRO,3,1368,1,137
2020-05-25,PR,Puerto Rico,AMRO,4,1372,0,137
2020-05-26,PR,Puerto Rico,AMRO,5,1377,0,137
2020-05-27,PR,Puerto Rico,AMRO,4,1381,1,138
2020-05-28,PR,Puerto Rico,AMRO,14,1395,2,140
2020-05-29,PR,Puerto Rico,AMRO,20,1415,1,141
2020-05-30,PR,Puerto Rico,AMRO,26,1441,0,141
2020-05-31,PR,Puerto Rico,AMRO,4,1445,2,143
2020-06-01,PR,Puerto Rico,AMRO,1,1446,1,144
2020-06-02,PR,Puerto Rico,AMRO,25,1471,2,146
2020-06-03,PR,Puerto Rico,AMRO,18,1489,0,146
2020-06-04,PR,Puerto Rico,AMRO,13,1502,0,146
2020-06-05,PR,Puerto Rico,AMRO,12,1514,2,148
2020-06-06,PR,Puerto Rico,AMRO,8,1522,0,148
2020-06-07,PR,Puerto Rico,AMRO,9,1531,1,149
2020-06-08,PR,Puerto Rico,AMRO,3,1534,1,150
2020-03-29,QA,Qatar,EMRO,28,590,0,0
2020-03-30,QA,Qatar,EMRO,44,634,1,1
2020-03-31,QA,Qatar,EMRO,59,693,0,1
2020-04-01,QA,Qatar,EMRO,88,781,1,2
2020-04-02,QA,Qatar,EMRO,54,835,0,2
2020-04-03,QA,Qatar,EMRO,114,949,1,3
2020-04-04,QA,Qatar,EMRO,126,1075,0,3
2020-04-05,QA,Qatar,EMRO,250,1325,0,3
2020-04-06,QA,Qatar,EMRO,279,1604,1,4
2020-04-07,QA,Qatar,EMRO,228,1832,0,4
2020-04-08,QA,Qatar,EMRO,225,2057,2,6
2020-04-09,QA,Qatar,EMRO,153,2210,0,6
2020-04-10,QA,Qatar,EMRO,166,2376,0,6
2020-04-11,QA,Qatar,EMRO,136,2512,0,6
2020-04-12,QA,Qatar,EMRO,216,2728,0,6
2020-04-13,QA,Qatar,EMRO,251,2979,1,7
2020-04-14,QA,Qatar,EMRO,252,3231,0,7
2020-04-15,QA,Qatar,EMRO,197,3428,0,7
2020-04-16,QA,Qatar,EMRO,283,3711,0,7
2020-04-17,QA,Qatar,EMRO,392,4103,0,7
2020-04-18,QA,Qatar,EMRO,560,4663,0,7
2020-04-19,QA,Qatar,EMRO,345,5008,1,8
2020-04-20,QA,Qatar,EMRO,440,5448,0,8
2020-04-21,QA,Qatar,EMRO,567,6015,1,9
2020-04-22,QA,Qatar,EMRO,518,6533,0,9
2020-04-23,QA,Qatar,EMRO,608,7141,1,10
2020-04-24,QA,Qatar,EMRO,623,7764,0,10
2020-04-25,QA,Qatar,EMRO,761,8525,0,10
2020-04-26,QA,Qatar,EMRO,833,9358,0,10
2020-04-27,QA,Qatar,EMRO,929,10287,0,10
2020-04-28,QA,Qatar,EMRO,957,11244,0,10
2020-04-29,QA,Qatar,EMRO,677,11921,0,10
2020-04-30,QA,Qatar,EMRO,643,12564,0,10
2020-05-01,QA,Qatar,EMRO,845,13409,0,10
2020-05-02,QA,Qatar,EMRO,687,14096,2,12
2020-05-03,QA,Qatar,EMRO,776,14872,0,12
2020-05-04,QA,Qatar,EMRO,679,15551,0,12
2020-05-05,QA,Qatar,EMRO,640,16191,0,12
2020-05-06,QA,Qatar,EMRO,951,17142,0,12
2020-05-07,QA,Qatar,EMRO,830,17972,0,12
2020-05-08,QA,Qatar,EMRO,918,18890,0,12
2020-05-09,QA,Qatar,EMRO,1311,20201,0,12
2020-05-10,QA,Qatar,EMRO,1130,21331,1,13
2020-05-11,QA,Qatar,EMRO,1189,22520,1,14
2020-05-12,QA,Qatar,EMRO,1103,23623,0,14
2020-05-13,QA,Qatar,EMRO,1526,25149,0,14
2020-05-14,QA,Qatar,EMRO,1390,26539,0,14
2020-05-15,QA,Qatar,EMRO,1733,28272,0,14
2020-05-16,QA,Qatar,EMRO,1153,29425,0,14
2020-05-17,QA,Qatar,EMRO,1547,30972,1,15
2020-05-18,QA,Qatar,EMRO,1632,32604,0,15
2020-05-19,QA,Qatar,EMRO,1365,33969,0,15
2020-05-20,QA,Qatar,EMRO,1637,35606,0,15
2020-05-21,QA,Qatar,EMRO,1491,37097,1,16
2020-05-22,QA,Qatar,EMRO,1554,38651,1,17
2020-05-23,QA,Qatar,EMRO,1830,40481,2,19
2020-05-24,QA,Qatar,EMRO,1732,42213,2,21
2020-05-25,QA,Qatar,EMRO,1501,43714,2,23
2020-05-26,QA,Qatar,EMRO,1751,45465,3,26
2020-05-27,QA,Qatar,EMRO,1742,47207,2,28
2020-05-28,QA,Qatar,EMRO,1740,48947,2,30
2020-05-29,QA,Qatar,EMRO,1967,50914,3,33
2020-05-30,QA,Qatar,EMRO,1993,52907,3,36
2020-05-31,QA,Qatar,EMRO,2355,55262,0,36
2020-06-01,QA,Qatar,EMRO,1648,56910,2,38
2020-06-02,QA,Qatar,EMRO,1523,58433,2,40
2020-06-03,QA,Qatar,EMRO,1826,60259,3,43
2020-06-04,QA,Qatar,EMRO,1901,62160,2,45
2020-06-05,QA,Qatar,EMRO,1581,63741,0,45
2020-06-06,QA,Qatar,EMRO,1754,65495,4,49
2020-06-07,QA,Qatar,EMRO,1700,67195,2,51
2020-06-08,QA,Qatar,EMRO,1595,68790,3,54
2020-03-29,KR,Republic of Korea,WPRO,105,9583,8,152
2020-03-30,KR,Republic of Korea,WPRO,78,9661,6,158
2020-03-31,KR,Republic of Korea,WPRO,125,9786,4,162
2020-04-01,KR,Republic of Korea,WPRO,101,9887,3,165
2020-04-02,KR,Republic of Korea,WPRO,89,9976,4,169
2020-04-03,KR,Republic of Korea,WPRO,86,10062,5,174
2020-04-04,KR,Republic of Korea,WPRO,94,10156,3,177
2020-04-05,KR,Republic of Korea,WPRO,81,10237,6,183
2020-04-06,KR,Republic of Korea,WPRO,47,10284,3,186
2020-04-07,KR,Republic of Korea,WPRO,47,10331,6,192
2020-04-08,KR,Republic of Korea,WPRO,53,10384,8,200
2020-04-09,KR,Republic of Korea,WPRO,39,10423,4,204
2020-04-10,KR,Republic of Korea,WPRO,27,10450,4,208
2020-04-11,KR,Republic of Korea,WPRO,30,10480,3,211
2020-04-12,KR,Republic of Korea,WPRO,32,10512,3,214
2020-04-13,KR,Republic of Korea,WPRO,25,10537,3,217
2020-04-14,KR,Republic of Korea,WPRO,27,10564,5,222
2020-04-15,KR,Republic of Korea,WPRO,27,10591,3,225
2020-04-16,KR,Republic of Korea,WPRO,22,10613,4,229
2020-04-17,KR,Republic of Korea,WPRO,22,10635,1,230
2020-04-18,KR,Republic of Korea,WPRO,18,10653,2,232
2020-04-19,KR,Republic of Korea,WPRO,8,10661,2,234
2020-04-20,KR,Republic of Korea,WPRO,13,10674,2,236
2020-04-21,KR,Republic of Korea,WPRO,9,10683,1,237
2020-04-22,KR,Republic of Korea,WPRO,11,10694,1,238
2020-04-23,KR,Republic of Korea,WPRO,8,10702,2,240
2020-04-24,KR,Republic of Korea,WPRO,6,10708,0,240
2020-04-25,KR,Republic of Korea,WPRO,10,10718,0,240
2020-04-26,KR,Republic of Korea,WPRO,10,10728,2,242
2020-04-27,KR,Republic of Korea,WPRO,10,10738,1,243
2020-04-28,KR,Republic of Korea,WPRO,14,10752,1,244
2020-04-29,KR,Republic of Korea,WPRO,9,10761,2,246
2020-04-30,KR,Republic of Korea,WPRO,4,10765,1,247
2020-05-01,KR,Republic of Korea,WPRO,9,10774,1,248
2020-05-02,KR,Republic of Korea,WPRO,6,10780,2,250
2020-05-03,KR,Republic of Korea,WPRO,13,10793,0,250
2020-05-04,KR,Republic of Korea,WPRO,8,10801,2,252
2020-05-05,KR,Republic of Korea,WPRO,3,10804,2,254
2020-05-06,KR,Republic of Korea,WPRO,2,10806,1,255
2020-05-07,KR,Republic of Korea,WPRO,4,10810,1,256
2020-05-08,KR,Republic of Korea,WPRO,12,10822,0,256
2020-05-09,KR,Republic of Korea,WPRO,18,10840,0,256
2020-05-10,KR,Republic of Korea,WPRO,34,10874,0,256
2020-05-11,KR,Republic of Korea,WPRO,35,10909,0,256
2020-05-12,KR,Republic of Korea,WPRO,27,10936,2,258
2020-05-13,KR,Republic of Korea,WPRO,26,10962,1,259
2020-05-14,KR,Republic of Korea,WPRO,29,10991,1,260
2020-05-15,KR,Republic of Korea,WPRO,27,11018,0,260
2020-05-16,KR,Republic of Korea,WPRO,19,11037,2,262
2020-05-17,KR,Republic of Korea,WPRO,13,11050,0,262
2020-05-18,KR,Republic of Korea,WPRO,15,11065,1,263
2020-05-19,KR,Republic of Korea,WPRO,13,11078,0,263
2020-05-20,KR,Republic of Korea,WPRO,32,11110,0,263
2020-05-21,KR,Republic of Korea,WPRO,12,11122,1,264
2020-05-22,KR,Republic of Korea,WPRO,20,11142,0,264
2020-05-23,KR,Republic of Korea,WPRO,23,11165,2,266
2020-05-24,KR,Republic of Korea,WPRO,25,11190,0,266
2020-05-25,KR,Republic of Korea,WPRO,16,11206,1,267
2020-05-26,KR,Republic of Korea,WPRO,19,11225,2,269
2020-05-27,KR,Republic of Korea,WPRO,40,11265,0,269
2020-05-28,KR,Republic of Korea,WPRO,79,11344,0,269
2020-05-29,KR,Republic of Korea,WPRO,58,11402,0,269
2020-05-30,KR,Republic of Korea,WPRO,39,11441,0,269
2020-05-31,KR,Republic of Korea,WPRO,27,11468,1,270
2020-06-01,KR,Republic of Korea,WPRO,35,11503,1,271
2020-06-02,KR,Republic of Korea,WPRO,38,11541,1,272
2020-06-03,KR,Republic of Korea,WPRO,49,11590,1,273
2020-06-04,KR,Republic of Korea,WPRO,39,11629,0,273
2020-06-05,KR,Republic of Korea,WPRO,39,11668,0,273
2020-06-06,KR,Republic of Korea,WPRO,51,11719,0,273
2020-06-07,KR,Republic of Korea,WPRO,57,11776,0,273
2020-06-08,KR,Republic of Korea,WPRO,37,11813,0,273
2020-03-29,MD,Republic of Moldova,EURO,32,231,0,2
2020-03-30,MD,Republic of Moldova,EURO,32,263,0,2
2020-03-31,MD,Republic of Moldova,EURO,90,353,1,3
2020-04-01,MD,Republic of Moldova,EURO,70,423,2,5
2020-04-02,MD,Republic of Moldova,EURO,0,423,0,5
2020-04-03,MD,Republic of Moldova,EURO,168,591,3,8
2020-04-04,MD,Republic of Moldova,EURO,0,591,1,9
2020-04-05,MD,Republic of Moldova,EURO,161,752,3,12
2020-04-06,MD,Republic of Moldova,EURO,112,864,3,15
2020-04-07,MD,Republic of Moldova,EURO,101,965,4,19
2020-04-08,MD,Republic of Moldova,EURO,91,1056,3,22
2020-04-09,MD,Republic of Moldova,EURO,118,1174,6,28
2020-04-10,MD,Republic of Moldova,EURO,115,1289,1,29
2020-04-11,MD,Republic of Moldova,EURO,149,1438,0,29
2020-04-12,MD,Republic of Moldova,EURO,122,1560,1,30
2020-04-13,MD,Republic of Moldova,EURO,102,1662,3,33
2020-04-14,MD,Republic of Moldova,EURO,50,1712,3,36
2020-04-15,MD,Republic of Moldova,EURO,222,1934,5,41
2020-04-16,MD,Republic of Moldova,EURO,115,2049,5,46
2020-04-17,MD,Republic of Moldova,EURO,105,2154,8,54
2020-04-18,MD,Republic of Moldova,EURO,110,2264,2,56
2020-04-19,MD,Republic of Moldova,EURO,87,2351,4,60
2020-04-20,MD,Republic of Moldova,EURO,121,2472,7,67
2020-04-21,MD,Republic of Moldova,EURO,76,2548,3,70
2020-04-22,MD,Republic of Moldova,EURO,93,2641,3,73
2020-04-23,MD,Republic of Moldova,EURO,137,2778,3,76
2020-04-24,MD,Republic of Moldova,EURO,148,2926,4,80
2020-04-25,MD,Republic of Moldova,EURO,184,3110,7,87
2020-04-26,MD,Republic of Moldova,EURO,194,3304,7,94
2020-04-27,MD,Republic of Moldova,EURO,104,3408,2,96
2020-04-28,MD,Republic of Moldova,EURO,73,3481,7,103
2020-04-29,MD,Republic of Moldova,EURO,157,3638,6,109
2020-04-30,MD,Republic of Moldova,EURO,133,3771,7,116
2020-05-01,MD,Republic of Moldova,EURO,126,3897,3,119
2020-05-02,MD,Republic of Moldova,EURO,83,3980,3,122
2020-05-03,MD,Republic of Moldova,EURO,72,4052,2,124
2020-05-04,MD,Republic of Moldova,EURO,69,4121,4,128
2020-05-05,MD,Republic of Moldova,EURO,127,4248,5,133
2020-05-06,MD,Republic of Moldova,EURO,115,4363,7,140
2020-05-07,MD,Republic of Moldova,EURO,113,4476,3,143
2020-05-08,MD,Republic of Moldova,EURO,129,4605,2,145
2020-05-09,MD,Republic of Moldova,EURO,123,4728,14,159
2020-05-10,MD,Republic of Moldova,EURO,139,4867,6,165
2020-05-11,MD,Republic of Moldova,EURO,60,4927,6,171
2020-05-12,MD,Republic of Moldova,EURO,68,4995,8,179
2020-05-13,MD,Republic of Moldova,EURO,159,5154,3,182
2020-05-14,MD,Republic of Moldova,EURO,252,5406,8,190
2020-05-15,MD,Republic of Moldova,EURO,147,5553,6,196
2020-05-16,MD,Republic of Moldova,EURO,192,5745,8,204
2020-05-17,MD,Republic of Moldova,EURO,189,5934,5,209
2020-05-18,MD,Republic of Moldova,EURO,126,6060,2,211
2020-05-19,MD,Republic of Moldova,EURO,78,6138,8,219
2020-05-20,MD,Republic of Moldova,EURO,202,6340,5,224
2020-05-21,MD,Republic of Moldova,EURO,213,6553,8,232
2020-05-22,MD,Republic of Moldova,EURO,151,6704,1,233
2020-05-23,MD,Republic of Moldova,EURO,143,6847,5,238
2020-05-24,MD,Republic of Moldova,EURO,147,6994,12,250
2020-05-25,MD,Republic of Moldova,EURO,99,7093,6,256
2020-05-26,MD,Republic of Moldova,EURO,56,7149,9,265
2020-05-27,MD,Republic of Moldova,EURO,156,7305,8,273
2020-05-28,MD,Republic of Moldova,EURO,232,7537,3,276
2020-05-29,MD,Republic of Moldova,EURO,188,7725,6,282
2020-05-30,MD,Republic of Moldova,EURO,171,7896,7,289
2020-05-31,MD,Republic of Moldova,EURO,202,8098,7,296
2020-06-01,MD,Republic of Moldova,EURO,153,8251,1,297
2020-06-02,MD,Republic of Moldova,EURO,109,8360,12,309
2020-06-03,MD,Republic of Moldova,EURO,188,8548,2,311
2020-06-04,MD,Republic of Moldova,EURO,247,8795,5,316
2020-06-05,MD,Republic of Moldova,EURO,223,9018,1,317
2020-06-06,MD,Republic of Moldova,EURO,229,9247,8,325
2020-06-07,MD,Republic of Moldova,EURO,264,9511,12,337
2020-06-08,MD,Republic of Moldova,EURO,189,9700,11,348
2020-03-29,RE,Réunion,AFRO,0,143,0,0
2020-03-30,RE,Réunion,AFRO,64,207,0,0
2020-03-31,RE,Réunion,AFRO,0,207,0,0
2020-04-01,RE,Réunion,AFRO,40,247,0,0
2020-04-02,RE,Réunion,AFRO,34,281,0,0
2020-04-03,RE,Réunion,AFRO,27,308,0,0
2020-04-04,RE,Réunion,AFRO,13,321,0,0
2020-04-05,RE,Réunion,AFRO,13,334,0,0
2020-04-06,RE,Réunion,AFRO,10,344,0,0
2020-04-07,RE,Réunion,AFRO,5,349,0,0
2020-04-08,RE,Réunion,AFRO,9,358,0,0
2020-04-09,RE,Réunion,AFRO,4,362,0,0
2020-04-10,RE,Réunion,AFRO,14,376,0,0
2020-04-11,RE,Réunion,AFRO,6,382,0,0
2020-04-12,RE,Réunion,AFRO,6,388,0,0
2020-04-13,RE,Réunion,AFRO,1,389,0,0
2020-04-14,RE,Réunion,AFRO,1,390,0,0
2020-04-15,RE,Réunion,AFRO,0,390,0,0
2020-04-16,RE,Réunion,AFRO,0,390,0,0
2020-04-17,RE,Réunion,AFRO,4,394,0,0
2020-04-18,RE,Réunion,AFRO,8,402,0,0
2020-04-19,RE,Réunion,AFRO,5,407,0,0
2020-04-20,RE,Réunion,AFRO,1,408,0,0
2020-04-21,RE,Réunion,AFRO,0,408,0,0
2020-04-22,RE,Réunion,AFRO,2,410,0,0
2020-04-23,RE,Réunion,AFRO,0,410,0,0
2020-04-24,RE,Réunion,AFRO,1,411,0,0
2020-04-25,RE,Réunion,AFRO,0,411,0,0
2020-04-26,RE,Réunion,AFRO,0,411,0,0
2020-04-27,RE,Réunion,AFRO,5,416,0,0
2020-04-28,RE,Réunion,AFRO,1,417,0,0
2020-04-29,RE,Réunion,AFRO,0,417,0,0
2020-04-30,RE,Réunion,AFRO,3,420,0,0
2020-05-01,RE,Réunion,AFRO,0,420,0,0
2020-05-02,RE,Réunion,AFRO,0,420,0,0
2020-05-03,RE,Réunion,AFRO,0,420,0,0
2020-05-04,RE,Réunion,AFRO,3,423,0,0
2020-05-05,RE,Réunion,AFRO,1,424,0,0
2020-05-06,RE,Réunion,AFRO,1,425,0,0
2020-05-07,RE,Réunion,AFRO,0,425,0,0
2020-05-08,RE,Réunion,AFRO,2,427,0,0
2020-05-09,RE,Réunion,AFRO,3,430,0,0
2020-05-10,RE,Réunion,AFRO,0,430,0,0
2020-05-11,RE,Réunion,AFRO,6,436,0,0
2020-05-12,RE,Réunion,AFRO,0,436,0,0
2020-05-13,RE,Réunion,AFRO,1,437,0,0
2020-05-14,RE,Réunion,AFRO,2,439,0,0
2020-05-15,RE,Réunion,AFRO,1,440,0,0
2020-05-16,RE,Réunion,AFRO,1,441,0,0
2020-05-17,RE,Réunion,AFRO,2,443,0,0
2020-05-18,RE,Réunion,AFRO,0,443,0,0
2020-05-19,RE,Réunion,AFRO,3,446,0,0
2020-05-20,RE,Réunion,AFRO,0,446,0,0
2020-05-21,RE,Réunion,AFRO,1,447,1,1
2020-05-22,RE,Réunion,AFRO,2,449,0,1
2020-05-23,RE,Réunion,AFRO,0,449,0,1
2020-05-24,RE,Réunion,AFRO,3,452,0,1
2020-05-25,RE,Réunion,AFRO,0,452,0,1
2020-05-26,RE,Réunion,AFRO,4,456,0,1
2020-05-27,RE,Réunion,AFRO,3,459,0,1
2020-05-28,RE,Réunion,AFRO,1,460,0,1
2020-05-29,RE,Réunion,AFRO,5,465,0,1
2020-05-30,RE,Réunion,AFRO,5,470,0,1
2020-05-31,RE,Réunion,AFRO,1,471,0,1
2020-06-01,RE,Réunion,AFRO,0,471,0,1
2020-06-02,RE,Réunion,AFRO,2,473,0,1
2020-06-03,RE,Réunion,AFRO,4,477,0,1
2020-06-04,RE,Réunion,AFRO,1,478,0,1
2020-06-05,RE,Réunion,AFRO,1,479,0,1
2020-06-06,RE,Réunion,AFRO,1,480,0,1
2020-06-07,RE,Réunion,AFRO,0,480,0,1
2020-06-08,RE,Réunion,AFRO,0,480,0,1
2020-03-29,RO,Romania,EURO,160,1452,11,37
2020-03-30,RO,Romania,EURO,308,1760,6,43
2020-03-31,RO,Romania,EURO,192,1952,22,65
2020-04-01,RO,Romania,EURO,293,2245,17,82
2020-04-02,RO,Romania,EURO,215,2460,10,92
2020-04-03,RO,Romania,EURO,278,2738,23,115
2020-04-04,RO,Romania,EURO,445,3183,18,133
2020-04-05,RO,Romania,EURO,430,3613,13,146
2020-04-06,RO,Romania,EURO,251,3864,5,151
2020-04-07,RO,Romania,EURO,193,4057,25,176
2020-04-08,RO,Romania,EURO,360,4417,21,197
2020-04-09,RO,Romania,EURO,344,4761,23,220
2020-04-10,RO,Romania,EURO,441,5202,28,248
2020-04-11,RO,Romania,EURO,265,5467,22,270
2020-04-12,RO,Romania,EURO,523,5990,21,291
2020-04-13,RO,Romania,EURO,310,6300,23,314
2020-04-14,RO,Romania,EURO,333,6633,17,331
2020-04-15,RO,Romania,EURO,246,6879,20,351
2020-04-16,RO,Romania,EURO,337,7216,21,372
2020-04-17,RO,Romania,EURO,491,7707,20,392
2020-04-18,RO,Romania,EURO,360,8067,19,411
2020-04-19,RO,Romania,EURO,351,8418,10,421
2020-04-20,RO,Romania,EURO,328,8746,30,451
2020-04-21,RO,Romania,EURO,190,8936,27,478
2020-04-22,RO,Romania,EURO,306,9242,20,498
2020-04-23,RO,Romania,EURO,468,9710,26,524
2020-04-24,RO,Romania,EURO,386,10096,21,545
2020-04-25,RO,Romania,EURO,321,10417,22,567
2020-04-26,RO,Romania,EURO,218,10635,34,601
2020-04-27,RO,Romania,EURO,401,11036,18,619
2020-04-28,RO,Romania,EURO,303,11339,27,646
2020-04-29,RO,Romania,EURO,277,11616,17,663
2020-04-30,RO,Romania,EURO,362,11978,30,693
2020-05-01,RO,Romania,EURO,262,12240,24,717
2020-05-02,RO,Romania,EURO,327,12567,27,744
2020-05-03,RO,Romania,EURO,165,12732,27,771
2020-05-04,RO,Romania,EURO,431,13163,19,790
2020-05-05,RO,Romania,EURO,349,13512,28,818
2020-05-06,RO,Romania,EURO,325,13837,23,841
2020-05-07,RO,Romania,EURO,270,14107,23,864
2020-05-08,RO,Romania,EURO,392,14499,24,888
2020-05-09,RO,Romania,EURO,312,14811,35,923
2020-05-10,RO,Romania,EURO,320,15131,16,939
2020-05-11,RO,Romania,EURO,231,15362,22,961
2020-05-12,RO,Romania,EURO,226,15588,21,982
2020-05-13,RO,Romania,EURO,190,15778,20,1002
2020-05-14,RO,Romania,EURO,224,16002,34,1036
2020-05-15,RO,Romania,EURO,245,16247,17,1053
2020-05-16,RO,Romania,EURO,190,16437,17,1070
2020-05-17,RO,Romania,EURO,267,16704,24,1094
2020-05-18,RO,Romania,EURO,167,16871,13,1107
2020-05-19,RO,Romania,EURO,165,17036,13,1120
2020-05-20,RO,Romania,EURO,155,17191,17,1137
2020-05-21,RO,Romania,EURO,196,17387,10,1147
2020-05-22,RO,Romania,EURO,198,17585,9,1156
2020-05-23,RO,Romania,EURO,127,17712,10,1166
2020-05-24,RO,Romania,EURO,145,17857,10,1176
2020-05-25,RO,Romania,EURO,213,18070,9,1185
2020-05-26,RO,Romania,EURO,213,18283,17,1202
2020-05-27,RO,Romania,EURO,146,18429,14,1216
2020-05-28,RO,Romania,EURO,165,18594,7,1223
2020-05-29,RO,Romania,EURO,197,18791,12,1235
2020-05-30,RO,Romania,EURO,191,18982,13,1248
2020-05-31,RO,Romania,EURO,151,19133,11,1259
2020-06-01,RO,Romania,EURO,124,19257,7,1266
2020-06-02,RO,Romania,EURO,141,19398,10,1276
2020-06-03,RO,Romania,EURO,119,19517,12,1288
2020-06-04,RO,Romania,EURO,152,19669,8,1296
2020-06-05,RO,Romania,EURO,238,19907,9,1305
2020-06-06,RO,Romania,EURO,196,20103,11,1316
2020-06-07,RO,Romania,EURO,187,20290,2,1318
2020-06-08,RO,Romania,EURO,189,20479,15,1333
2020-03-29,RU,Russian Federation,EURO,270,1534,4,8
2020-03-30,RU,Russian Federation,EURO,303,1837,1,9
2020-03-31,RU,Russian Federation,EURO,500,2337,8,17
2020-04-01,RU,Russian Federation,EURO,440,2777,7,24
2020-04-02,RU,Russian Federation,EURO,0,2777,0,24
2020-04-03,RU,Russian Federation,EURO,771,3548,6,30
2020-04-04,RU,Russian Federation,EURO,601,4149,4,34
2020-04-05,RU,Russian Federation,EURO,582,4731,9,43
2020-04-06,RU,Russian Federation,EURO,658,5389,2,45
2020-04-07,RU,Russian Federation,EURO,954,6343,2,47
2020-04-08,RU,Russian Federation,EURO,1154,7497,11,58
2020-04-09,RU,Russian Federation,EURO,2634,10131,18,76
2020-04-10,RU,Russian Federation,EURO,1786,11917,18,94
2020-04-11,RU,Russian Federation,EURO,1667,13584,12,106
2020-04-12,RU,Russian Federation,EURO,2186,15770,24,130
2020-04-13,RU,Russian Federation,EURO,2558,18328,18,148
2020-04-14,RU,Russian Federation,EURO,2774,21102,22,170
2020-04-15,RU,Russian Federation,EURO,3388,24490,28,198
2020-04-16,RU,Russian Federation,EURO,3448,27938,34,232
2020-04-17,RU,Russian Federation,EURO,4070,32008,41,273
2020-04-18,RU,Russian Federation,EURO,4785,36793,40,313
2020-04-19,RU,Russian Federation,EURO,6060,42853,48,361
2020-04-20,RU,Russian Federation,EURO,4268,47121,44,405
2020-04-21,RU,Russian Federation,EURO,5642,52763,51,456
2020-04-22,RU,Russian Federation,EURO,5236,57999,57,513
2020-04-23,RU,Russian Federation,EURO,4774,62773,42,555
2020-04-24,RU,Russian Federation,EURO,5849,68622,60,615
2020-04-25,RU,Russian Federation,EURO,5966,74588,66,681
2020-04-26,RU,Russian Federation,EURO,6361,80949,66,747
2020-04-27,RU,Russian Federation,EURO,6198,87147,47,794
2020-04-28,RU,Russian Federation,EURO,6411,93558,73,867
2020-04-29,RU,Russian Federation,EURO,5841,99399,105,972
2020-04-30,RU,Russian Federation,EURO,7099,106498,101,1073
2020-05-01,RU,Russian Federation,EURO,7933,114431,96,1169
2020-05-02,RU,Russian Federation,EURO,9623,124054,53,1222
2020-05-03,RU,Russian Federation,EURO,10633,134687,58,1280
2020-05-04,RU,Russian Federation,EURO,10581,145268,76,1356
2020-05-05,RU,Russian Federation,EURO,10102,155370,95,1451
2020-05-06,RU,Russian Federation,EURO,10559,165929,86,1537
2020-05-07,RU,Russian Federation,EURO,11231,177160,88,1625
2020-05-08,RU,Russian Federation,EURO,10699,187859,98,1723
2020-05-09,RU,Russian Federation,EURO,10817,198676,104,1827
2020-05-10,RU,Russian Federation,EURO,11012,209688,88,1915
2020-05-11,RU,Russian Federation,EURO,11656,221344,94,2009
2020-05-12,RU,Russian Federation,EURO,10899,232243,107,2116
2020-05-13,RU,Russian Federation,EURO,10028,242271,96,2212
2020-05-14,RU,Russian Federation,EURO,9974,252245,93,2305
2020-05-15,RU,Russian Federation,EURO,10598,262843,113,2418
2020-05-16,RU,Russian Federation,EURO,9200,272043,119,2537
2020-05-17,RU,Russian Federation,EURO,9709,281752,94,2631
2020-05-18,RU,Russian Federation,EURO,8926,290678,91,2722
2020-05-19,RU,Russian Federation,EURO,9263,299941,115,2837
2020-05-20,RU,Russian Federation,EURO,8764,308705,135,2972
2020-05-21,RU,Russian Federation,EURO,8849,317554,127,3099
2020-05-22,RU,Russian Federation,EURO,8894,326448,150,3249
2020-05-23,RU,Russian Federation,EURO,9434,335882,139,3388
2020-05-24,RU,Russian Federation,EURO,8599,344481,153,3541
2020-05-25,RU,Russian Federation,EURO,8946,353427,92,3633
2020-05-26,RU,Russian Federation,EURO,8915,362342,174,3807
2020-05-27,RU,Russian Federation,EURO,8338,370680,161,3968
2020-05-28,RU,Russian Federation,EURO,8371,379051,174,4142
2020-05-29,RU,Russian Federation,EURO,8572,387623,232,4374
2020-05-30,RU,Russian Federation,EURO,8952,396575,181,4555
2020-05-31,RU,Russian Federation,EURO,9268,405843,138,4693
2020-06-01,RU,Russian Federation,EURO,9035,414878,162,4855
2020-06-02,RU,Russian Federation,EURO,8863,423741,182,5037
2020-06-03,RU,Russian Federation,EURO,8536,432277,178,5215
2020-06-04,RU,Russian Federation,EURO,8831,441108,169,5384
2020-06-05,RU,Russian Federation,EURO,8726,449834,144,5528
2020-06-06,RU,Russian Federation,EURO,8855,458689,197,5725
2020-06-07,RU,Russian Federation,EURO,8984,467673,134,5859
2020-06-08,RU,Russian Federation,EURO,8985,476658,112,5971
2020-03-29,RW,Rwanda,AFRO,2,58,0,1
2020-03-30,RW,Rwanda,AFRO,12,70,0,1
2020-03-31,RW,Rwanda,AFRO,0,70,0,1
2020-04-01,RW,Rwanda,AFRO,5,75,0,1
2020-04-02,RW,Rwanda,AFRO,7,82,0,1
2020-04-03,RW,Rwanda,AFRO,2,84,0,1
2020-04-04,RW,Rwanda,AFRO,5,89,0,1
2020-04-05,RW,Rwanda,AFRO,13,102,0,1
2020-04-06,RW,Rwanda,AFRO,2,104,0,1
2020-04-07,RW,Rwanda,AFRO,1,105,0,1
2020-04-08,RW,Rwanda,AFRO,0,105,0,1
2020-04-09,RW,Rwanda,AFRO,5,110,0,1
2020-04-10,RW,Rwanda,AFRO,3,113,0,1
2020-04-11,RW,Rwanda,AFRO,5,118,0,1
2020-04-12,RW,Rwanda,AFRO,2,120,0,1
2020-04-13,RW,Rwanda,AFRO,6,126,0,1
2020-04-14,RW,Rwanda,AFRO,1,127,0,1
2020-04-15,RW,Rwanda,AFRO,7,134,0,1
2020-04-16,RW,Rwanda,AFRO,2,136,0,1
2020-04-17,RW,Rwanda,AFRO,2,138,0,1
2020-04-18,RW,Rwanda,AFRO,5,143,0,1
2020-04-19,RW,Rwanda,AFRO,1,144,0,1
2020-04-20,RW,Rwanda,AFRO,3,147,0,1
2020-04-21,RW,Rwanda,AFRO,0,147,0,1
2020-04-22,RW,Rwanda,AFRO,3,150,0,1
2020-04-23,RW,Rwanda,AFRO,3,153,0,1
2020-04-24,RW,Rwanda,AFRO,1,154,0,1
2020-04-25,RW,Rwanda,AFRO,22,176,0,1
2020-04-26,RW,Rwanda,AFRO,7,183,0,1
2020-04-27,RW,Rwanda,AFRO,8,191,0,1
2020-04-28,RW,Rwanda,AFRO,16,207,0,1
2020-04-29,RW,Rwanda,AFRO,5,212,0,1
2020-04-30,RW,Rwanda,AFRO,13,225,0,1
2020-05-01,RW,Rwanda,AFRO,18,243,0,1
2020-05-02,RW,Rwanda,AFRO,6,249,0,1
2020-05-03,RW,Rwanda,AFRO,6,255,0,1
2020-05-04,RW,Rwanda,AFRO,4,259,0,1
2020-05-05,RW,Rwanda,AFRO,2,261,0,1
2020-05-06,RW,Rwanda,AFRO,0,261,0,1
2020-05-07,RW,Rwanda,AFRO,7,268,0,1
2020-05-08,RW,Rwanda,AFRO,3,271,0,1
2020-05-09,RW,Rwanda,AFRO,3,274,0,1
2020-05-10,RW,Rwanda,AFRO,7,281,0,1
2020-05-11,RW,Rwanda,AFRO,4,285,0,1
2020-05-12,RW,Rwanda,AFRO,1,286,0,1
2020-05-13,RW,Rwanda,AFRO,0,286,0,1
2020-05-14,RW,Rwanda,AFRO,1,287,0,1
2020-05-15,RW,Rwanda,AFRO,0,287,0,1
2020-05-16,RW,Rwanda,AFRO,0,287,0,1
2020-05-17,RW,Rwanda,AFRO,2,289,0,1
2020-05-18,RW,Rwanda,AFRO,3,292,0,1
2020-05-19,RW,Rwanda,AFRO,5,297,0,1
2020-05-20,RW,Rwanda,AFRO,11,308,0,1
2020-05-21,RW,Rwanda,AFRO,6,314,0,1
2020-05-22,RW,Rwanda,AFRO,6,320,0,1
2020-05-23,RW,Rwanda,AFRO,1,321,0,1
2020-05-24,RW,Rwanda,AFRO,4,325,0,1
2020-05-25,RW,Rwanda,AFRO,2,327,0,1
2020-05-26,RW,Rwanda,AFRO,9,336,0,1
2020-05-27,RW,Rwanda,AFRO,3,339,0,1
2020-05-28,RW,Rwanda,AFRO,7,346,0,1
2020-05-29,RW,Rwanda,AFRO,3,349,0,1
2020-05-30,RW,Rwanda,AFRO,6,355,0,1
2020-05-31,RW,Rwanda,AFRO,4,359,0,1
2020-06-01,RW,Rwanda,AFRO,11,370,0,1
2020-06-02,RW,Rwanda,AFRO,7,377,0,1
2020-06-03,RW,Rwanda,AFRO,7,384,1,2
2020-06-04,RW,Rwanda,AFRO,13,397,0,2
2020-06-05,RW,Rwanda,AFRO,13,410,0,2
2020-06-06,RW,Rwanda,AFRO,10,420,0,2
2020-06-07,RW,Rwanda,AFRO,11,431,0,2
2020-06-08,RW,Rwanda,AFRO,8,439,0,2
2020-03-29,XC,Saba,AMRO,0,0,0,0
2020-03-30,XC,Saba,AMRO,0,0,0,0
2020-03-31,XC,Saba,AMRO,0,0,0,0
2020-04-01,XC,Saba,AMRO,0,0,0,0
2020-04-02,XC,Saba,AMRO,0,0,0,0
2020-04-03,XC,Saba,AMRO,0,0,0,0
2020-04-04,XC,Saba,AMRO,0,0,0,0
2020-04-05,XC,Saba,AMRO,0,0,0,0
2020-04-06,XC,Saba,AMRO,0,0,0,0
2020-04-07,XC,Saba,AMRO,0,0,0,0
2020-04-08,XC,Saba,AMRO,0,0,0,0
2020-04-09,XC,Saba,AMRO,0,0,0,0
2020-04-10,XC,Saba,AMRO,0,0,0,0
2020-04-11,XC,Saba,AMRO,1,1,0,0
2020-04-12,XC,Saba,AMRO,0,1,0,0
2020-04-13,XC,Saba,AMRO,0,1,0,0
2020-04-14,XC,Saba,AMRO,1,2,0,0
2020-04-15,XC,Saba,AMRO,0,2,0,0
2020-04-16,XC,Saba,AMRO,0,2,0,0
2020-04-17,XC,Saba,AMRO,0,2,0,0
2020-04-18,XC,Saba,AMRO,0,2,0,0
2020-04-19,XC,Saba,AMRO,0,2,0,0
2020-04-20,XC,Saba,AMRO,0,2,0,0
2020-04-21,XC,Saba,AMRO,0,2,0,0
2020-04-22,XC,Saba,AMRO,0,2,0,0
2020-04-23,XC,Saba,AMRO,0,2,0,0
2020-04-24,XC,Saba,AMRO,0,2,0,0
2020-04-25,XC,Saba,AMRO,0,2,0,0
2020-04-26,XC,Saba,AMRO,0,2,0,0
2020-04-27,XC,Saba,AMRO,0,2,0,0
2020-04-28,XC,Saba,AMRO,0,2,0,0
2020-04-29,XC,Saba,AMRO,0,2,0,0
2020-04-30,XC,Saba,AMRO,0,2,0,0
2020-05-01,XC,Saba,AMRO,0,2,0,0
2020-05-02,XC,Saba,AMRO,0,2,0,0
2020-05-03,XC,Saba,AMRO,0,2,0,0
2020-05-04,XC,Saba,AMRO,0,2,0,0
2020-05-05,XC,Saba,AMRO,0,2,0,0
2020-05-06,XC,Saba,AMRO,0,2,0,0
2020-05-07,XC,Saba,AMRO,0,2,0,0
2020-05-08,XC,Saba,AMRO,0,2,0,0
2020-05-09,XC,Saba,AMRO,0,2,0,0
2020-05-10,XC,Saba,AMRO,0,2,0,0
2020-05-11,XC,Saba,AMRO,0,2,0,0
2020-05-12,XC,Saba,AMRO,0,2,0,0
2020-05-13,XC,Saba,AMRO,0,2,0,0
2020-05-14,XC,Saba,AMRO,0,2,0,0
2020-05-15,XC,Saba,AMRO,0,2,0,0
2020-05-16,XC,Saba,AMRO,0,2,0,0
2020-05-17,XC,Saba,AMRO,0,2,0,0
2020-05-18,XC,Saba,AMRO,0,2,0,0
2020-05-19,XC,Saba,AMRO,0,2,0,0
2020-05-20,XC,Saba,AMRO,0,2,0,0
2020-05-21,XC,Saba,AMRO,0,2,0,0
2020-05-22,XC,Saba,AMRO,0,2,0,0
2020-05-23,XC,Saba,AMRO,0,2,0,0
2020-05-24,XC,Saba,AMRO,0,2,0,0
2020-05-25,XC,Saba,AMRO,0,2,0,0
2020-05-26,XC,Saba,AMRO,0,2,0,0
2020-05-27,XC,Saba,AMRO,1,3,0,0
2020-05-28,XC,Saba,AMRO,0,3,0,0
2020-05-29,XC,Saba,AMRO,0,3,0,0
2020-05-30,XC,Saba,AMRO,0,3,0,0
2020-05-31,XC,Saba,AMRO,0,3,0,0
2020-06-01,XC,Saba,AMRO,0,3,0,0
2020-06-02,XC,Saba,AMRO,0,3,0,0
2020-06-03,XC,Saba,AMRO,0,3,0,0
2020-06-04,XC,Saba,AMRO,0,3,0,0
2020-06-05,XC,Saba,AMRO,0,3,0,0
2020-06-06,XC,Saba,AMRO,0,3,0,0
2020-06-07,XC,Saba,AMRO,0,3,0,0
2020-06-08,XC,Saba,AMRO,0,3,0,0
2020-03-29,BL,Saint Barthélemy,AMRO,0,5,0,0
2020-03-30,BL,Saint Barthélemy,AMRO,0,5,0,0
2020-03-31,BL,Saint Barthélemy,AMRO,1,6,0,0
2020-04-01,BL,Saint Barthélemy,AMRO,0,6,0,0
2020-04-02,BL,Saint Barthélemy,AMRO,0,6,0,0
2020-04-03,BL,Saint Barthélemy,AMRO,0,6,0,0
2020-04-04,BL,Saint Barthélemy,AMRO,0,6,0,0
2020-04-05,BL,Saint Barthélemy,AMRO,0,6,0,0
2020-04-06,BL,Saint Barthélemy,AMRO,0,6,0,0
2020-04-07,BL,Saint Barthélemy,AMRO,0,6,0,0
2020-04-08,BL,Saint Barthélemy,AMRO,0,6,0,0
2020-04-09,BL,Saint Barthélemy,AMRO,0,6,0,0
2020-04-10,BL,Saint Barthélemy,AMRO,0,6,0,0
2020-04-11,BL,Saint Barthélemy,AMRO,0,6,0,0
2020-04-12,BL,Saint Barthélemy,AMRO,0,6,0,0
2020-04-13,BL,Saint Barthélemy,AMRO,0,6,0,0
2020-04-14,BL,Saint Barthélemy,AMRO,0,6,0,0
2020-04-15,BL,Saint Barthélemy,AMRO,0,6,0,0
2020-04-16,BL,Saint Barthélemy,AMRO,0,6,0,0
2020-04-17,BL,Saint Barthélemy,AMRO,0,6,0,0
2020-04-18,BL,Saint Barthélemy,AMRO,0,6,0,0
2020-04-19,BL,Saint Barthélemy,AMRO,0,6,0,0
2020-04-20,BL,Saint Barthélemy,AMRO,0,6,0,0
2020-04-21,BL,Saint Barthélemy,AMRO,0,6,0,0
2020-04-22,BL,Saint Barthélemy,AMRO,0,6,0,0
2020-04-23,BL,Saint Barthélemy,AMRO,0,6,0,0
2020-04-24,BL,Saint Barthélemy,AMRO,0,6,0,0
2020-04-25,BL,Saint Barthélemy,AMRO,0,6,0,0
2020-04-26,BL,Saint Barthélemy,AMRO,0,6,0,0
2020-04-27,BL,Saint Barthélemy,AMRO,0,6,0,0
2020-04-28,BL,Saint Barthélemy,AMRO,0,6,0,0
2020-04-29,BL,Saint Barthélemy,AMRO,0,6,0,0
2020-04-30,BL,Saint Barthélemy,AMRO,0,6,0,0
2020-05-01,BL,Saint Barthélemy,AMRO,0,6,0,0
2020-05-02,BL,Saint Barthélemy,AMRO,0,6,0,0
2020-05-03,BL,Saint Barthélemy,AMRO,0,6,0,0
2020-05-04,BL,Saint Barthélemy,AMRO,0,6,0,0
2020-05-05,BL,Saint Barthélemy,AMRO,0,6,0,0
2020-05-06,BL,Saint Barthélemy,AMRO,0,6,0,0
2020-05-07,BL,Saint Barthélemy,AMRO,0,6,0,0
2020-05-08,BL,Saint Barthélemy,AMRO,0,6,0,0
2020-05-09,BL,Saint Barthélemy,AMRO,0,6,0,0
2020-05-10,BL,Saint Barthélemy,AMRO,0,6,0,0
2020-05-11,BL,Saint Barthélemy,AMRO,0,6,0,0
2020-05-12,BL,Saint Barthélemy,AMRO,0,6,0,0
2020-05-13,BL,Saint Barthélemy,AMRO,0,6,0,0
2020-05-14,BL,Saint Barthélemy,AMRO,0,6,0,0
2020-05-15,BL,Saint Barthélemy,AMRO,0,6,0,0
2020-05-16,BL,Saint Barthélemy,AMRO,0,6,0,0
2020-05-17,BL,Saint Barthélemy,AMRO,0,6,0,0
2020-05-18,BL,Saint Barthélemy,AMRO,0,6,0,0
2020-05-19,BL,Saint Barthélemy,AMRO,0,6,0,0
2020-05-20,BL,Saint Barthélemy,AMRO,0,6,0,0
2020-05-21,BL,Saint Barthélemy,AMRO,0,6,0,0
2020-05-22,BL,Saint Barthélemy,AMRO,0,6,0,0
2020-05-23,BL,Saint Barthélemy,AMRO,0,6,0,0
2020-05-24,BL,Saint Barthélemy,AMRO,0,6,0,0
2020-05-25,BL,Saint Barthélemy,AMRO,0,6,0,0
2020-05-26,BL,Saint Barthélemy,AMRO,0,6,0,0
2020-05-27,BL,Saint Barthélemy,AMRO,0,6,0,0
2020-05-28,BL,Saint Barthélemy,AMRO,0,6,0,0
2020-05-29,BL,Saint Barthélemy,AMRO,0,6,0,0
2020-05-30,BL,Saint Barthélemy,AMRO,0,6,0,0
2020-05-31,BL,Saint Barthélemy,AMRO,0,6,0,0
2020-06-01,BL,Saint Barthélemy,AMRO,0,6,0,0
2020-06-02,BL,Saint Barthélemy,AMRO,0,6,0,0
2020-06-03,BL,Saint Barthélemy,AMRO,0,6,0,0
2020-06-04,BL,Saint Barthélemy,AMRO,0,6,0,0
2020-06-05,BL,Saint Barthélemy,AMRO,0,6,0,0
2020-06-06,BL,Saint Barthélemy,AMRO,0,6,0,0
2020-06-07,BL,Saint Barthélemy,AMRO,0,6,0,0
2020-06-08,BL,Saint Barthélemy,AMRO,0,6,0,0
2020-03-29,SH,"Saint Helena, Ascension and Tristan da Cunha",AFRO,0,0,0,0
2020-03-30,SH,"Saint Helena, Ascension and Tristan da Cunha",AFRO,0,0,0,0
2020-03-31,SH,"Saint Helena, Ascension and Tristan da Cunha",AFRO,0,0,0,0
2020-04-01,SH,"Saint Helena, Ascension and Tristan da Cunha",AFRO,0,0,0,0
2020-04-02,SH,"Saint Helena, Ascension and Tristan da Cunha",AFRO,0,0,0,0
2020-04-03,SH,"Saint Helena, Ascension and Tristan da Cunha",AFRO,0,0,0,0
2020-04-04,SH,"Saint Helena, Ascension and Tristan da Cunha",AFRO,0,0,0,0
2020-04-05,SH,"Saint Helena, Ascension and Tristan da Cunha",AFRO,0,0,0,0
2020-04-06,SH,"Saint Helena, Ascension and Tristan da Cunha",AFRO,0,0,0,0
2020-04-07,SH,"Saint Helena, Ascension and Tristan da Cunha",AFRO,0,0,0,0
2020-04-08,SH,"Saint Helena, Ascension and Tristan da Cunha",AFRO,0,0,0,0
2020-04-09,SH,"Saint Helena, Ascension and Tristan da Cunha",AFRO,0,0,0,0
2020-04-10,SH,"Saint Helena, Ascension and Tristan da Cunha",AFRO,0,0,0,0
2020-04-11,SH,"Saint Helena, Ascension and Tristan da Cunha",AFRO,0,0,0,0
2020-04-12,SH,"Saint Helena, Ascension and Tristan da Cunha",AFRO,0,0,0,0
2020-04-13,SH,"Saint Helena, Ascension and Tristan da Cunha",AFRO,0,0,0,0
2020-04-14,SH,"Saint Helena, Ascension and Tristan da Cunha",AFRO,0,0,0,0
2020-04-15,SH,"Saint Helena, Ascension and Tristan da Cunha",AFRO,0,0,0,0
2020-04-16,SH,"Saint Helena, Ascension and Tristan da Cunha",AFRO,0,0,0,0
2020-04-17,SH,"Saint Helena, Ascension and Tristan da Cunha",AFRO,0,0,0,0
2020-04-18,SH,"Saint Helena, Ascension and Tristan da Cunha",AFRO,0,0,0,0
2020-04-19,SH,"Saint Helena, Ascension and Tristan da Cunha",AFRO,0,0,0,0
2020-04-20,SH,"Saint Helena, Ascension and Tristan da Cunha",AFRO,0,0,0,0
2020-04-21,SH,"Saint Helena, Ascension and Tristan da Cunha",AFRO,0,0,0,0
2020-04-22,SH,"Saint Helena, Ascension and Tristan da Cunha",AFRO,0,0,0,0
2020-04-23,SH,"Saint Helena, Ascension and Tristan da Cunha",AFRO,0,0,0,0
2020-04-24,SH,"Saint Helena, Ascension and Tristan da Cunha",AFRO,0,0,0,0
2020-04-25,SH,"Saint Helena, Ascension and Tristan da Cunha",AFRO,0,0,0,0
2020-04-26,SH,"Saint Helena, Ascension and Tristan da Cunha",AFRO,0,0,0,0
2020-04-27,SH,"Saint Helena, Ascension and Tristan da Cunha",AFRO,0,0,0,0
2020-04-28,SH,"Saint Helena, Ascension and Tristan da Cunha",AFRO,0,0,0,0
2020-04-29,SH,"Saint Helena, Ascension and Tristan da Cunha",AFRO,0,0,0,0
2020-04-30,SH,"Saint Helena, Ascension and Tristan da Cunha",AFRO,0,0,0,0
2020-05-01,SH,"Saint Helena, Ascension and Tristan da Cunha",AFRO,0,0,0,0
2020-05-02,SH,"Saint Helena, Ascension and Tristan da Cunha",AFRO,0,0,0,0
2020-05-03,SH,"Saint Helena, Ascension and Tristan da Cunha",AFRO,0,0,0,0
2020-05-04,SH,"Saint Helena, Ascension and Tristan da Cunha",AFRO,0,0,0,0
2020-05-05,SH,"Saint Helena, Ascension and Tristan da Cunha",AFRO,0,0,0,0
2020-05-06,SH,"Saint Helena, Ascension and Tristan da Cunha",AFRO,0,0,0,0
2020-05-07,SH,"Saint Helena, Ascension and Tristan da Cunha",AFRO,0,0,0,0
2020-05-08,SH,"Saint Helena, Ascension and Tristan da Cunha",AFRO,0,0,0,0
2020-05-09,SH,"Saint Helena, Ascension and Tristan da Cunha",AFRO,0,0,0,0
2020-05-10,SH,"Saint Helena, Ascension and Tristan da Cunha",AFRO,0,0,0,0
2020-05-11,SH,"Saint Helena, Ascension and Tristan da Cunha",AFRO,0,0,0,0
2020-05-12,SH,"Saint Helena, Ascension and Tristan da Cunha",AFRO,0,0,0,0
2020-05-13,SH,"Saint Helena, Ascension and Tristan da Cunha",AFRO,0,0,0,0
2020-05-14,SH,"Saint Helena, Ascension and Tristan da Cunha",AFRO,0,0,0,0
2020-05-15,SH,"Saint Helena, Ascension and Tristan da Cunha",AFRO,0,0,0,0
2020-05-16,SH,"Saint Helena, Ascension and Tristan da Cunha",AFRO,0,0,0,0
2020-05-17,SH,"Saint Helena, Ascension and Tristan da Cunha",AFRO,0,0,0,0
2020-05-18,SH,"Saint Helena, Ascension and Tristan da Cunha",AFRO,0,0,0,0
2020-05-19,SH,"Saint Helena, Ascension and Tristan da Cunha",AFRO,0,0,0,0
2020-05-20,SH,"Saint Helena, Ascension and Tristan da Cunha",AFRO,0,0,0,0
2020-05-21,SH,"Saint Helena, Ascension and Tristan da Cunha",AFRO,0,0,0,0
2020-05-22,SH,"Saint Helena, Ascension and Tristan da Cunha",AFRO,0,0,0,0
2020-05-23,SH,"Saint Helena, Ascension and Tristan da Cunha",AFRO,0,0,0,0
2020-05-24,SH,"Saint Helena, Ascension and Tristan da Cunha",AFRO,0,0,0,0
2020-05-25,SH,"Saint Helena, Ascension and Tristan da Cunha",AFRO,0,0,0,0
2020-05-26,SH,"Saint Helena, Ascension and Tristan da Cunha",AFRO,0,0,0,0
2020-05-27,SH,"Saint Helena, Ascension and Tristan da Cunha",AFRO,0,0,0,0
2020-05-28,SH,"Saint Helena, Ascension and Tristan da Cunha",AFRO,0,0,0,0
2020-05-29,SH,"Saint Helena, Ascension and Tristan da Cunha",AFRO,0,0,0,0
2020-05-30,SH,"Saint Helena, Ascension and Tristan da Cunha",AFRO,0,0,0,0
2020-05-31,SH,"Saint Helena, Ascension and Tristan da Cunha",AFRO,0,0,0,0
2020-06-01,SH,"Saint Helena, Ascension and Tristan da Cunha",AFRO,0,0,0,0
2020-06-02,SH,"Saint Helena, Ascension and Tristan da Cunha",AFRO,0,0,0,0
2020-06-03,SH,"Saint Helena, Ascension and Tristan da Cunha",AFRO,0,0,0,0
2020-06-04,SH,"Saint Helena, Ascension and Tristan da Cunha",AFRO,0,0,0,0
2020-06-05,SH,"Saint Helena, Ascension and Tristan da Cunha",AFRO,0,0,0,0
2020-06-06,SH,"Saint Helena, Ascension and Tristan da Cunha",AFRO,0,0,0,0
2020-06-07,SH,"Saint Helena, Ascension and Tristan da Cunha",AFRO,0,0,0,0
2020-06-08,SH,"Saint Helena, Ascension and Tristan da Cunha",AFRO,0,0,0,0
2020-03-29,KN,Saint Kitts and Nevis,AMRO,0,2,0,0
2020-03-30,KN,Saint Kitts and Nevis,AMRO,0,2,0,0
2020-03-31,KN,Saint Kitts and Nevis,AMRO,0,2,0,0
2020-04-01,KN,Saint Kitts and Nevis,AMRO,6,8,0,0
2020-04-02,KN,Saint Kitts and Nevis,AMRO,0,8,0,0
2020-04-03,KN,Saint Kitts and Nevis,AMRO,0,8,0,0
2020-04-04,KN,Saint Kitts and Nevis,AMRO,0,8,0,0
2020-04-05,KN,Saint Kitts and Nevis,AMRO,1,9,0,0
2020-04-06,KN,Saint Kitts and Nevis,AMRO,0,9,0,0
2020-04-07,KN,Saint Kitts and Nevis,AMRO,1,10,0,0
2020-04-08,KN,Saint Kitts and Nevis,AMRO,0,10,0,0
2020-04-09,KN,Saint Kitts and Nevis,AMRO,1,11,0,0
2020-04-10,KN,Saint Kitts and Nevis,AMRO,0,11,0,0
2020-04-11,KN,Saint Kitts and Nevis,AMRO,0,11,0,0
2020-04-12,KN,Saint Kitts and Nevis,AMRO,1,12,0,0
2020-04-13,KN,Saint Kitts and Nevis,AMRO,0,12,0,0
2020-04-14,KN,Saint Kitts and Nevis,AMRO,0,12,0,0
2020-04-15,KN,Saint Kitts and Nevis,AMRO,0,12,0,0
2020-04-16,KN,Saint Kitts and Nevis,AMRO,2,14,0,0
2020-04-17,KN,Saint Kitts and Nevis,AMRO,0,14,0,0
2020-04-18,KN,Saint Kitts and Nevis,AMRO,0,14,0,0
2020-04-19,KN,Saint Kitts and Nevis,AMRO,0,14,0,0
2020-04-20,KN,Saint Kitts and Nevis,AMRO,0,14,0,0
2020-04-21,KN,Saint Kitts and Nevis,AMRO,1,15,0,0
2020-04-22,KN,Saint Kitts and Nevis,AMRO,0,15,0,0
2020-04-23,KN,Saint Kitts and Nevis,AMRO,0,15,0,0
2020-04-24,KN,Saint Kitts and Nevis,AMRO,0,15,0,0
2020-04-25,KN,Saint Kitts and Nevis,AMRO,0,15,0,0
2020-04-26,KN,Saint Kitts and Nevis,AMRO,0,15,0,0
2020-04-27,KN,Saint Kitts and Nevis,AMRO,0,15,0,0
2020-04-28,KN,Saint Kitts and Nevis,AMRO,0,15,0,0
2020-04-29,KN,Saint Kitts and Nevis,AMRO,0,15,0,0
2020-04-30,KN,Saint Kitts and Nevis,AMRO,0,15,0,0
2020-05-01,KN,Saint Kitts and Nevis,AMRO,0,15,0,0
2020-05-02,KN,Saint Kitts and Nevis,AMRO,0,15,0,0
2020-05-03,KN,Saint Kitts and Nevis,AMRO,0,15,0,0
2020-05-04,KN,Saint Kitts and Nevis,AMRO,0,15,0,0
2020-05-05,KN,Saint Kitts and Nevis,AMRO,0,15,0,0
2020-05-06,KN,Saint Kitts and Nevis,AMRO,0,15,0,0
2020-05-07,KN,Saint Kitts and Nevis,AMRO,0,15,0,0
2020-05-08,KN,Saint Kitts and Nevis,AMRO,0,15,0,0
2020-05-09,KN,Saint Kitts and Nevis,AMRO,0,15,0,0
2020-05-10,KN,Saint Kitts and Nevis,AMRO,0,15,0,0
2020-05-11,KN,Saint Kitts and Nevis,AMRO,0,15,0,0
2020-05-12,KN,Saint Kitts and Nevis,AMRO,0,15,0,0
2020-05-13,KN,Saint Kitts and Nevis,AMRO,0,15,0,0
2020-05-14,KN,Saint Kitts and Nevis,AMRO,0,15,0,0
2020-05-15,KN,Saint Kitts and Nevis,AMRO,0,15,0,0
2020-05-16,KN,Saint Kitts and Nevis,AMRO,0,15,0,0
2020-05-17,KN,Saint Kitts and Nevis,AMRO,0,15,0,0
2020-05-18,KN,Saint Kitts and Nevis,AMRO,0,15,0,0
2020-05-19,KN,Saint Kitts and Nevis,AMRO,0,15,0,0
2020-05-20,KN,Saint Kitts and Nevis,AMRO,0,15,0,0
2020-05-21,KN,Saint Kitts and Nevis,AMRO,0,15,0,0
2020-05-22,KN,Saint Kitts and Nevis,AMRO,0,15,0,0
2020-05-23,KN,Saint Kitts and Nevis,AMRO,0,15,0,0
2020-05-24,KN,Saint Kitts and Nevis,AMRO,0,15,0,0
2020-05-25,KN,Saint Kitts and Nevis,AMRO,0,15,0,0
2020-05-26,KN,Saint Kitts and Nevis,AMRO,0,15,0,0
2020-05-27,KN,Saint Kitts and Nevis,AMRO,0,15,0,0
2020-05-28,KN,Saint Kitts and Nevis,AMRO,0,15,0,0
2020-05-29,KN,Saint Kitts and Nevis,AMRO,0,15,0,0
2020-05-30,KN,Saint Kitts and Nevis,AMRO,0,15,0,0
2020-05-31,KN,Saint Kitts and Nevis,AMRO,0,15,0,0
2020-06-01,KN,Saint Kitts and Nevis,AMRO,0,15,0,0
2020-06-02,KN,Saint Kitts and Nevis,AMRO,0,15,0,0
2020-06-03,KN,Saint Kitts and Nevis,AMRO,0,15,0,0
2020-06-04,KN,Saint Kitts and Nevis,AMRO,0,15,0,0
2020-06-05,KN,Saint Kitts and Nevis,AMRO,0,15,0,0
2020-06-06,KN,Saint Kitts and Nevis,AMRO,0,15,0,0
2020-06-07,KN,Saint Kitts and Nevis,AMRO,0,15,0,0
2020-06-08,KN,Saint Kitts and Nevis,AMRO,0,15,0,0
2020-03-29,LC,Saint Lucia,AMRO,0,3,0,0
2020-03-30,LC,Saint Lucia,AMRO,1,4,0,0
2020-03-31,LC,Saint Lucia,AMRO,5,9,0,0
2020-04-01,LC,Saint Lucia,AMRO,0,9,0,0
2020-04-02,LC,Saint Lucia,AMRO,4,13,0,0
2020-04-03,LC,Saint Lucia,AMRO,0,13,0,0
2020-04-04,LC,Saint Lucia,AMRO,0,13,0,0
2020-04-05,LC,Saint Lucia,AMRO,0,13,0,0
2020-04-06,LC,Saint Lucia,AMRO,1,14,0,0
2020-04-07,LC,Saint Lucia,AMRO,0,14,0,0
2020-04-08,LC,Saint Lucia,AMRO,0,14,0,0
2020-04-09,LC,Saint Lucia,AMRO,0,14,0,0
2020-04-10,LC,Saint Lucia,AMRO,0,14,0,0
2020-04-11,LC,Saint Lucia,AMRO,0,14,0,0
2020-04-12,LC,Saint Lucia,AMRO,1,15,0,0
2020-04-13,LC,Saint Lucia,AMRO,0,15,0,0
2020-04-14,LC,Saint Lucia,AMRO,0,15,0,0
2020-04-15,LC,Saint Lucia,AMRO,0,15,0,0
2020-04-16,LC,Saint Lucia,AMRO,0,15,0,0
2020-04-17,LC,Saint Lucia,AMRO,0,15,0,0
2020-04-18,LC,Saint Lucia,AMRO,0,15,0,0
2020-04-19,LC,Saint Lucia,AMRO,0,15,0,0
2020-04-20,LC,Saint Lucia,AMRO,0,15,0,0
2020-04-21,LC,Saint Lucia,AMRO,0,15,0,0
2020-04-22,LC,Saint Lucia,AMRO,0,15,0,0
2020-04-23,LC,Saint Lucia,AMRO,0,15,0,0
2020-04-24,LC,Saint Lucia,AMRO,0,15,0,0
2020-04-25,LC,Saint Lucia,AMRO,0,15,0,0
2020-04-26,LC,Saint Lucia,AMRO,0,15,0,0
2020-04-27,LC,Saint Lucia,AMRO,0,15,0,0
2020-04-28,LC,Saint Lucia,AMRO,0,15,0,0
2020-04-29,LC,Saint Lucia,AMRO,0,15,0,0
2020-04-30,LC,Saint Lucia,AMRO,2,17,0,0
2020-05-01,LC,Saint Lucia,AMRO,0,17,0,0
2020-05-02,LC,Saint Lucia,AMRO,0,17,0,0
2020-05-03,LC,Saint Lucia,AMRO,0,17,0,0
2020-05-04,LC,Saint Lucia,AMRO,0,17,0,0
2020-05-05,LC,Saint Lucia,AMRO,1,18,0,0
2020-05-06,LC,Saint Lucia,AMRO,0,18,0,0
2020-05-07,LC,Saint Lucia,AMRO,0,18,0,0
2020-05-08,LC,Saint Lucia,AMRO,0,18,0,0
2020-05-09,LC,Saint Lucia,AMRO,0,18,0,0
2020-05-10,LC,Saint Lucia,AMRO,0,18,0,0
2020-05-11,LC,Saint Lucia,AMRO,0,18,0,0
2020-05-12,LC,Saint Lucia,AMRO,0,18,0,0
2020-05-13,LC,Saint Lucia,AMRO,0,18,0,0
2020-05-14,LC,Saint Lucia,AMRO,0,18,0,0
2020-05-15,LC,Saint Lucia,AMRO,0,18,0,0
2020-05-16,LC,Saint Lucia,AMRO,0,18,0,0
2020-05-17,LC,Saint Lucia,AMRO,0,18,0,0
2020-05-18,LC,Saint Lucia,AMRO,0,18,0,0
2020-05-19,LC,Saint Lucia,AMRO,0,18,0,0
2020-05-20,LC,Saint Lucia,AMRO,0,18,0,0
2020-05-21,LC,Saint Lucia,AMRO,0,18,0,0
2020-05-22,LC,Saint Lucia,AMRO,0,18,0,0
2020-05-23,LC,Saint Lucia,AMRO,0,18,0,0
2020-05-24,LC,Saint Lucia,AMRO,0,18,0,0
2020-05-25,LC,Saint Lucia,AMRO,0,18,0,0
2020-05-26,LC,Saint Lucia,AMRO,0,18,0,0
2020-05-27,LC,Saint Lucia,AMRO,0,18,0,0
2020-05-28,LC,Saint Lucia,AMRO,0,18,0,0
2020-05-29,LC,Saint Lucia,AMRO,0,18,0,0
2020-05-30,LC,Saint Lucia,AMRO,0,18,0,0
2020-05-31,LC,Saint Lucia,AMRO,0,18,0,0
2020-06-01,LC,Saint Lucia,AMRO,0,18,0,0
2020-06-02,LC,Saint Lucia,AMRO,0,18,0,0
2020-06-03,LC,Saint Lucia,AMRO,0,18,0,0
2020-06-04,LC,Saint Lucia,AMRO,0,18,0,0
2020-06-05,LC,Saint Lucia,AMRO,0,18,0,0
2020-06-06,LC,Saint Lucia,AMRO,1,19,0,0
2020-06-07,LC,Saint Lucia,AMRO,0,19,0,0
2020-06-08,LC,Saint Lucia,AMRO,0,19,0,0
2020-03-29,MF,Saint Martin,AMRO,0,12,0,0
2020-03-30,MF,Saint Martin,AMRO,0,12,0,0
2020-03-31,MF,Saint Martin,AMRO,6,18,1,1
2020-04-01,MF,Saint Martin,AMRO,0,18,1,2
2020-04-02,MF,Saint Martin,AMRO,3,21,0,2
2020-04-03,MF,Saint Martin,AMRO,1,22,0,2
2020-04-04,MF,Saint Martin,AMRO,0,22,0,2
2020-04-05,MF,Saint Martin,AMRO,2,24,0,2
2020-04-06,MF,Saint Martin,AMRO,5,29,0,2
2020-04-07,MF,Saint Martin,AMRO,2,31,0,2
2020-04-08,MF,Saint Martin,AMRO,0,31,0,2
2020-04-09,MF,Saint Martin,AMRO,0,31,0,2
2020-04-10,MF,Saint Martin,AMRO,1,32,0,2
2020-04-11,MF,Saint Martin,AMRO,0,32,0,2
2020-04-12,MF,Saint Martin,AMRO,1,33,0,2
2020-04-13,MF,Saint Martin,AMRO,0,33,0,2
2020-04-14,MF,Saint Martin,AMRO,0,33,0,2
2020-04-15,MF,Saint Martin,AMRO,2,35,0,2
2020-04-16,MF,Saint Martin,AMRO,0,35,0,2
2020-04-17,MF,Saint Martin,AMRO,0,35,0,2
2020-04-18,MF,Saint Martin,AMRO,0,35,0,2
2020-04-19,MF,Saint Martin,AMRO,2,37,0,2
2020-04-20,MF,Saint Martin,AMRO,0,37,0,2
2020-04-21,MF,Saint Martin,AMRO,0,37,0,2
2020-04-22,MF,Saint Martin,AMRO,0,37,0,2
2020-04-23,MF,Saint Martin,AMRO,1,38,0,2
2020-04-24,MF,Saint Martin,AMRO,0,38,0,2
2020-04-25,MF,Saint Martin,AMRO,0,38,0,2
2020-04-26,MF,Saint Martin,AMRO,0,38,1,3
2020-04-27,MF,Saint Martin,AMRO,0,38,0,3
2020-04-28,MF,Saint Martin,AMRO,0,38,0,3
2020-04-29,MF,Saint Martin,AMRO,0,38,0,3
2020-04-30,MF,Saint Martin,AMRO,0,38,0,3
2020-05-01,MF,Saint Martin,AMRO,0,38,0,3
2020-05-02,MF,Saint Martin,AMRO,0,38,0,3
2020-05-03,MF,Saint Martin,AMRO,0,38,0,3
2020-05-04,MF,Saint Martin,AMRO,0,38,0,3
2020-05-05,MF,Saint Martin,AMRO,0,38,0,3
2020-05-06,MF,Saint Martin,AMRO,0,38,0,3
2020-05-07,MF,Saint Martin,AMRO,0,38,0,3
2020-05-08,MF,Saint Martin,AMRO,0,38,0,3
2020-05-09,MF,Saint Martin,AMRO,0,38,0,3
2020-05-10,MF,Saint Martin,AMRO,0,38,0,3
2020-05-11,MF,Saint Martin,AMRO,1,39,0,3
2020-05-12,MF,Saint Martin,AMRO,0,39,0,3
2020-05-13,MF,Saint Martin,AMRO,0,39,0,3
2020-05-14,MF,Saint Martin,AMRO,0,39,0,3
2020-05-15,MF,Saint Martin,AMRO,0,39,0,3
2020-05-16,MF,Saint Martin,AMRO,0,39,0,3
2020-05-17,MF,Saint Martin,AMRO,0,39,0,3
2020-05-18,MF,Saint Martin,AMRO,0,39,0,3
2020-05-19,MF,Saint Martin,AMRO,0,39,0,3
2020-05-20,MF,Saint Martin,AMRO,0,39,0,3
2020-05-21,MF,Saint Martin,AMRO,0,39,0,3
2020-05-22,MF,Saint Martin,AMRO,0,39,0,3
2020-05-23,MF,Saint Martin,AMRO,0,39,0,3
2020-05-24,MF,Saint Martin,AMRO,0,39,0,3
2020-05-25,MF,Saint Martin,AMRO,0,39,0,3
2020-05-26,MF,Saint Martin,AMRO,0,39,0,3
2020-05-27,MF,Saint Martin,AMRO,1,40,0,3
2020-05-28,MF,Saint Martin,AMRO,0,40,0,3
2020-05-29,MF,Saint Martin,AMRO,0,40,0,3
2020-05-30,MF,Saint Martin,AMRO,0,40,0,3
2020-05-31,MF,Saint Martin,AMRO,1,41,0,3
2020-06-01,MF,Saint Martin,AMRO,0,41,0,3
2020-06-02,MF,Saint Martin,AMRO,0,41,0,3
2020-06-03,MF,Saint Martin,AMRO,0,41,0,3
2020-06-04,MF,Saint Martin,AMRO,0,41,0,3
2020-06-05,MF,Saint Martin,AMRO,0,41,0,3
2020-06-06,MF,Saint Martin,AMRO,0,41,0,3
2020-06-07,MF,Saint Martin,AMRO,0,41,0,3
2020-06-08,MF,Saint Martin,AMRO,0,41,0,3
2020-03-29,PM,Saint Pierre and Miquelon,AMRO,0,0,0,0
2020-03-30,PM,Saint Pierre and Miquelon,AMRO,0,0,0,0
2020-03-31,PM,Saint Pierre and Miquelon,AMRO,0,0,0,0
2020-04-01,PM,Saint Pierre and Miquelon,AMRO,0,0,0,0
2020-04-02,PM,Saint Pierre and Miquelon,AMRO,0,0,0,0
2020-04-03,PM,Saint Pierre and Miquelon,AMRO,0,0,0,0
2020-04-04,PM,Saint Pierre and Miquelon,AMRO,0,0,0,0
2020-04-05,PM,Saint Pierre and Miquelon,AMRO,0,0,0,0
2020-04-06,PM,Saint Pierre and Miquelon,AMRO,0,0,0,0
2020-04-07,PM,Saint Pierre and Miquelon,AMRO,0,0,0,0
2020-04-08,PM,Saint Pierre and Miquelon,AMRO,1,1,0,0
2020-04-09,PM,Saint Pierre and Miquelon,AMRO,0,1,0,0
2020-04-10,PM,Saint Pierre and Miquelon,AMRO,0,1,0,0
2020-04-11,PM,Saint Pierre and Miquelon,AMRO,0,1,0,0
2020-04-12,PM,Saint Pierre and Miquelon,AMRO,0,1,0,0
2020-04-13,PM,Saint Pierre and Miquelon,AMRO,0,1,0,0
2020-04-14,PM,Saint Pierre and Miquelon,AMRO,0,1,0,0
2020-04-15,PM,Saint Pierre and Miquelon,AMRO,0,1,0,0
2020-04-16,PM,Saint Pierre and Miquelon,AMRO,0,1,0,0
2020-04-17,PM,Saint Pierre and Miquelon,AMRO,0,1,0,0
2020-04-18,PM,Saint Pierre and Miquelon,AMRO,0,1,0,0
2020-04-19,PM,Saint Pierre and Miquelon,AMRO,0,1,0,0
2020-04-20,PM,Saint Pierre and Miquelon,AMRO,0,1,0,0
2020-04-21,PM,Saint Pierre and Miquelon,AMRO,0,1,0,0
2020-04-22,PM,Saint Pierre and Miquelon,AMRO,0,1,0,0
2020-04-23,PM,Saint Pierre and Miquelon,AMRO,0,1,0,0
2020-04-24,PM,Saint Pierre and Miquelon,AMRO,0,1,0,0
2020-04-25,PM,Saint Pierre and Miquelon,AMRO,0,1,0,0
2020-04-26,PM,Saint Pierre and Miquelon,AMRO,0,1,0,0
2020-04-27,PM,Saint Pierre and Miquelon,AMRO,0,1,0,0
2020-04-28,PM,Saint Pierre and Miquelon,AMRO,0,1,0,0
2020-04-29,PM,Saint Pierre and Miquelon,AMRO,0,1,0,0
2020-04-30,PM,Saint Pierre and Miquelon,AMRO,0,1,0,0
2020-05-01,PM,Saint Pierre and Miquelon,AMRO,0,1,0,0
2020-05-02,PM,Saint Pierre and Miquelon,AMRO,0,1,0,0
2020-05-03,PM,Saint Pierre and Miquelon,AMRO,0,1,0,0
2020-05-04,PM,Saint Pierre and Miquelon,AMRO,0,1,0,0
2020-05-05,PM,Saint Pierre and Miquelon,AMRO,0,1,0,0
2020-05-06,PM,Saint Pierre and Miquelon,AMRO,0,1,0,0
2020-05-07,PM,Saint Pierre and Miquelon,AMRO,0,1,0,0
2020-05-08,PM,Saint Pierre and Miquelon,AMRO,0,1,0,0
2020-05-09,PM,Saint Pierre and Miquelon,AMRO,0,1,0,0
2020-05-10,PM,Saint Pierre and Miquelon,AMRO,0,1,0,0
2020-05-11,PM,Saint Pierre and Miquelon,AMRO,0,1,0,0
2020-05-12,PM,Saint Pierre and Miquelon,AMRO,0,1,0,0
2020-05-13,PM,Saint Pierre and Miquelon,AMRO,0,1,0,0
2020-05-14,PM,Saint Pierre and Miquelon,AMRO,0,1,0,0
2020-05-15,PM,Saint Pierre and Miquelon,AMRO,0,1,0,0
2020-05-16,PM,Saint Pierre and Miquelon,AMRO,0,1,0,0
2020-05-17,PM,Saint Pierre and Miquelon,AMRO,0,1,0,0
2020-05-18,PM,Saint Pierre and Miquelon,AMRO,0,1,0,0
2020-05-19,PM,Saint Pierre and Miquelon,AMRO,0,1,0,0
2020-05-20,PM,Saint Pierre and Miquelon,AMRO,0,1,0,0
2020-05-21,PM,Saint Pierre and Miquelon,AMRO,0,1,0,0
2020-05-22,PM,Saint Pierre and Miquelon,AMRO,0,1,0,0
2020-05-23,PM,Saint Pierre and Miquelon,AMRO,0,1,0,0
2020-05-24,PM,Saint Pierre and Miquelon,AMRO,0,1,0,0
2020-05-25,PM,Saint Pierre and Miquelon,AMRO,0,1,0,0
2020-05-26,PM,Saint Pierre and Miquelon,AMRO,0,1,0,0
2020-05-27,PM,Saint Pierre and Miquelon,AMRO,0,1,0,0
2020-05-28,PM,Saint Pierre and Miquelon,AMRO,0,1,0,0
2020-05-29,PM,Saint Pierre and Miquelon,AMRO,0,1,0,0
2020-05-30,PM,Saint Pierre and Miquelon,AMRO,0,1,0,0
2020-05-31,PM,Saint Pierre and Miquelon,AMRO,0,1,0,0
2020-06-01,PM,Saint Pierre and Miquelon,AMRO,0,1,0,0
2020-06-02,PM,Saint Pierre and Miquelon,AMRO,0,1,0,0
2020-06-03,PM,Saint Pierre and Miquelon,AMRO,0,1,0,0
2020-06-04,PM,Saint Pierre and Miquelon,AMRO,0,1,0,0
2020-06-05,PM,Saint Pierre and Miquelon,AMRO,0,1,0,0
2020-06-06,PM,Saint Pierre and Miquelon,AMRO,0,1,0,0
2020-06-07,PM,Saint Pierre and Miquelon,AMRO,0,1,0,0
2020-06-08,PM,Saint Pierre and Miquelon,AMRO,0,1,0,0
2020-03-29,VC,Saint Vincent and the Grenadines,AMRO,0,1,0,0
2020-03-30,VC,Saint Vincent and the Grenadines,AMRO,0,1,0,0
2020-03-31,VC,Saint Vincent and the Grenadines,AMRO,0,1,0,0
2020-04-01,VC,Saint Vincent and the Grenadines,AMRO,0,1,0,0
2020-04-02,VC,Saint Vincent and the Grenadines,AMRO,0,1,0,0
2020-04-03,VC,Saint Vincent and the Grenadines,AMRO,1,2,0,0
2020-04-04,VC,Saint Vincent and the Grenadines,AMRO,1,3,0,0
2020-04-05,VC,Saint Vincent and the Grenadines,AMRO,0,3,0,0
2020-04-06,VC,Saint Vincent and the Grenadines,AMRO,0,3,0,0
2020-04-07,VC,Saint Vincent and the Grenadines,AMRO,4,7,0,0
2020-04-08,VC,Saint Vincent and the Grenadines,AMRO,0,7,0,0
2020-04-09,VC,Saint Vincent and the Grenadines,AMRO,1,8,0,0
2020-04-10,VC,Saint Vincent and the Grenadines,AMRO,0,8,0,0
2020-04-11,VC,Saint Vincent and the Grenadines,AMRO,4,12,0,0
2020-04-12,VC,Saint Vincent and the Grenadines,AMRO,0,12,0,0
2020-04-13,VC,Saint Vincent and the Grenadines,AMRO,0,12,0,0
2020-04-14,VC,Saint Vincent and the Grenadines,AMRO,0,12,0,0
2020-04-15,VC,Saint Vincent and the Grenadines,AMRO,0,12,0,0
2020-04-16,VC,Saint Vincent and the Grenadines,AMRO,0,12,0,0
2020-04-17,VC,Saint Vincent and the Grenadines,AMRO,0,12,0,0
2020-04-18,VC,Saint Vincent and the Grenadines,AMRO,0,12,0,0
2020-04-19,VC,Saint Vincent and the Grenadines,AMRO,0,12,0,0
2020-04-20,VC,Saint Vincent and the Grenadines,AMRO,0,12,0,0
2020-04-21,VC,Saint Vincent and the Grenadines,AMRO,0,12,0,0
2020-04-22,VC,Saint Vincent and the Grenadines,AMRO,0,12,0,0
2020-04-23,VC,Saint Vincent and the Grenadines,AMRO,1,13,0,0
2020-04-24,VC,Saint Vincent and the Grenadines,AMRO,0,13,0,0
2020-04-25,VC,Saint Vincent and the Grenadines,AMRO,1,14,0,0
2020-04-26,VC,Saint Vincent and the Grenadines,AMRO,0,14,0,0
2020-04-27,VC,Saint Vincent and the Grenadines,AMRO,0,14,0,0
2020-04-28,VC,Saint Vincent and the Grenadines,AMRO,1,15,0,0
2020-04-29,VC,Saint Vincent and the Grenadines,AMRO,0,15,0,0
2020-04-30,VC,Saint Vincent and the Grenadines,AMRO,1,16,0,0
2020-05-01,VC,Saint Vincent and the Grenadines,AMRO,0,16,0,0
2020-05-02,VC,Saint Vincent and the Grenadines,AMRO,0,16,0,0
2020-05-03,VC,Saint Vincent and the Grenadines,AMRO,0,16,0,0
2020-05-04,VC,Saint Vincent and the Grenadines,AMRO,0,16,0,0
2020-05-05,VC,Saint Vincent and the Grenadines,AMRO,1,17,0,0
2020-05-06,VC,Saint Vincent and the Grenadines,AMRO,0,17,0,0
2020-05-07,VC,Saint Vincent and the Grenadines,AMRO,0,17,0,0
2020-05-08,VC,Saint Vincent and the Grenadines,AMRO,0,17,0,0
2020-05-09,VC,Saint Vincent and the Grenadines,AMRO,0,17,0,0
2020-05-10,VC,Saint Vincent and the Grenadines,AMRO,0,17,0,0
2020-05-11,VC,Saint Vincent and the Grenadines,AMRO,0,17,0,0
2020-05-12,VC,Saint Vincent and the Grenadines,AMRO,0,17,0,0
2020-05-13,VC,Saint Vincent and the Grenadines,AMRO,0,17,0,0
2020-05-14,VC,Saint Vincent and the Grenadines,AMRO,0,17,0,0
2020-05-15,VC,Saint Vincent and the Grenadines,AMRO,0,17,0,0
2020-05-16,VC,Saint Vincent and the Grenadines,AMRO,0,17,0,0
2020-05-17,VC,Saint Vincent and the Grenadines,AMRO,0,17,0,0
2020-05-18,VC,Saint Vincent and the Grenadines,AMRO,0,17,0,0
2020-05-19,VC,Saint Vincent and the Grenadines,AMRO,0,17,0,0
2020-05-20,VC,Saint Vincent and the Grenadines,AMRO,0,17,0,0
2020-05-21,VC,Saint Vincent and the Grenadines,AMRO,1,18,0,0
2020-05-22,VC,Saint Vincent and the Grenadines,AMRO,0,18,0,0
2020-05-23,VC,Saint Vincent and the Grenadines,AMRO,0,18,0,0
2020-05-24,VC,Saint Vincent and the Grenadines,AMRO,0,18,0,0
2020-05-25,VC,Saint Vincent and the Grenadines,AMRO,0,18,0,0
2020-05-26,VC,Saint Vincent and the Grenadines,AMRO,0,18,0,0
2020-05-27,VC,Saint Vincent and the Grenadines,AMRO,0,18,0,0
2020-05-28,VC,Saint Vincent and the Grenadines,AMRO,0,18,0,0
2020-05-29,VC,Saint Vincent and the Grenadines,AMRO,7,25,0,0
2020-05-30,VC,Saint Vincent and the Grenadines,AMRO,0,25,0,0
2020-05-31,VC,Saint Vincent and the Grenadines,AMRO,0,25,0,0
2020-06-01,VC,Saint Vincent and the Grenadines,AMRO,1,26,0,0
2020-06-02,VC,Saint Vincent and the Grenadines,AMRO,0,26,0,0
2020-06-03,VC,Saint Vincent and the Grenadines,AMRO,0,26,0,0
2020-06-04,VC,Saint Vincent and the Grenadines,AMRO,0,26,0,0
2020-06-05,VC,Saint Vincent and the Grenadines,AMRO,0,26,0,0
2020-06-06,VC,Saint Vincent and the Grenadines,AMRO,0,26,0,0
2020-06-07,VC,Saint Vincent and the Grenadines,AMRO,0,26,0,0
2020-06-08,VC,Saint Vincent and the Grenadines,AMRO,0,26,0,0
2020-03-29,WS,Samoa,WPRO,0,0,0,0
2020-03-30,WS,Samoa,WPRO,0,0,0,0
2020-03-31,WS,Samoa,WPRO,0,0,0,0
2020-04-01,WS,Samoa,WPRO,0,0,0,0
2020-04-02,WS,Samoa,WPRO,0,0,0,0
2020-04-03,WS,Samoa,WPRO,0,0,0,0
2020-04-04,WS,Samoa,WPRO,0,0,0,0
2020-04-05,WS,Samoa,WPRO,0,0,0,0
2020-04-06,WS,Samoa,WPRO,0,0,0,0
2020-04-07,WS,Samoa,WPRO,0,0,0,0
2020-04-08,WS,Samoa,WPRO,0,0,0,0
2020-04-09,WS,Samoa,WPRO,0,0,0,0
2020-04-10,WS,Samoa,WPRO,0,0,0,0
2020-04-11,WS,Samoa,WPRO,0,0,0,0
2020-04-12,WS,Samoa,WPRO,0,0,0,0
2020-04-13,WS,Samoa,WPRO,0,0,0,0
2020-04-14,WS,Samoa,WPRO,0,0,0,0
2020-04-15,WS,Samoa,WPRO,0,0,0,0
2020-04-16,WS,Samoa,WPRO,0,0,0,0
2020-04-17,WS,Samoa,WPRO,0,0,0,0
2020-04-18,WS,Samoa,WPRO,0,0,0,0
2020-04-19,WS,Samoa,WPRO,0,0,0,0
2020-04-20,WS,Samoa,WPRO,0,0,0,0
2020-04-21,WS,Samoa,WPRO,0,0,0,0
2020-04-22,WS,Samoa,WPRO,0,0,0,0
2020-04-23,WS,Samoa,WPRO,0,0,0,0
2020-04-24,WS,Samoa,WPRO,0,0,0,0
2020-04-25,WS,Samoa,WPRO,0,0,0,0
2020-04-26,WS,Samoa,WPRO,0,0,0,0
2020-04-27,WS,Samoa,WPRO,0,0,0,0
2020-04-28,WS,Samoa,WPRO,0,0,0,0
2020-04-29,WS,Samoa,WPRO,0,0,0,0
2020-04-30,WS,Samoa,WPRO,0,0,0,0
2020-05-01,WS,Samoa,WPRO,0,0,0,0
2020-05-02,WS,Samoa,WPRO,0,0,0,0
2020-05-03,WS,Samoa,WPRO,0,0,0,0
2020-05-04,WS,Samoa,WPRO,0,0,0,0
2020-05-05,WS,Samoa,WPRO,0,0,0,0
2020-05-06,WS,Samoa,WPRO,0,0,0,0
2020-05-07,WS,Samoa,WPRO,0,0,0,0
2020-05-08,WS,Samoa,WPRO,0,0,0,0
2020-05-09,WS,Samoa,WPRO,0,0,0,0
2020-05-10,WS,Samoa,WPRO,0,0,0,0
2020-05-11,WS,Samoa,WPRO,0,0,0,0
2020-05-12,WS,Samoa,WPRO,0,0,0,0
2020-05-13,WS,Samoa,WPRO,0,0,0,0
2020-05-14,WS,Samoa,WPRO,0,0,0,0
2020-05-15,WS,Samoa,WPRO,0,0,0,0
2020-05-16,WS,Samoa,WPRO,0,0,0,0
2020-05-17,WS,Samoa,WPRO,0,0,0,0
2020-05-18,WS,Samoa,WPRO,0,0,0,0
2020-05-19,WS,Samoa,WPRO,0,0,0,0
2020-05-20,WS,Samoa,WPRO,0,0,0,0
2020-05-21,WS,Samoa,WPRO,0,0,0,0
2020-05-22,WS,Samoa,WPRO,0,0,0,0
2020-05-23,WS,Samoa,WPRO,0,0,0,0
2020-05-24,WS,Samoa,WPRO,0,0,0,0
2020-05-25,WS,Samoa,WPRO,0,0,0,0
2020-05-26,WS,Samoa,WPRO,0,0,0,0
2020-05-27,WS,Samoa,WPRO,0,0,0,0
2020-05-28,WS,Samoa,WPRO,0,0,0,0
2020-05-29,WS,Samoa,WPRO,0,0,0,0
2020-05-30,WS,Samoa,WPRO,0,0,0,0
2020-05-31,WS,Samoa,WPRO,0,0,0,0
2020-06-01,WS,Samoa,WPRO,0,0,0,0
2020-06-02,WS,Samoa,WPRO,0,0,0,0
2020-06-03,WS,Samoa,WPRO,0,0,0,0
2020-06-04,WS,Samoa,WPRO,0,0,0,0
2020-06-05,WS,Samoa,WPRO,0,0,0,0
2020-06-06,WS,Samoa,WPRO,0,0,0,0
2020-06-07,WS,Samoa,WPRO,0,0,0,0
2020-06-08,WS,Samoa,WPRO,0,0,0,0
2020-03-29,SM,San Marino,EURO,0,229,0,22
2020-03-30,SM,San Marino,EURO,2,231,3,25
2020-03-31,SM,San Marino,EURO,6,237,1,26
2020-04-01,SM,San Marino,EURO,1,238,2,28
2020-04-02,SM,San Marino,EURO,0,238,0,28
2020-04-03,SM,San Marino,EURO,9,247,2,30
2020-04-04,SM,San Marino,EURO,7,254,2,32
2020-04-05,SM,San Marino,EURO,7,261,0,32
2020-04-06,SM,San Marino,EURO,7,268,0,32
2020-04-07,SM,San Marino,EURO,11,279,0,32
2020-04-08,SM,San Marino,EURO,2,281,2,34
2020-04-09,SM,San Marino,EURO,29,310,0,34
2020-04-10,SM,San Marino,EURO,36,346,0,34
2020-04-11,SM,San Marino,EURO,0,346,0,34
2020-04-12,SM,San Marino,EURO,12,358,1,35
2020-04-13,SM,San Marino,EURO,0,358,0,35
2020-04-14,SM,San Marino,EURO,15,373,1,36
2020-04-15,SM,San Marino,EURO,1,374,0,36
2020-04-16,SM,San Marino,EURO,21,395,0,36
2020-04-17,SM,San Marino,EURO,33,428,2,38
2020-04-18,SM,San Marino,EURO,0,428,0,38
2020-04-19,SM,San Marino,EURO,29,457,1,39
2020-04-20,SM,San Marino,EURO,6,463,0,39
2020-04-21,SM,San Marino,EURO,1,464,0,39
2020-04-22,SM,San Marino,EURO,14,478,1,40
2020-04-23,SM,San Marino,EURO,12,490,0,40
2020-04-24,SM,San Marino,EURO,13,503,0,40
2020-04-25,SM,San Marino,EURO,12,515,0,40
2020-04-26,SM,San Marino,EURO,0,515,0,40
2020-04-27,SM,San Marino,EURO,25,540,1,41
2020-04-28,SM,San Marino,EURO,0,540,0,41
2020-04-29,SM,San Marino,EURO,15,555,0,41
2020-04-30,SM,San Marino,EURO,10,565,0,41
2020-05-01,SM,San Marino,EURO,6,571,0,41
2020-05-02,SM,San Marino,EURO,11,582,0,41
2020-05-03,SM,San Marino,EURO,0,582,0,41
2020-05-04,SM,San Marino,EURO,2,584,0,41
2020-05-05,SM,San Marino,EURO,0,584,0,41
2020-05-06,SM,San Marino,EURO,7,591,0,41
2020-05-07,SM,San Marino,EURO,19,610,0,41
2020-05-08,SM,San Marino,EURO,24,634,0,41
2020-05-09,SM,San Marino,EURO,0,634,0,41
2020-05-10,SM,San Marino,EURO,0,634,0,41
2020-05-11,SM,San Marino,EURO,5,639,0,41
2020-05-12,SM,San Marino,EURO,10,649,0,41
2020-05-13,SM,San Marino,EURO,0,649,0,41
2020-05-14,SM,San Marino,EURO,0,649,0,41
2020-05-15,SM,San Marino,EURO,0,649,0,41
2020-05-16,SM,San Marino,EURO,5,654,0,41
2020-05-17,SM,San Marino,EURO,0,654,0,41
2020-05-18,SM,San Marino,EURO,16,670,0,41
2020-05-19,SM,San Marino,EURO,0,670,0,41
2020-05-20,SM,San Marino,EURO,0,670,0,41
2020-05-21,SM,San Marino,EURO,2,672,0,41
2020-05-22,SM,San Marino,EURO,2,674,0,41
2020-05-23,SM,San Marino,EURO,0,674,0,41
2020-05-24,SM,San Marino,EURO,0,674,1,42
2020-05-25,SM,San Marino,EURO,0,674,0,42
2020-05-26,SM,San Marino,EURO,0,674,0,42
2020-05-27,SM,San Marino,EURO,0,674,0,42
2020-05-28,SM,San Marino,EURO,0,674,0,42
2020-05-29,SM,San Marino,EURO,15,689,0,42
2020-05-30,SM,San Marino,EURO,0,689,0,42
2020-05-31,SM,San Marino,EURO,0,689,0,42
2020-06-01,SM,San Marino,EURO,0,689,0,42
2020-06-02,SM,San Marino,EURO,0,689,0,42
2020-06-03,SM,San Marino,EURO,0,689,0,42
2020-06-04,SM,San Marino,EURO,0,689,0,42
2020-06-05,SM,San Marino,EURO,8,697,0,42
2020-06-06,SM,San Marino,EURO,0,697,0,42
2020-06-07,SM,San Marino,EURO,0,697,0,42
2020-06-08,SM,San Marino,EURO,0,697,0,42
2020-03-29,ST,Sao Tome and Principe,AFRO,0,4,0,4
2020-03-30,ST,Sao Tome and Principe,AFRO,0,4,0,4
2020-03-31,ST,Sao Tome and Principe,AFRO,0,4,0,4
2020-04-01,ST,Sao Tome and Principe,AFRO,0,4,0,4
2020-04-02,ST,Sao Tome and Principe,AFRO,0,4,0,4
2020-04-03,ST,Sao Tome and Principe,AFRO,0,4,0,4
2020-04-04,ST,Sao Tome and Principe,AFRO,0,4,0,4
2020-04-05,ST,Sao Tome and Principe,AFRO,0,4,0,4
2020-04-06,ST,Sao Tome and Principe,AFRO,0,4,0,4
2020-04-07,ST,Sao Tome and Principe,AFRO,0,4,0,4
2020-04-08,ST,Sao Tome and Principe,AFRO,0,4,0,4
2020-04-09,ST,Sao Tome and Principe,AFRO,0,4,0,4
2020-04-10,ST,Sao Tome and Principe,AFRO,0,4,0,4
2020-04-11,ST,Sao Tome and Principe,AFRO,0,4,0,4
2020-04-12,ST,Sao Tome and Principe,AFRO,0,4,0,4
2020-04-13,ST,Sao Tome and Principe,AFRO,0,4,0,4
2020-04-14,ST,Sao Tome and Principe,AFRO,0,4,0,4
2020-04-15,ST,Sao Tome and Principe,AFRO,0,4,0,4
2020-04-16,ST,Sao Tome and Principe,AFRO,0,4,0,4
2020-04-17,ST,Sao Tome and Principe,AFRO,0,4,0,4
2020-04-18,ST,Sao Tome and Principe,AFRO,0,4,0,4
2020-04-19,ST,Sao Tome and Principe,AFRO,0,4,0,4
2020-04-20,ST,Sao Tome and Principe,AFRO,0,4,0,4
2020-04-21,ST,Sao Tome and Principe,AFRO,0,4,0,4
2020-04-22,ST,Sao Tome and Principe,AFRO,3,7,0,4
2020-04-23,ST,Sao Tome and Principe,AFRO,0,7,0,4
2020-04-24,ST,Sao Tome and Principe,AFRO,1,8,0,4
2020-04-25,ST,Sao Tome and Principe,AFRO,0,8,0,4
2020-04-26,ST,Sao Tome and Principe,AFRO,0,8,0,4
2020-04-27,ST,Sao Tome and Principe,AFRO,0,8,0,4
2020-04-28,ST,Sao Tome and Principe,AFRO,0,8,0,4
2020-04-29,ST,Sao Tome and Principe,AFRO,3,11,0,4
2020-04-30,ST,Sao Tome and Principe,AFRO,3,14,0,4
2020-05-01,ST,Sao Tome and Principe,AFRO,2,16,0,4
2020-05-02,ST,Sao Tome and Principe,AFRO,2,18,0,4
2020-05-03,ST,Sao Tome and Principe,AFRO,5,23,0,4
2020-05-04,ST,Sao Tome and Principe,AFRO,138,161,0,4
2020-05-05,ST,Sao Tome and Principe,AFRO,4,165,0,4
2020-05-06,ST,Sao Tome and Principe,AFRO,0,165,0,4
2020-05-07,ST,Sao Tome and Principe,AFRO,0,165,1,5
2020-05-08,ST,Sao Tome and Principe,AFRO,0,165,0,5
2020-05-09,ST,Sao Tome and Principe,AFRO,0,165,0,5
2020-05-10,ST,Sao Tome and Principe,AFRO,47,212,0,5
2020-05-11,ST,Sao Tome and Principe,AFRO,0,212,0,5
2020-05-12,ST,Sao Tome and Principe,AFRO,8,220,0,5
2020-05-13,ST,Sao Tome and Principe,AFRO,11,231,3,8
2020-05-14,ST,Sao Tome and Principe,AFRO,3,234,2,10
2020-05-15,ST,Sao Tome and Principe,AFRO,1,235,0,10
2020-05-16,ST,Sao Tome and Principe,AFRO,0,235,0,10
2020-05-17,ST,Sao Tome and Principe,AFRO,5,240,0,10
2020-05-18,ST,Sao Tome and Principe,AFRO,0,240,0,10
2020-05-19,ST,Sao Tome and Principe,AFRO,6,246,0,10
2020-05-20,ST,Sao Tome and Principe,AFRO,5,251,0,10
2020-05-21,ST,Sao Tome and Principe,AFRO,7,258,1,11
2020-05-22,ST,Sao Tome and Principe,AFRO,24,282,0,11
2020-05-23,ST,Sao Tome and Principe,AFRO,0,282,0,11
2020-05-24,ST,Sao Tome and Principe,AFRO,9,291,1,12
2020-05-25,ST,Sao Tome and Principe,AFRO,8,299,0,12
2020-05-26,ST,Sao Tome and Principe,AFRO,0,299,1,13
2020-05-27,ST,Sao Tome and Principe,AFRO,142,441,0,13
2020-05-28,ST,Sao Tome and Principe,AFRO,2,443,0,13
2020-05-29,ST,Sao Tome and Principe,AFRO,15,458,0,13
2020-05-30,ST,Sao Tome and Principe,AFRO,5,463,0,13
2020-05-31,ST,Sao Tome and Principe,AFRO,16,479,0,13
2020-06-01,ST,Sao Tome and Principe,AFRO,4,483,0,13
2020-06-02,ST,Sao Tome and Principe,AFRO,1,484,0,13
2020-06-03,ST,Sao Tome and Principe,AFRO,0,484,0,13
2020-06-04,ST,Sao Tome and Principe,AFRO,0,484,0,13
2020-06-05,ST,Sao Tome and Principe,AFRO,15,499,0,13
2020-06-06,ST,Sao Tome and Principe,AFRO,10,509,0,13
2020-06-07,ST,Sao Tome and Principe,AFRO,4,513,0,13
2020-06-08,ST,Sao Tome and Principe,AFRO,1,514,0,13
2020-03-29,SA,Saudi Arabia,EMRO,99,1203,1,4
2020-03-30,SA,Saudi Arabia,EMRO,96,1299,4,8
2020-03-31,SA,Saudi Arabia,EMRO,154,1453,0,8
2020-04-01,SA,Saudi Arabia,EMRO,110,1563,2,10
2020-04-02,SA,Saudi Arabia,EMRO,157,1720,6,16
2020-04-03,SA,Saudi Arabia,EMRO,165,1885,5,21
2020-04-04,SA,Saudi Arabia,EMRO,154,2039,4,25
2020-04-05,SA,Saudi Arabia,EMRO,140,2179,4,29
2020-04-06,SA,Saudi Arabia,EMRO,223,2402,5,34
2020-04-07,SA,Saudi Arabia,EMRO,203,2605,4,38
2020-04-08,SA,Saudi Arabia,EMRO,190,2795,3,41
2020-04-09,SA,Saudi Arabia,EMRO,137,2932,0,41
2020-04-10,SA,Saudi Arabia,EMRO,355,3287,3,44
2020-04-11,SA,Saudi Arabia,EMRO,364,3651,3,47
2020-04-12,SA,Saudi Arabia,EMRO,382,4033,5,52
2020-04-13,SA,Saudi Arabia,EMRO,429,4462,7,59
2020-04-14,SA,Saudi Arabia,EMRO,472,4934,6,65
2020-04-15,SA,Saudi Arabia,EMRO,435,5369,8,73
2020-04-16,SA,Saudi Arabia,EMRO,493,5862,6,79
2020-04-17,SA,Saudi Arabia,EMRO,518,6380,4,83
2020-04-18,SA,Saudi Arabia,EMRO,762,7142,4,87
2020-04-19,SA,Saudi Arabia,EMRO,1132,8274,5,92
2020-04-20,SA,Saudi Arabia,EMRO,1088,9362,5,97
2020-04-21,SA,Saudi Arabia,EMRO,1122,10484,6,103
2020-04-22,SA,Saudi Arabia,EMRO,1147,11631,6,109
2020-04-23,SA,Saudi Arabia,EMRO,1141,12772,5,114
2020-04-24,SA,Saudi Arabia,EMRO,1158,13930,7,121
2020-04-25,SA,Saudi Arabia,EMRO,1172,15102,6,127
2020-04-26,SA,Saudi Arabia,EMRO,1197,16299,9,136
2020-04-27,SA,Saudi Arabia,EMRO,1223,17522,3,139
2020-04-28,SA,Saudi Arabia,EMRO,1289,18811,5,144
2020-04-29,SA,Saudi Arabia,EMRO,1266,20077,8,152
2020-04-30,SA,Saudi Arabia,EMRO,1325,21402,5,157
2020-05-01,SA,Saudi Arabia,EMRO,1351,22753,5,162
2020-05-02,SA,Saudi Arabia,EMRO,1344,24097,7,169
2020-05-03,SA,Saudi Arabia,EMRO,1362,25459,7,176
2020-05-04,SA,Saudi Arabia,EMRO,1552,27011,8,184
2020-05-05,SA,Saudi Arabia,EMRO,1645,28656,7,191
2020-05-06,SA,Saudi Arabia,EMRO,1595,30251,9,200
2020-05-07,SA,Saudi Arabia,EMRO,1687,31938,9,209
2020-05-08,SA,Saudi Arabia,EMRO,1793,33731,10,219
2020-05-09,SA,Saudi Arabia,EMRO,1701,35432,10,229
2020-05-10,SA,Saudi Arabia,EMRO,1704,37136,10,239
2020-05-11,SA,Saudi Arabia,EMRO,1912,39048,7,246
2020-05-12,SA,Saudi Arabia,EMRO,1966,41014,9,255
2020-05-13,SA,Saudi Arabia,EMRO,1911,42925,9,264
2020-05-14,SA,Saudi Arabia,EMRO,1905,44830,9,273
2020-05-15,SA,Saudi Arabia,EMRO,2039,46869,10,283
2020-05-16,SA,Saudi Arabia,EMRO,2307,49176,9,292
2020-05-17,SA,Saudi Arabia,EMRO,2840,52016,10,302
2020-05-18,SA,Saudi Arabia,EMRO,2736,54752,10,312
2020-05-19,SA,Saudi Arabia,EMRO,2593,57345,8,320
2020-05-20,SA,Saudi Arabia,EMRO,2509,59854,9,329
2020-05-21,SA,Saudi Arabia,EMRO,2691,62545,10,339
2020-05-22,SA,Saudi Arabia,EMRO,2532,65077,12,351
2020-05-23,SA,Saudi Arabia,EMRO,2642,67719,13,364
2020-05-24,SA,Saudi Arabia,EMRO,2442,70161,15,379
2020-05-25,SA,Saudi Arabia,EMRO,2399,72560,11,390
2020-05-26,SA,Saudi Arabia,EMRO,2235,74795,9,399
2020-05-27,SA,Saudi Arabia,EMRO,1931,76726,12,411
2020-05-28,SA,Saudi Arabia,EMRO,1815,78541,14,425
2020-05-29,SA,Saudi Arabia,EMRO,1644,80185,16,441
2020-05-30,SA,Saudi Arabia,EMRO,1581,81766,17,458
2020-05-31,SA,Saudi Arabia,EMRO,1618,83384,22,480
2020-06-01,SA,Saudi Arabia,EMRO,1877,85261,23,503
2020-06-02,SA,Saudi Arabia,EMRO,1881,87142,22,525
2020-06-03,SA,Saudi Arabia,EMRO,1869,89011,24,549
2020-06-04,SA,Saudi Arabia,EMRO,2171,91182,30,579
2020-06-05,SA,Saudi Arabia,EMRO,1975,93157,32,611
2020-06-06,SA,Saudi Arabia,EMRO,2591,95748,31,642
2020-06-07,SA,Saudi Arabia,EMRO,3121,98869,34,676
2020-06-08,SA,Saudi Arabia,EMRO,3045,101914,36,712
2020-03-29,SN,Senegal,AFRO,1,144,0,137
2020-03-30,SN,Senegal,AFRO,19,163,0,137
2020-03-31,SN,Senegal,AFRO,26,189,0,137
2020-04-01,SN,Senegal,AFRO,15,204,0,137
2020-04-02,SN,Senegal,AFRO,4,208,0,137
2020-04-03,SN,Senegal,AFRO,10,218,0,137
2020-04-04,SN,Senegal,AFRO,4,222,0,137
2020-04-05,SN,Senegal,AFRO,2,224,0,137
2020-04-06,SN,Senegal,AFRO,4,228,0,137
2020-04-07,SN,Senegal,AFRO,12,240,0,137
2020-04-08,SN,Senegal,AFRO,10,250,0,137
2020-04-09,SN,Senegal,AFRO,3,253,0,137
2020-04-10,SN,Senegal,AFRO,14,267,0,137
2020-04-11,SN,Senegal,AFRO,13,280,0,137
2020-04-12,SN,Senegal,AFRO,10,290,0,137
2020-04-13,SN,Senegal,AFRO,6,296,0,137
2020-04-14,SN,Senegal,AFRO,5,301,0,137
2020-04-15,SN,Senegal,AFRO,10,311,0,137
2020-04-16,SN,Senegal,AFRO,10,321,0,137
2020-04-17,SN,Senegal,AFRO,3,324,0,137
2020-04-18,SN,Senegal,AFRO,9,333,0,137
2020-04-19,SN,Senegal,AFRO,6,339,0,137
2020-04-20,SN,Senegal,AFRO,0,339,0,137
2020-04-21,SN,Senegal,AFRO,1,340,0,137
2020-04-22,SN,Senegal,AFRO,1,341,0,137
2020-04-23,SN,Senegal,AFRO,38,379,0,137
2020-04-24,SN,Senegal,AFRO,54,433,0,137
2020-04-25,SN,Senegal,AFRO,73,506,0,137
2020-04-26,SN,Senegal,AFRO,14,520,0,137
2020-04-27,SN,Senegal,AFRO,80,600,0,137
2020-04-28,SN,Senegal,AFRO,42,642,0,137
2020-04-29,SN,Senegal,AFRO,8,650,0,137
2020-04-30,SN,Senegal,AFRO,79,729,0,137
2020-05-01,SN,Senegal,AFRO,104,833,0,137
2020-05-02,SN,Senegal,AFRO,142,975,0,137
2020-05-03,SN,Senegal,AFRO,140,1115,0,137
2020-05-04,SN,Senegal,AFRO,67,1182,0,137
2020-05-05,SN,Senegal,AFRO,89,1271,0,137
2020-05-06,SN,Senegal,AFRO,58,1329,0,137
2020-05-07,SN,Senegal,AFRO,104,1433,0,137
2020-05-08,SN,Senegal,AFRO,118,1551,0,137
2020-05-09,SN,Senegal,AFRO,0,1551,0,137
2020-05-10,SN,Senegal,AFRO,83,1634,0,137
2020-05-11,SN,Senegal,AFRO,75,1709,0,137
2020-05-12,SN,Senegal,AFRO,177,1886,0,137
2020-05-13,SN,Senegal,AFRO,109,1995,0,137
2020-05-14,SN,Senegal,AFRO,110,2105,0,137
2020-05-15,SN,Senegal,AFRO,84,2189,0,137
2020-05-16,SN,Senegal,AFRO,121,2310,0,137
2020-05-17,SN,Senegal,AFRO,119,2429,0,137
2020-05-18,SN,Senegal,AFRO,51,2480,0,137
2020-05-19,SN,Senegal,AFRO,64,2544,0,137
2020-05-20,SN,Senegal,AFRO,73,2617,0,137
2020-05-21,SN,Senegal,AFRO,97,2714,0,137
2020-05-22,SN,Senegal,AFRO,101,2815,0,137
2020-05-23,SN,Senegal,AFRO,94,2909,0,137
2020-05-24,SN,Senegal,AFRO,67,2976,0,137
2020-05-25,SN,Senegal,AFRO,71,3047,0,137
2020-05-26,SN,Senegal,AFRO,83,3130,0,137
2020-05-27,SN,Senegal,AFRO,31,3161,0,137
2020-05-28,SN,Senegal,AFRO,92,3253,0,137
2020-05-29,SN,Senegal,AFRO,95,3348,0,137
2020-05-30,SN,Senegal,AFRO,81,3429,0,137
2020-05-31,SN,Senegal,AFRO,106,3535,0,137
2020-06-01,SN,Senegal,AFRO,110,3645,0,137
2020-06-02,SN,Senegal,AFRO,94,3739,0,137
2020-06-03,SN,Senegal,AFRO,97,3836,0,137
2020-06-04,SN,Senegal,AFRO,96,3932,0,137
2020-06-05,SN,Senegal,AFRO,89,4021,0,137
2020-06-06,SN,Senegal,AFRO,134,4155,0,137
2020-06-07,SN,Senegal,AFRO,94,4249,0,137
2020-06-08,SN,Senegal,AFRO,0,4249,0,137
2020-03-29,RS,Serbia,EURO,131,659,2,10
2020-03-30,RS,Serbia,EURO,82,741,3,13
2020-03-31,RS,Serbia,EURO,44,785,3,16
2020-04-01,RS,Serbia,EURO,115,900,7,23
2020-04-02,RS,Serbia,EURO,160,1060,5,28
2020-04-03,RS,Serbia,EURO,111,1171,3,31
2020-04-04,RS,Serbia,EURO,305,1476,8,39
2020-04-05,RS,Serbia,EURO,148,1624,5,44
2020-04-06,RS,Serbia,EURO,284,1908,7,51
2020-04-07,RS,Serbia,EURO,292,2200,7,58
2020-04-08,RS,Serbia,EURO,247,2447,3,61
2020-04-09,RS,Serbia,EURO,219,2666,4,65
2020-04-10,RS,Serbia,EURO,201,2867,1,66
2020-04-11,RS,Serbia,EURO,238,3105,5,71
2020-04-12,RS,Serbia,EURO,275,3380,3,74
2020-04-13,RS,Serbia,EURO,250,3630,6,80
2020-04-14,RS,Serbia,EURO,424,4054,5,85
2020-04-15,RS,Serbia,EURO,411,4465,9,94
2020-04-16,RS,Serbia,EURO,408,4873,5,99
2020-04-17,RS,Serbia,EURO,445,5318,4,103
2020-04-18,RS,Serbia,EURO,372,5690,7,110
2020-04-19,RS,Serbia,EURO,304,5994,7,117
2020-04-20,RS,Serbia,EURO,324,6318,5,122
2020-04-21,RS,Serbia,EURO,312,6630,3,125
2020-04-22,RS,Serbia,EURO,260,6890,5,130
2020-04-23,RS,Serbia,EURO,224,7114,4,134
2020-04-24,RS,Serbia,EURO,162,7276,5,139
2020-04-25,RS,Serbia,EURO,207,7483,5,144
2020-04-26,RS,Serbia,EURO,296,7779,7,151
2020-04-27,RS,Serbia,EURO,263,8042,5,156
2020-04-28,RS,Serbia,EURO,233,8275,6,162
2020-04-29,RS,Serbia,EURO,222,8497,6,168
2020-04-30,RS,Serbia,EURO,227,8724,5,173
2020-05-01,RS,Serbia,EURO,285,9009,6,179
2020-05-02,RS,Serbia,EURO,196,9205,6,185
2020-05-03,RS,Serbia,EURO,157,9362,4,189
2020-05-04,RS,Serbia,EURO,102,9464,4,193
2020-05-05,RS,Serbia,EURO,93,9557,4,197
2020-05-06,RS,Serbia,EURO,120,9677,3,200
2020-05-07,RS,Serbia,EURO,114,9791,3,203
2020-05-08,RS,Serbia,EURO,57,9848,3,206
2020-05-09,RS,Serbia,EURO,95,9943,3,209
2020-05-10,RS,Serbia,EURO,89,10032,4,213
2020-05-11,RS,Serbia,EURO,82,10114,2,215
2020-05-12,RS,Serbia,EURO,62,10176,3,218
2020-05-13,RS,Serbia,EURO,67,10243,2,220
2020-05-14,RS,Serbia,EURO,52,10295,2,222
2020-05-15,RS,Serbia,EURO,79,10374,2,224
2020-05-16,RS,Serbia,EURO,64,10438,1,225
2020-05-17,RS,Serbia,EURO,58,10496,3,228
2020-05-18,RS,Serbia,EURO,114,10610,2,230
2020-05-19,RS,Serbia,EURO,89,10699,1,231
2020-05-20,RS,Serbia,EURO,34,10733,3,234
2020-05-21,RS,Serbia,EURO,100,10833,1,235
2020-05-22,RS,Serbia,EURO,86,10919,2,237
2020-05-23,RS,Serbia,EURO,105,11024,0,237
2020-05-24,RS,Serbia,EURO,68,11092,1,238
2020-05-25,RS,Serbia,EURO,67,11159,0,238
2020-05-26,RS,Serbia,EURO,34,11193,1,239
2020-05-27,RS,Serbia,EURO,34,11227,0,239
2020-05-28,RS,Serbia,EURO,48,11275,1,240
2020-05-29,RS,Serbia,EURO,25,11300,1,241
2020-05-30,RS,Serbia,EURO,54,11354,1,242
2020-05-31,RS,Serbia,EURO,27,11381,0,242
2020-06-01,RS,Serbia,EURO,31,11412,1,243
2020-06-02,RS,Serbia,EURO,18,11430,1,244
2020-06-03,RS,Serbia,EURO,24,11454,1,245
2020-06-04,RS,Serbia,EURO,69,11523,0,245
2020-06-05,RS,Serbia,EURO,48,11571,1,246
2020-06-06,RS,Serbia,EURO,96,11667,1,247
2020-06-07,RS,Serbia,EURO,74,11741,1,248
2020-06-08,RS,Serbia,EURO,82,11823,1,249
2020-03-29,SC,Seychelles,AFRO,1,8,0,1
2020-03-30,SC,Seychelles,AFRO,0,8,0,1
2020-03-31,SC,Seychelles,AFRO,2,10,0,1
2020-04-01,SC,Seychelles,AFRO,0,10,0,1
2020-04-02,SC,Seychelles,AFRO,0,10,0,1
2020-04-03,SC,Seychelles,AFRO,0,10,0,1
2020-04-04,SC,Seychelles,AFRO,0,10,0,1
2020-04-05,SC,Seychelles,AFRO,0,10,0,1
2020-04-06,SC,Seychelles,AFRO,0,10,0,1
2020-04-07,SC,Seychelles,AFRO,1,11,0,1
2020-04-08,SC,Seychelles,AFRO,0,11,0,1
2020-04-09,SC,Seychelles,AFRO,0,11,0,1
2020-04-10,SC,Seychelles,AFRO,0,11,0,1
2020-04-11,SC,Seychelles,AFRO,0,11,0,1
2020-04-12,SC,Seychelles,AFRO,0,11,0,1
2020-04-13,SC,Seychelles,AFRO,0,11,0,1
2020-04-14,SC,Seychelles,AFRO,0,11,0,1
2020-04-15,SC,Seychelles,AFRO,0,11,0,1
2020-04-16,SC,Seychelles,AFRO,0,11,0,1
2020-04-17,SC,Seychelles,AFRO,0,11,0,1
2020-04-18,SC,Seychelles,AFRO,0,11,0,1
2020-04-19,SC,Seychelles,AFRO,0,11,0,1
2020-04-20,SC,Seychelles,AFRO,0,11,0,1
2020-04-21,SC,Seychelles,AFRO,0,11,0,1
2020-04-22,SC,Seychelles,AFRO,0,11,0,1
2020-04-23,SC,Seychelles,AFRO,0,11,0,1
2020-04-24,SC,Seychelles,AFRO,0,11,0,1
2020-04-25,SC,Seychelles,AFRO,0,11,0,1
2020-04-26,SC,Seychelles,AFRO,0,11,0,1
2020-04-27,SC,Seychelles,AFRO,0,11,0,1
2020-04-28,SC,Seychelles,AFRO,0,11,0,1
2020-04-29,SC,Seychelles,AFRO,0,11,0,1
2020-04-30,SC,Seychelles,AFRO,0,11,0,1
2020-05-01,SC,Seychelles,AFRO,0,11,0,1
2020-05-02,SC,Seychelles,AFRO,0,11,0,1
2020-05-03,SC,Seychelles,AFRO,0,11,0,1
2020-05-04,SC,Seychelles,AFRO,0,11,0,1
2020-05-05,SC,Seychelles,AFRO,0,11,0,1
2020-05-06,SC,Seychelles,AFRO,0,11,0,1
2020-05-07,SC,Seychelles,AFRO,0,11,0,1
2020-05-08,SC,Seychelles,AFRO,0,11,0,1
2020-05-09,SC,Seychelles,AFRO,0,11,0,1
2020-05-10,SC,Seychelles,AFRO,0,11,0,1
2020-05-11,SC,Seychelles,AFRO,0,11,0,1
2020-05-12,SC,Seychelles,AFRO,0,11,0,1
2020-05-13,SC,Seychelles,AFRO,0,11,0,1
2020-05-14,SC,Seychelles,AFRO,0,11,0,1
2020-05-15,SC,Seychelles,AFRO,0,11,0,1
2020-05-16,SC,Seychelles,AFRO,0,11,0,1
2020-05-17,SC,Seychelles,AFRO,0,11,0,1
2020-05-18,SC,Seychelles,AFRO,0,11,0,1
2020-05-19,SC,Seychelles,AFRO,0,11,0,1
2020-05-20,SC,Seychelles,AFRO,0,11,0,1
2020-05-21,SC,Seychelles,AFRO,0,11,0,1
2020-05-22,SC,Seychelles,AFRO,0,11,0,1
2020-05-23,SC,Seychelles,AFRO,0,11,0,1
2020-05-24,SC,Seychelles,AFRO,0,11,0,1
2020-05-25,SC,Seychelles,AFRO,0,11,0,1
2020-05-26,SC,Seychelles,AFRO,0,11,0,1
2020-05-27,SC,Seychelles,AFRO,0,11,0,1
2020-05-28,SC,Seychelles,AFRO,0,11,0,1
2020-05-29,SC,Seychelles,AFRO,0,11,0,1
2020-05-30,SC,Seychelles,AFRO,0,11,0,1
2020-05-31,SC,Seychelles,AFRO,0,11,0,1
2020-06-01,SC,Seychelles,AFRO,0,11,0,1
2020-06-02,SC,Seychelles,AFRO,0,11,0,1
2020-06-03,SC,Seychelles,AFRO,0,11,0,1
2020-06-04,SC,Seychelles,AFRO,0,11,0,1
2020-06-05,SC,Seychelles,AFRO,0,11,0,1
2020-06-06,SC,Seychelles,AFRO,0,11,0,1
2020-06-07,SC,Seychelles,AFRO,0,11,0,1
2020-06-08,SC,Seychelles,AFRO,0,11,0,1
2020-03-29,SL,Sierra Leone,AFRO,0,1,0,2
2020-03-30,SL,Sierra Leone,AFRO,0,1,0,2
2020-03-31,SL,Sierra Leone,AFRO,0,1,0,2
2020-04-01,SL,Sierra Leone,AFRO,0,1,0,2
2020-04-02,SL,Sierra Leone,AFRO,1,2,0,2
2020-04-03,SL,Sierra Leone,AFRO,0,2,0,2
2020-04-04,SL,Sierra Leone,AFRO,0,2,0,2
2020-04-05,SL,Sierra Leone,AFRO,2,4,0,2
2020-04-06,SL,Sierra Leone,AFRO,2,6,0,2
2020-04-07,SL,Sierra Leone,AFRO,0,6,0,2
2020-04-08,SL,Sierra Leone,AFRO,0,6,0,2
2020-04-09,SL,Sierra Leone,AFRO,1,7,0,2
2020-04-10,SL,Sierra Leone,AFRO,0,7,0,2
2020-04-11,SL,Sierra Leone,AFRO,1,8,0,2
2020-04-12,SL,Sierra Leone,AFRO,2,10,0,2
2020-04-13,SL,Sierra Leone,AFRO,0,10,0,2
2020-04-14,SL,Sierra Leone,AFRO,0,10,0,2
2020-04-15,SL,Sierra Leone,AFRO,3,13,0,2
2020-04-16,SL,Sierra Leone,AFRO,0,13,0,2
2020-04-17,SL,Sierra Leone,AFRO,2,15,0,2
2020-04-18,SL,Sierra Leone,AFRO,11,26,0,2
2020-04-19,SL,Sierra Leone,AFRO,4,30,0,2
2020-04-20,SL,Sierra Leone,AFRO,5,35,0,2
2020-04-21,SL,Sierra Leone,AFRO,8,43,0,2
2020-04-22,SL,Sierra Leone,AFRO,7,50,0,2
2020-04-23,SL,Sierra Leone,AFRO,11,61,0,2
2020-04-24,SL,Sierra Leone,AFRO,3,64,1,3
2020-04-25,SL,Sierra Leone,AFRO,19,83,1,4
2020-04-26,SL,Sierra Leone,AFRO,3,86,0,4
2020-04-27,SL,Sierra Leone,AFRO,7,93,1,5
2020-04-28,SL,Sierra Leone,AFRO,6,99,0,5
2020-04-29,SL,Sierra Leone,AFRO,5,104,0,5
2020-04-30,SL,Sierra Leone,AFRO,12,116,1,6
2020-05-01,SL,Sierra Leone,AFRO,8,124,2,8
2020-05-02,SL,Sierra Leone,AFRO,12,136,1,9
2020-05-03,SL,Sierra Leone,AFRO,19,155,0,9
2020-05-04,SL,Sierra Leone,AFRO,11,166,0,9
2020-05-05,SL,Sierra Leone,AFRO,12,178,1,10
2020-05-06,SL,Sierra Leone,AFRO,21,199,2,12
2020-05-07,SL,Sierra Leone,AFRO,26,225,3,15
2020-05-08,SL,Sierra Leone,AFRO,6,231,2,17
2020-05-09,SL,Sierra Leone,AFRO,26,257,1,18
2020-05-10,SL,Sierra Leone,AFRO,34,291,1,19
2020-05-11,SL,Sierra Leone,AFRO,16,307,0,19
2020-05-12,SL,Sierra Leone,AFRO,31,338,1,20
2020-05-13,SL,Sierra Leone,AFRO,0,338,1,21
2020-05-14,SL,Sierra Leone,AFRO,49,387,1,22
2020-05-15,SL,Sierra Leone,AFRO,21,408,5,27
2020-05-16,SL,Sierra Leone,AFRO,39,447,1,28
2020-05-17,SL,Sierra Leone,AFRO,15,462,2,30
2020-05-18,SL,Sierra Leone,AFRO,43,505,3,33
2020-05-19,SL,Sierra Leone,AFRO,14,519,1,34
2020-05-20,SL,Sierra Leone,AFRO,15,534,0,34
2020-05-21,SL,Sierra Leone,AFRO,36,570,1,35
2020-05-22,SL,Sierra Leone,AFRO,15,585,1,36
2020-05-23,SL,Sierra Leone,AFRO,21,606,3,39
2020-05-24,SL,Sierra Leone,AFRO,15,621,1,40
2020-05-25,SL,Sierra Leone,AFRO,100,721,1,41
2020-05-26,SL,Sierra Leone,AFRO,14,735,2,43
2020-05-27,SL,Sierra Leone,AFRO,19,754,2,45
2020-05-28,SL,Sierra Leone,AFRO,28,782,1,46
2020-05-29,SL,Sierra Leone,AFRO,30,812,0,46
2020-05-30,SL,Sierra Leone,AFRO,17,829,0,46
2020-05-31,SL,Sierra Leone,AFRO,23,852,1,47
2020-06-01,SL,Sierra Leone,AFRO,9,861,0,47
2020-06-02,SL,Sierra Leone,AFRO,4,865,0,47
2020-06-03,SL,Sierra Leone,AFRO,31,896,0,47
2020-06-04,SL,Sierra Leone,AFRO,13,909,1,48
2020-06-05,SL,Sierra Leone,AFRO,5,914,0,48
2020-06-06,SL,Sierra Leone,AFRO,15,929,0,48
2020-06-07,SL,Sierra Leone,AFRO,17,946,1,49
2020-06-08,SL,Sierra Leone,AFRO,23,969,0,49
2020-03-29,SG,Singapore,WPRO,70,802,0,2
2020-03-30,SG,Singapore,WPRO,42,844,1,3
2020-03-31,SG,Singapore,WPRO,35,879,0,3
2020-04-01,SG,Singapore,WPRO,47,926,0,3
2020-04-02,SG,Singapore,WPRO,74,1000,0,3
2020-04-03,SG,Singapore,WPRO,49,1049,1,4
2020-04-04,SG,Singapore,WPRO,65,1114,1,5
2020-04-05,SG,Singapore,WPRO,75,1189,0,5
2020-04-06,SG,Singapore,WPRO,120,1309,1,6
2020-04-07,SG,Singapore,WPRO,66,1375,0,6
2020-04-08,SG,Singapore,WPRO,106,1481,0,6
2020-04-09,SG,Singapore,WPRO,142,1623,0,6
2020-04-10,SG,Singapore,WPRO,287,1910,1,7
2020-04-11,SG,Singapore,WPRO,198,2108,0,7
2020-04-12,SG,Singapore,WPRO,191,2299,1,8
2020-04-13,SG,Singapore,WPRO,233,2532,0,8
2020-04-14,SG,Singapore,WPRO,386,2918,1,9
2020-04-15,SG,Singapore,WPRO,334,3252,1,10
2020-04-16,SG,Singapore,WPRO,447,3699,0,10
2020-04-17,SG,Singapore,WPRO,728,4427,0,10
2020-04-18,SG,Singapore,WPRO,623,5050,1,11
2020-04-19,SG,Singapore,WPRO,942,5992,0,11
2020-04-20,SG,Singapore,WPRO,596,6588,0,11
2020-04-21,SG,Singapore,WPRO,1426,8014,0,11
2020-04-22,SG,Singapore,WPRO,1111,9125,0,11
2020-04-23,SG,Singapore,WPRO,1016,10141,1,12
2020-04-24,SG,Singapore,WPRO,1037,11178,0,12
2020-04-25,SG,Singapore,WPRO,897,12075,0,12
2020-04-26,SG,Singapore,WPRO,618,12693,0,12
2020-04-27,SG,Singapore,WPRO,931,13624,0,12
2020-04-28,SG,Singapore,WPRO,799,14423,2,14
2020-04-29,SG,Singapore,WPRO,528,14951,0,14
2020-04-30,SG,Singapore,WPRO,690,15641,0,14
2020-05-01,SG,Singapore,WPRO,528,16169,1,15
2020-05-02,SG,Singapore,WPRO,932,17101,1,16
2020-05-03,SG,Singapore,WPRO,447,17548,1,17
2020-05-04,SG,Singapore,WPRO,657,18205,1,18
2020-05-05,SG,Singapore,WPRO,573,18778,0,18
2020-05-06,SG,Singapore,WPRO,632,19410,0,18
2020-05-07,SG,Singapore,WPRO,788,20198,2,20
2020-05-08,SG,Singapore,WPRO,741,20939,0,20
2020-05-09,SG,Singapore,WPRO,768,21707,0,20
2020-05-10,SG,Singapore,WPRO,753,22460,0,20
2020-05-11,SG,Singapore,WPRO,876,23336,0,20
2020-05-12,SG,Singapore,WPRO,451,23787,1,21
2020-05-13,SG,Singapore,WPRO,884,24671,0,21
2020-05-14,SG,Singapore,WPRO,675,25346,0,21
2020-05-15,SG,Singapore,WPRO,752,26098,0,21
2020-05-16,SG,Singapore,WPRO,793,26891,0,21
2020-05-17,SG,Singapore,WPRO,465,27356,1,22
2020-05-18,SG,Singapore,WPRO,682,28038,0,22
2020-05-19,SG,Singapore,WPRO,305,28343,0,22
2020-05-20,SG,Singapore,WPRO,451,28794,0,22
2020-05-21,SG,Singapore,WPRO,570,29364,0,22
2020-05-22,SG,Singapore,WPRO,448,29812,1,23
2020-05-23,SG,Singapore,WPRO,614,30426,0,23
2020-05-24,SG,Singapore,WPRO,642,31068,0,23
2020-05-25,SG,Singapore,WPRO,548,31616,0,23
2020-05-26,SG,Singapore,WPRO,344,31960,0,23
2020-05-27,SG,Singapore,WPRO,383,32343,0,23
2020-05-28,SG,Singapore,WPRO,533,32876,0,23
2020-05-29,SG,Singapore,WPRO,373,33249,0,23
2020-05-30,SG,Singapore,WPRO,611,33860,0,23
2020-05-31,SG,Singapore,WPRO,506,34366,0,23
2020-06-01,SG,Singapore,WPRO,518,34884,0,23
2020-06-02,SG,Singapore,WPRO,408,35292,1,24
2020-06-03,SG,Singapore,WPRO,544,35836,0,24
2020-06-04,SG,Singapore,WPRO,569,36405,0,24
2020-06-05,SG,Singapore,WPRO,517,36922,0,24
2020-06-06,SG,Singapore,WPRO,261,37183,0,24
2020-06-07,SG,Singapore,WPRO,344,37527,1,25
2020-06-08,SG,Singapore,WPRO,383,37910,0,25
2020-03-29,XB,Sint Eustatius,AMRO,0,0,0,0
2020-03-30,XB,Sint Eustatius,AMRO,0,0,0,0
2020-03-31,XB,Sint Eustatius,AMRO,0,0,0,0
2020-04-01,XB,Sint Eustatius,AMRO,0,0,0,0
2020-04-02,XB,Sint Eustatius,AMRO,2,2,0,0
2020-04-03,XB,Sint Eustatius,AMRO,0,2,0,0
2020-04-04,XB,Sint Eustatius,AMRO,0,2,0,0
2020-04-05,XB,Sint Eustatius,AMRO,0,2,0,0
2020-04-06,XB,Sint Eustatius,AMRO,0,2,0,0
2020-04-07,XB,Sint Eustatius,AMRO,0,2,0,0
2020-04-08,XB,Sint Eustatius,AMRO,0,2,0,0
2020-04-09,XB,Sint Eustatius,AMRO,0,2,0,0
2020-04-10,XB,Sint Eustatius,AMRO,0,2,0,0
2020-04-11,XB,Sint Eustatius,AMRO,0,2,0,0
2020-04-12,XB,Sint Eustatius,AMRO,0,2,0,0
2020-04-13,XB,Sint Eustatius,AMRO,0,2,0,0
2020-04-14,XB,Sint Eustatius,AMRO,0,2,0,0
2020-04-15,XB,Sint Eustatius,AMRO,0,2,0,0
2020-04-16,XB,Sint Eustatius,AMRO,0,2,0,0
2020-04-17,XB,Sint Eustatius,AMRO,0,2,0,0
2020-04-18,XB,Sint Eustatius,AMRO,0,2,0,0
2020-04-19,XB,Sint Eustatius,AMRO,0,2,0,0
2020-04-20,XB,Sint Eustatius,AMRO,0,2,0,0
2020-04-21,XB,Sint Eustatius,AMRO,0,2,0,0
2020-04-22,XB,Sint Eustatius,AMRO,0,2,0,0
2020-04-23,XB,Sint Eustatius,AMRO,0,2,0,0
2020-04-24,XB,Sint Eustatius,AMRO,0,2,0,0
2020-04-25,XB,Sint Eustatius,AMRO,0,2,0,0
2020-04-26,XB,Sint Eustatius,AMRO,0,2,0,0
2020-04-27,XB,Sint Eustatius,AMRO,0,2,0,0
2020-04-28,XB,Sint Eustatius,AMRO,0,2,0,0
2020-04-29,XB,Sint Eustatius,AMRO,0,2,0,0
2020-04-30,XB,Sint Eustatius,AMRO,0,2,0,0
2020-05-01,XB,Sint Eustatius,AMRO,0,2,0,0
2020-05-02,XB,Sint Eustatius,AMRO,0,2,0,0
2020-05-03,XB,Sint Eustatius,AMRO,0,2,0,0
2020-05-04,XB,Sint Eustatius,AMRO,0,2,0,0
2020-05-05,XB,Sint Eustatius,AMRO,0,2,0,0
2020-05-06,XB,Sint Eustatius,AMRO,0,2,0,0
2020-05-07,XB,Sint Eustatius,AMRO,0,2,0,0
2020-05-08,XB,Sint Eustatius,AMRO,0,2,0,0
2020-05-09,XB,Sint Eustatius,AMRO,0,2,0,0
2020-05-10,XB,Sint Eustatius,AMRO,0,2,0,0
2020-05-11,XB,Sint Eustatius,AMRO,0,2,0,0
2020-05-12,XB,Sint Eustatius,AMRO,0,2,0,0
2020-05-13,XB,Sint Eustatius,AMRO,0,2,0,0
2020-05-14,XB,Sint Eustatius,AMRO,0,2,0,0
2020-05-15,XB,Sint Eustatius,AMRO,0,2,0,0
2020-05-16,XB,Sint Eustatius,AMRO,0,2,0,0
2020-05-17,XB,Sint Eustatius,AMRO,0,2,0,0
2020-05-18,XB,Sint Eustatius,AMRO,0,2,0,0
2020-05-19,XB,Sint Eustatius,AMRO,0,2,0,0
2020-05-20,XB,Sint Eustatius,AMRO,0,2,0,0
2020-05-21,XB,Sint Eustatius,AMRO,0,2,0,0
2020-05-22,XB,Sint Eustatius,AMRO,0,2,0,0
2020-05-23,XB,Sint Eustatius,AMRO,0,2,0,0
2020-05-24,XB,Sint Eustatius,AMRO,0,2,0,0
2020-05-25,XB,Sint Eustatius,AMRO,0,2,0,0
2020-05-26,XB,Sint Eustatius,AMRO,0,2,0,0
2020-05-27,XB,Sint Eustatius,AMRO,0,2,0,0
2020-05-28,XB,Sint Eustatius,AMRO,0,2,0,0
2020-05-29,XB,Sint Eustatius,AMRO,0,2,0,0
2020-05-30,XB,Sint Eustatius,AMRO,0,2,0,0
2020-05-31,XB,Sint Eustatius,AMRO,0,2,0,0
2020-06-01,XB,Sint Eustatius,AMRO,0,2,0,0
2020-06-02,XB,Sint Eustatius,AMRO,0,2,0,0
2020-06-03,XB,Sint Eustatius,AMRO,0,2,0,0
2020-06-04,XB,Sint Eustatius,AMRO,0,2,0,0
2020-06-05,XB,Sint Eustatius,AMRO,0,2,0,0
2020-06-06,XB,Sint Eustatius,AMRO,0,2,0,0
2020-06-07,XB,Sint Eustatius,AMRO,0,2,0,0
2020-06-08,XB,Sint Eustatius,AMRO,0,2,0,0
2020-03-29,SX,Sint Maarten,AMRO,0,3,0,0
2020-03-30,SX,Sint Maarten,AMRO,3,6,0,0
2020-03-31,SX,Sint Maarten,AMRO,0,6,0,0
2020-04-01,SX,Sint Maarten,AMRO,0,6,0,0
2020-04-02,SX,Sint Maarten,AMRO,0,6,0,0
2020-04-03,SX,Sint Maarten,AMRO,12,18,1,1
2020-04-04,SX,Sint Maarten,AMRO,5,23,1,2
2020-04-05,SX,Sint Maarten,AMRO,0,23,0,2
2020-04-06,SX,Sint Maarten,AMRO,0,23,0,2
2020-04-07,SX,Sint Maarten,AMRO,14,37,4,6
2020-04-08,SX,Sint Maarten,AMRO,3,40,2,8
2020-04-09,SX,Sint Maarten,AMRO,0,40,0,8
2020-04-10,SX,Sint Maarten,AMRO,3,43,0,8
2020-04-11,SX,Sint Maarten,AMRO,7,50,1,9
2020-04-12,SX,Sint Maarten,AMRO,0,50,0,9
2020-04-13,SX,Sint Maarten,AMRO,0,50,0,9
2020-04-14,SX,Sint Maarten,AMRO,2,52,0,9
2020-04-15,SX,Sint Maarten,AMRO,0,52,0,9
2020-04-16,SX,Sint Maarten,AMRO,1,53,0,9
2020-04-17,SX,Sint Maarten,AMRO,4,57,0,9
2020-04-18,SX,Sint Maarten,AMRO,0,57,0,9
2020-04-19,SX,Sint Maarten,AMRO,0,57,0,9
2020-04-20,SX,Sint Maarten,AMRO,7,64,0,9
2020-04-21,SX,Sint Maarten,AMRO,3,67,1,10
2020-04-22,SX,Sint Maarten,AMRO,1,68,0,10
2020-04-23,SX,Sint Maarten,AMRO,3,71,1,11
2020-04-24,SX,Sint Maarten,AMRO,2,73,1,12
2020-04-25,SX,Sint Maarten,AMRO,0,73,0,12
2020-04-26,SX,Sint Maarten,AMRO,0,73,0,12
2020-04-27,SX,Sint Maarten,AMRO,1,74,1,13
2020-04-28,SX,Sint Maarten,AMRO,0,74,0,13
2020-04-29,SX,Sint Maarten,AMRO,1,75,0,13
2020-04-30,SX,Sint Maarten,AMRO,0,75,0,13
2020-05-01,SX,Sint Maarten,AMRO,1,76,0,13
2020-05-02,SX,Sint Maarten,AMRO,0,76,0,13
2020-05-03,SX,Sint Maarten,AMRO,0,76,0,13
2020-05-04,SX,Sint Maarten,AMRO,0,76,0,13
2020-05-05,SX,Sint Maarten,AMRO,0,76,0,13
2020-05-06,SX,Sint Maarten,AMRO,0,76,1,14
2020-05-07,SX,Sint Maarten,AMRO,0,76,0,14
2020-05-08,SX,Sint Maarten,AMRO,0,76,0,14
2020-05-09,SX,Sint Maarten,AMRO,0,76,0,14
2020-05-10,SX,Sint Maarten,AMRO,1,77,1,15
2020-05-11,SX,Sint Maarten,AMRO,0,77,0,15
2020-05-12,SX,Sint Maarten,AMRO,0,77,0,15
2020-05-13,SX,Sint Maarten,AMRO,0,77,0,15
2020-05-14,SX,Sint Maarten,AMRO,1,78,0,15
2020-05-15,SX,Sint Maarten,AMRO,0,78,0,15
2020-05-16,SX,Sint Maarten,AMRO,0,78,0,15
2020-05-17,SX,Sint Maarten,AMRO,0,78,0,15
2020-05-18,SX,Sint Maarten,AMRO,0,78,0,15
2020-05-19,SX,Sint Maarten,AMRO,0,78,0,15
2020-05-20,SX,Sint Maarten,AMRO,0,78,0,15
2020-05-21,SX,Sint Maarten,AMRO,0,78,0,15
2020-05-22,SX,Sint Maarten,AMRO,0,78,0,15
2020-05-23,SX,Sint Maarten,AMRO,0,78,0,15
2020-05-24,SX,Sint Maarten,AMRO,0,78,0,15
2020-05-25,SX,Sint Maarten,AMRO,0,78,0,15
2020-05-26,SX,Sint Maarten,AMRO,0,78,0,15
2020-05-27,SX,Sint Maarten,AMRO,0,78,0,15
2020-05-28,SX,Sint Maarten,AMRO,0,78,0,15
2020-05-29,SX,Sint Maarten,AMRO,0,78,0,15
2020-05-30,SX,Sint Maarten,AMRO,0,78,0,15
2020-05-31,SX,Sint Maarten,AMRO,0,78,0,15
2020-06-01,SX,Sint Maarten,AMRO,0,78,0,15
2020-06-02,SX,Sint Maarten,AMRO,0,78,0,15
2020-06-03,SX,Sint Maarten,AMRO,0,78,0,15
2020-06-04,SX,Sint Maarten,AMRO,0,78,0,15
2020-06-05,SX,Sint Maarten,AMRO,0,78,0,15
2020-06-06,SX,Sint Maarten,AMRO,-1,77,0,15
2020-06-07,SX,Sint Maarten,AMRO,0,77,0,15
2020-06-08,SX,Sint Maarten,AMRO,0,77,0,15
2020-03-29,SK,Slovakia,EURO,22,314,0,0
2020-03-30,SK,Slovakia,EURO,22,336,0,0
2020-03-31,SK,Slovakia,EURO,27,363,1,1
2020-04-01,SK,Slovakia,EURO,37,400,0,1
2020-04-02,SK,Slovakia,EURO,26,426,0,1
2020-04-03,SK,Slovakia,EURO,24,450,0,1
2020-04-04,SK,Slovakia,EURO,21,471,0,1
2020-04-05,SK,Slovakia,EURO,14,485,0,1
2020-04-06,SK,Slovakia,EURO,49,534,1,2
2020-04-07,SK,Slovakia,EURO,47,581,0,2
2020-04-08,SK,Slovakia,EURO,101,682,0,2
2020-04-09,SK,Slovakia,EURO,19,701,0,2
2020-04-10,SK,Slovakia,EURO,14,715,0,2
2020-04-11,SK,Slovakia,EURO,13,728,0,2
2020-04-12,SK,Slovakia,EURO,14,742,0,2
2020-04-13,SK,Slovakia,EURO,27,769,0,2
2020-04-14,SK,Slovakia,EURO,66,835,0,2
2020-04-15,SK,Slovakia,EURO,28,863,4,6
2020-04-16,SK,Slovakia,EURO,114,977,2,8
2020-04-17,SK,Slovakia,EURO,72,1049,1,9
2020-04-18,SK,Slovakia,EURO,40,1089,2,11
2020-04-19,SK,Slovakia,EURO,72,1161,1,12
2020-04-20,SK,Slovakia,EURO,12,1173,1,13
2020-04-21,SK,Slovakia,EURO,26,1199,1,14
2020-04-22,SK,Slovakia,EURO,45,1244,0,14
2020-04-23,SK,Slovakia,EURO,81,1325,1,15
2020-04-24,SK,Slovakia,EURO,35,1360,2,17
2020-04-25,SK,Slovakia,EURO,13,1373,0,17
2020-04-26,SK,Slovakia,EURO,6,1379,1,18
2020-04-27,SK,Slovakia,EURO,2,1381,0,18
2020-04-28,SK,Slovakia,EURO,3,1384,2,20
2020-04-29,SK,Slovakia,EURO,7,1391,1,21
2020-04-30,SK,Slovakia,EURO,5,1396,2,23
2020-05-01,SK,Slovakia,EURO,7,1403,0,23
2020-05-02,SK,Slovakia,EURO,4,1407,1,24
2020-05-03,SK,Slovakia,EURO,1,1408,0,24
2020-05-04,SK,Slovakia,EURO,5,1413,1,25
2020-05-05,SK,Slovakia,EURO,8,1421,0,25
2020-05-06,SK,Slovakia,EURO,8,1429,0,25
2020-05-07,SK,Slovakia,EURO,16,1445,1,26
2020-05-08,SK,Slovakia,EURO,10,1455,0,26
2020-05-09,SK,Slovakia,EURO,0,1455,0,26
2020-05-10,SK,Slovakia,EURO,2,1457,0,26
2020-05-11,SK,Slovakia,EURO,0,1457,0,26
2020-05-12,SK,Slovakia,EURO,8,1465,1,27
2020-05-13,SK,Slovakia,EURO,4,1469,0,27
2020-05-14,SK,Slovakia,EURO,8,1477,0,27
2020-05-15,SK,Slovakia,EURO,3,1480,0,27
2020-05-16,SK,Slovakia,EURO,13,1493,1,28
2020-05-17,SK,Slovakia,EURO,1,1494,0,28
2020-05-18,SK,Slovakia,EURO,1,1495,0,28
2020-05-19,SK,Slovakia,EURO,0,1495,0,28
2020-05-20,SK,Slovakia,EURO,1,1496,0,28
2020-05-21,SK,Slovakia,EURO,6,1502,0,28
2020-05-22,SK,Slovakia,EURO,1,1503,0,28
2020-05-23,SK,Slovakia,EURO,1,1504,0,28
2020-05-24,SK,Slovakia,EURO,5,1509,0,28
2020-05-25,SK,Slovakia,EURO,2,1511,0,28
2020-05-26,SK,Slovakia,EURO,2,1513,0,28
2020-05-27,SK,Slovakia,EURO,2,1515,0,28
2020-05-28,SK,Slovakia,EURO,5,1520,0,28
2020-05-29,SK,Slovakia,EURO,0,1520,0,28
2020-05-30,SK,Slovakia,EURO,1,1521,0,28
2020-05-31,SK,Slovakia,EURO,0,1521,0,28
2020-06-01,SK,Slovakia,EURO,1,1522,0,28
2020-06-02,SK,Slovakia,EURO,0,1522,0,28
2020-06-03,SK,Slovakia,EURO,3,1525,0,28
2020-06-04,SK,Slovakia,EURO,1,1526,0,28
2020-06-05,SK,Slovakia,EURO,0,1526,0,28
2020-06-06,SK,Slovakia,EURO,2,1528,0,28
2020-06-07,SK,Slovakia,EURO,0,1528,0,28
2020-06-08,SK,Slovakia,EURO,2,1530,0,28
2020-03-29,SI,Slovenia,EURO,47,733,2,12
2020-03-30,SI,Slovenia,EURO,24,757,1,13
2020-03-31,SI,Slovenia,EURO,48,805,5,18
2020-04-01,SI,Slovenia,EURO,37,842,1,19
2020-04-02,SI,Slovenia,EURO,55,897,1,20
2020-04-03,SI,Slovenia,EURO,40,937,3,23
2020-04-04,SI,Slovenia,EURO,41,978,3,26
2020-04-05,SI,Slovenia,EURO,20,998,4,30
2020-04-06,SI,Slovenia,EURO,23,1021,3,33
2020-04-07,SI,Slovenia,EURO,35,1056,7,40
2020-04-08,SI,Slovenia,EURO,36,1092,2,42
2020-04-09,SI,Slovenia,EURO,33,1125,4,46
2020-04-10,SI,Slovenia,EURO,35,1160,2,48
2020-04-11,SI,Slovenia,EURO,29,1189,6,54
2020-04-12,SI,Slovenia,EURO,17,1206,3,57
2020-04-13,SI,Slovenia,EURO,7,1213,4,61
2020-04-14,SI,Slovenia,EURO,8,1221,3,64
2020-04-15,SI,Slovenia,EURO,27,1248,1,65
2020-04-16,SI,Slovenia,EURO,21,1269,0,65
2020-04-17,SI,Slovenia,EURO,36,1305,6,71
2020-04-18,SI,Slovenia,EURO,13,1318,4,75
2020-04-19,SI,Slovenia,EURO,13,1331,3,78
2020-04-20,SI,Slovenia,EURO,5,1336,5,83
2020-04-21,SI,Slovenia,EURO,9,1345,1,84
2020-04-22,SI,Slovenia,EURO,9,1354,3,87
2020-04-23,SI,Slovenia,EURO,13,1367,0,87
2020-04-24,SI,Slovenia,EURO,7,1374,1,88
2020-04-25,SI,Slovenia,EURO,15,1389,1,89
2020-04-26,SI,Slovenia,EURO,8,1397,1,90
2020-04-27,SI,Slovenia,EURO,6,1403,0,90
2020-04-28,SI,Slovenia,EURO,6,1409,3,93
2020-04-29,SI,Slovenia,EURO,9,1418,3,96
2020-04-30,SI,Slovenia,EURO,11,1429,1,97
2020-05-01,SI,Slovenia,EURO,5,1434,3,100
2020-05-02,SI,Slovenia,EURO,5,1439,2,102
2020-05-03,SI,Slovenia,EURO,0,1439,2,104
2020-05-04,SI,Slovenia,EURO,0,1439,1,105
2020-05-05,SI,Slovenia,EURO,6,1445,0,105
2020-05-06,SI,Slovenia,EURO,3,1448,2,107
2020-05-07,SI,Slovenia,EURO,1,1449,0,107
2020-05-08,SI,Slovenia,EURO,1,1450,1,108
2020-05-09,SI,Slovenia,EURO,4,1454,1,109
2020-05-10,SI,Slovenia,EURO,3,1457,1,110
2020-05-11,SI,Slovenia,EURO,3,1460,0,110
2020-05-12,SI,Slovenia,EURO,1,1461,0,110
2020-05-13,SI,Slovenia,EURO,2,1463,1,111
2020-05-14,SI,Slovenia,EURO,1,1464,0,111
2020-05-15,SI,Slovenia,EURO,1,1465,0,111
2020-05-16,SI,Slovenia,EURO,0,1465,0,111
2020-05-17,SI,Slovenia,EURO,1,1466,0,111
2020-05-18,SI,Slovenia,EURO,0,1466,0,111
2020-05-19,SI,Slovenia,EURO,1,1467,0,111
2020-05-20,SI,Slovenia,EURO,1,1468,1,112
2020-05-21,SI,Slovenia,EURO,0,1468,1,113
2020-05-22,SI,Slovenia,EURO,0,1468,0,113
2020-05-23,SI,Slovenia,EURO,0,1468,0,113
2020-05-24,SI,Slovenia,EURO,0,1468,0,113
2020-05-25,SI,Slovenia,EURO,1,1469,0,113
2020-05-26,SI,Slovenia,EURO,0,1469,0,113
2020-05-27,SI,Slovenia,EURO,2,1471,0,113
2020-05-28,SI,Slovenia,EURO,2,1473,0,113
2020-05-29,SI,Slovenia,EURO,0,1473,0,113
2020-05-30,SI,Slovenia,EURO,0,1473,0,113
2020-05-31,SI,Slovenia,EURO,0,1473,0,113
2020-06-01,SI,Slovenia,EURO,0,1473,0,113
2020-06-02,SI,Slovenia,EURO,2,1475,0,113
2020-06-03,SI,Slovenia,EURO,2,1477,0,113
2020-06-04,SI,Slovenia,EURO,0,1477,0,113
2020-06-05,SI,Slovenia,EURO,2,1479,0,113
2020-06-06,SI,Slovenia,EURO,5,1484,0,113
2020-06-07,SI,Slovenia,EURO,1,1485,0,113
2020-06-08,SI,Slovenia,EURO,0,1485,0,113
2020-03-29,SB,Solomon Islands,WPRO,0,0,0,0
2020-03-30,SB,Solomon Islands,WPRO,0,0,0,0
2020-03-31,SB,Solomon Islands,WPRO,0,0,0,0
2020-04-01,SB,Solomon Islands,WPRO,0,0,0,0
2020-04-02,SB,Solomon Islands,WPRO,0,0,0,0
2020-04-03,SB,Solomon Islands,WPRO,0,0,0,0
2020-04-04,SB,Solomon Islands,WPRO,0,0,0,0
2020-04-05,SB,Solomon Islands,WPRO,0,0,0,0
2020-04-06,SB,Solomon Islands,WPRO,0,0,0,0
2020-04-07,SB,Solomon Islands,WPRO,0,0,0,0
2020-04-08,SB,Solomon Islands,WPRO,0,0,0,0
2020-04-09,SB,Solomon Islands,WPRO,0,0,0,0
2020-04-10,SB,Solomon Islands,WPRO,0,0,0,0
2020-04-11,SB,Solomon Islands,WPRO,0,0,0,0
2020-04-12,SB,Solomon Islands,WPRO,0,0,0,0
2020-04-13,SB,Solomon Islands,WPRO,0,0,0,0
2020-04-14,SB,Solomon Islands,WPRO,0,0,0,0
2020-04-15,SB,Solomon Islands,WPRO,0,0,0,0
2020-04-16,SB,Solomon Islands,WPRO,0,0,0,0
2020-04-17,SB,Solomon Islands,WPRO,0,0,0,0
2020-04-18,SB,Solomon Islands,WPRO,0,0,0,0
2020-04-19,SB,Solomon Islands,WPRO,0,0,0,0
2020-04-20,SB,Solomon Islands,WPRO,0,0,0,0
2020-04-21,SB,Solomon Islands,WPRO,0,0,0,0
2020-04-22,SB,Solomon Islands,WPRO,0,0,0,0
2020-04-23,SB,Solomon Islands,WPRO,0,0,0,0
2020-04-24,SB,Solomon Islands,WPRO,0,0,0,0
2020-04-25,SB,Solomon Islands,WPRO,0,0,0,0
2020-04-26,SB,Solomon Islands,WPRO,0,0,0,0
2020-04-27,SB,Solomon Islands,WPRO,0,0,0,0
2020-04-28,SB,Solomon Islands,WPRO,0,0,0,0
2020-04-29,SB,Solomon Islands,WPRO,0,0,0,0
2020-04-30,SB,Solomon Islands,WPRO,0,0,0,0
2020-05-01,SB,Solomon Islands,WPRO,0,0,0,0
2020-05-02,SB,Solomon Islands,WPRO,0,0,0,0
2020-05-03,SB,Solomon Islands,WPRO,0,0,0,0
2020-05-04,SB,Solomon Islands,WPRO,0,0,0,0
2020-05-05,SB,Solomon Islands,WPRO,0,0,0,0
2020-05-06,SB,Solomon Islands,WPRO,0,0,0,0
2020-05-07,SB,Solomon Islands,WPRO,0,0,0,0
2020-05-08,SB,Solomon Islands,WPRO,0,0,0,0
2020-05-09,SB,Solomon Islands,WPRO,0,0,0,0
2020-05-10,SB,Solomon Islands,WPRO,0,0,0,0
2020-05-11,SB,Solomon Islands,WPRO,0,0,0,0
2020-05-12,SB,Solomon Islands,WPRO,0,0,0,0
2020-05-13,SB,Solomon Islands,WPRO,0,0,0,0
2020-05-14,SB,Solomon Islands,WPRO,0,0,0,0
2020-05-15,SB,Solomon Islands,WPRO,0,0,0,0
2020-05-16,SB,Solomon Islands,WPRO,0,0,0,0
2020-05-17,SB,Solomon Islands,WPRO,0,0,0,0
2020-05-18,SB,Solomon Islands,WPRO,0,0,0,0
2020-05-19,SB,Solomon Islands,WPRO,0,0,0,0
2020-05-20,SB,Solomon Islands,WPRO,0,0,0,0
2020-05-21,SB,Solomon Islands,WPRO,0,0,0,0
2020-05-22,SB,Solomon Islands,WPRO,0,0,0,0
2020-05-23,SB,Solomon Islands,WPRO,0,0,0,0
2020-05-24,SB,Solomon Islands,WPRO,0,0,0,0
2020-05-25,SB,Solomon Islands,WPRO,0,0,0,0
2020-05-26,SB,Solomon Islands,WPRO,0,0,0,0
2020-05-27,SB,Solomon Islands,WPRO,0,0,0,0
2020-05-28,SB,Solomon Islands,WPRO,0,0,0,0
2020-05-29,SB,Solomon Islands,WPRO,0,0,0,0
2020-05-30,SB,Solomon Islands,WPRO,0,0,0,0
2020-05-31,SB,Solomon Islands,WPRO,0,0,0,0
2020-06-01,SB,Solomon Islands,WPRO,0,0,0,0
2020-06-02,SB,Solomon Islands,WPRO,0,0,0,0
2020-06-03,SB,Solomon Islands,WPRO,0,0,0,0
2020-06-04,SB,Solomon Islands,WPRO,0,0,0,0
2020-06-05,SB,Solomon Islands,WPRO,0,0,0,0
2020-06-06,SB,Solomon Islands,WPRO,0,0,0,0
2020-06-07,SB,Solomon Islands,WPRO,0,0,0,0
2020-06-08,SB,Solomon Islands,WPRO,0,0,0,0
2020-03-29,SO,Somalia,EMRO,0,3,0,0
2020-03-30,SO,Somalia,EMRO,0,3,0,0
2020-03-31,SO,Somalia,EMRO,0,3,0,0
2020-04-01,SO,Somalia,EMRO,2,5,0,0
2020-04-02,SO,Somalia,EMRO,0,5,0,0
2020-04-03,SO,Somalia,EMRO,0,5,0,0
2020-04-04,SO,Somalia,EMRO,2,7,0,0
2020-04-05,SO,Somalia,EMRO,0,7,0,0
2020-04-06,SO,Somalia,EMRO,0,7,0,0
2020-04-07,SO,Somalia,EMRO,0,7,0,0
2020-04-08,SO,Somalia,EMRO,1,8,0,0
2020-04-09,SO,Somalia,EMRO,4,12,0,0
2020-04-10,SO,Somalia,EMRO,0,12,1,1
2020-04-11,SO,Somalia,EMRO,9,21,0,1
2020-04-12,SO,Somalia,EMRO,0,21,0,1
2020-04-13,SO,Somalia,EMRO,4,25,1,2
2020-04-14,SO,Somalia,EMRO,35,60,0,2
2020-04-15,SO,Somalia,EMRO,0,60,0,2
2020-04-16,SO,Somalia,EMRO,20,80,3,5
2020-04-17,SO,Somalia,EMRO,0,80,0,5
2020-04-18,SO,Somalia,EMRO,36,116,0,5
2020-04-19,SO,Somalia,EMRO,19,135,2,7
2020-04-20,SO,Somalia,EMRO,29,164,0,7
2020-04-21,SO,Somalia,EMRO,73,237,1,8
2020-04-22,SO,Somalia,EMRO,49,286,6,14
2020-04-23,SO,Somalia,EMRO,0,286,0,14
2020-04-24,SO,Somalia,EMRO,42,328,2,16
2020-04-25,SO,Somalia,EMRO,0,328,0,16
2020-04-26,SO,Somalia,EMRO,62,390,2,18
2020-04-27,SO,Somalia,EMRO,46,436,5,23
2020-04-28,SO,Somalia,EMRO,44,480,3,26
2020-04-29,SO,Somalia,EMRO,48,528,2,28
2020-04-30,SO,Somalia,EMRO,54,582,0,28
2020-05-01,SO,Somalia,EMRO,19,601,0,28
2020-05-02,SO,Somalia,EMRO,0,601,0,28
2020-05-03,SO,Somalia,EMRO,70,671,3,31
2020-05-04,SO,Somalia,EMRO,51,722,1,32
2020-05-05,SO,Somalia,EMRO,34,756,3,35
2020-05-06,SO,Somalia,EMRO,79,835,3,38
2020-05-07,SO,Somalia,EMRO,38,873,1,39
2020-05-08,SO,Somalia,EMRO,55,928,5,44
2020-05-09,SO,Somalia,EMRO,0,928,0,44
2020-05-10,SO,Somalia,EMRO,69,997,4,48
2020-05-11,SO,Somalia,EMRO,57,1054,3,51
2020-05-12,SO,Somalia,EMRO,35,1089,1,52
2020-05-13,SO,Somalia,EMRO,81,1170,0,52
2020-05-14,SO,Somalia,EMRO,49,1219,0,52
2020-05-15,SO,Somalia,EMRO,65,1284,1,53
2020-05-16,SO,Somalia,EMRO,0,1284,0,53
2020-05-17,SO,Somalia,EMRO,73,1357,2,55
2020-05-18,SO,Somalia,EMRO,64,1421,1,56
2020-05-19,SO,Somalia,EMRO,34,1455,1,57
2020-05-20,SO,Somalia,EMRO,47,1502,2,59
2020-05-21,SO,Somalia,EMRO,71,1573,2,61
2020-05-22,SO,Somalia,EMRO,21,1594,0,61
2020-05-23,SO,Somalia,EMRO,0,1594,0,61
2020-05-24,SO,Somalia,EMRO,0,1594,0,61
2020-05-25,SO,Somalia,EMRO,0,1594,0,61
2020-05-26,SO,Somalia,EMRO,95,1689,5,66
2020-05-27,SO,Somalia,EMRO,22,1711,1,67
2020-05-28,SO,Somalia,EMRO,20,1731,0,67
2020-05-29,SO,Somalia,EMRO,97,1828,5,72
2020-05-30,SO,Somalia,EMRO,0,1828,0,72
2020-05-31,SO,Somalia,EMRO,88,1916,1,73
2020-06-01,SO,Somalia,EMRO,60,1976,5,78
2020-06-02,SO,Somalia,EMRO,47,2023,1,79
2020-06-03,SO,Somalia,EMRO,66,2089,0,79
2020-06-04,SO,Somalia,EMRO,57,2146,0,79
2020-06-05,SO,Somalia,EMRO,58,2204,0,79
2020-06-06,SO,Somalia,EMRO,0,2204,0,79
2020-06-07,SO,Somalia,EMRO,85,2289,3,82
2020-06-08,SO,Somalia,EMRO,45,2334,1,83
2020-03-29,ZA,South Africa,AFRO,17,1187,0,1
2020-03-30,ZA,South Africa,AFRO,93,1280,1,2
2020-03-31,ZA,South Africa,AFRO,46,1326,0,2
2020-04-01,ZA,South Africa,AFRO,27,1353,3,5
2020-04-02,ZA,South Africa,AFRO,27,1380,0,5
2020-04-03,ZA,South Africa,AFRO,82,1462,0,5
2020-04-04,ZA,South Africa,AFRO,43,1505,2,7
2020-04-05,ZA,South Africa,AFRO,80,1585,2,9
2020-04-06,ZA,South Africa,AFRO,70,1655,2,11
2020-04-07,ZA,South Africa,AFRO,31,1686,1,12
2020-04-08,ZA,South Africa,AFRO,63,1749,1,13
2020-04-09,ZA,South Africa,AFRO,96,1845,5,18
2020-04-10,ZA,South Africa,AFRO,89,1934,1,19
2020-04-11,ZA,South Africa,AFRO,69,2003,8,27
2020-04-12,ZA,South Africa,AFRO,25,2028,1,28
2020-04-13,ZA,South Africa,AFRO,145,2173,1,29
2020-04-14,ZA,South Africa,AFRO,99,2272,5,34
2020-04-15,ZA,South Africa,AFRO,143,2415,0,34
2020-04-16,ZA,South Africa,AFRO,91,2506,0,34
2020-04-17,ZA,South Africa,AFRO,99,2605,14,48
2020-04-18,ZA,South Africa,AFRO,178,2783,2,50
2020-04-19,ZA,South Africa,AFRO,251,3034,2,52
2020-04-20,ZA,South Africa,AFRO,124,3158,2,54
2020-04-21,ZA,South Africa,AFRO,142,3300,4,58
2020-04-22,ZA,South Africa,AFRO,165,3465,0,58
2020-04-23,ZA,South Africa,AFRO,170,3635,7,65
2020-04-24,ZA,South Africa,AFRO,318,3953,10,75
2020-04-25,ZA,South Africa,AFRO,267,4220,4,79
2020-04-26,ZA,South Africa,AFRO,141,4361,7,86
2020-04-27,ZA,South Africa,AFRO,185,4546,1,87
2020-04-28,ZA,South Africa,AFRO,247,4793,3,90
2020-04-29,ZA,South Africa,AFRO,203,4996,3,93
2020-04-30,ZA,South Africa,AFRO,354,5350,10,103
2020-05-01,ZA,South Africa,AFRO,297,5647,0,103
2020-05-02,ZA,South Africa,AFRO,304,5951,13,116
2020-05-03,ZA,South Africa,AFRO,385,6336,7,123
2020-05-04,ZA,South Africa,AFRO,447,6783,8,131
2020-05-05,ZA,South Africa,AFRO,437,7220,7,138
2020-05-06,ZA,South Africa,AFRO,352,7572,10,148
2020-05-07,ZA,South Africa,AFRO,236,7808,5,153
2020-05-08,ZA,South Africa,AFRO,424,8232,8,161
2020-05-09,ZA,South Africa,AFRO,663,8895,17,178
2020-05-10,ZA,South Africa,AFRO,525,9420,8,186
2020-05-11,ZA,South Africa,AFRO,595,10015,8,194
2020-05-12,ZA,South Africa,AFRO,637,10652,12,206
2020-05-13,ZA,South Africa,AFRO,698,11350,0,206
2020-05-14,ZA,South Africa,AFRO,724,12074,13,219
2020-05-15,ZA,South Africa,AFRO,665,12739,19,238
2020-05-16,ZA,South Africa,AFRO,785,13524,9,247
2020-05-17,ZA,South Africa,AFRO,831,14355,14,261
2020-05-18,ZA,South Africa,AFRO,1160,15515,3,264
2020-05-19,ZA,South Africa,AFRO,918,16433,22,286
2020-05-20,ZA,South Africa,AFRO,767,17200,26,312
2020-05-21,ZA,South Africa,AFRO,803,18003,27,339
2020-05-22,ZA,South Africa,AFRO,1134,19137,30,369
2020-05-23,ZA,South Africa,AFRO,988,20125,28,397
2020-05-24,ZA,South Africa,AFRO,1218,21343,10,407
2020-05-25,ZA,South Africa,AFRO,1240,22583,22,429
2020-05-26,ZA,South Africa,AFRO,1032,23615,52,481
2020-05-27,ZA,South Africa,AFRO,649,24264,43,524
2020-05-28,ZA,South Africa,AFRO,1673,25937,28,552
2020-05-29,ZA,South Africa,AFRO,1466,27403,25,577
2020-05-30,ZA,South Africa,AFRO,1837,29240,34,611
2020-05-31,ZA,South Africa,AFRO,1727,30967,32,643
2020-06-01,ZA,South Africa,AFRO,1716,32683,40,683
2020-06-02,ZA,South Africa,AFRO,1674,34357,137,820
2020-06-03,ZA,South Africa,AFRO,1455,35812,153,973
2020-06-04,ZA,South Africa,AFRO,1713,37525,112,1085
2020-06-05,ZA,South Africa,AFRO,3267,40792,203,1288
2020-06-06,ZA,South Africa,AFRO,2642,43434,173,1461
2020-06-07,ZA,South Africa,AFRO,2539,45973,194,1655
2020-06-08,ZA,South Africa,AFRO,2312,48285,102,1757
2020-03-29,SS,South Sudan,AFRO,0,1,0,6
2020-03-30,SS,South Sudan,AFRO,0,1,0,6
2020-03-31,SS,South Sudan,AFRO,0,1,0,6
2020-04-01,SS,South Sudan,AFRO,0,1,0,6
2020-04-02,SS,South Sudan,AFRO,0,1,0,6
2020-04-03,SS,South Sudan,AFRO,0,1,0,6
2020-04-04,SS,South Sudan,AFRO,0,1,0,6
2020-04-05,SS,South Sudan,AFRO,0,1,0,6
2020-04-06,SS,South Sudan,AFRO,0,1,0,6
2020-04-07,SS,South Sudan,AFRO,0,1,0,6
2020-04-08,SS,South Sudan,AFRO,1,2,0,6
2020-04-09,SS,South Sudan,AFRO,1,3,0,6
2020-04-10,SS,South Sudan,AFRO,0,3,0,6
2020-04-11,SS,South Sudan,AFRO,1,4,0,6
2020-04-12,SS,South Sudan,AFRO,0,4,0,6
2020-04-13,SS,South Sudan,AFRO,0,4,0,6
2020-04-14,SS,South Sudan,AFRO,0,4,0,6
2020-04-15,SS,South Sudan,AFRO,0,4,0,6
2020-04-16,SS,South Sudan,AFRO,0,4,0,6
2020-04-17,SS,South Sudan,AFRO,0,4,0,6
2020-04-18,SS,South Sudan,AFRO,0,4,0,6
2020-04-19,SS,South Sudan,AFRO,0,4,0,6
2020-04-20,SS,South Sudan,AFRO,0,4,0,6
2020-04-21,SS,South Sudan,AFRO,0,4,0,6
2020-04-22,SS,South Sudan,AFRO,0,4,0,6
2020-04-23,SS,South Sudan,AFRO,0,4,0,6
2020-04-24,SS,South Sudan,AFRO,1,5,0,6
2020-04-25,SS,South Sudan,AFRO,0,5,0,6
2020-04-26,SS,South Sudan,AFRO,1,6,0,6
2020-04-27,SS,South Sudan,AFRO,0,6,0,6
2020-04-28,SS,South Sudan,AFRO,0,6,0,6
2020-04-29,SS,South Sudan,AFRO,28,34,0,6
2020-04-30,SS,South Sudan,AFRO,1,35,0,6
2020-05-01,SS,South Sudan,AFRO,0,35,0,6
2020-05-02,SS,South Sudan,AFRO,10,45,0,6
2020-05-03,SS,South Sudan,AFRO,1,46,0,6
2020-05-04,SS,South Sudan,AFRO,3,49,0,6
2020-05-05,SS,South Sudan,AFRO,3,52,0,6
2020-05-06,SS,South Sudan,AFRO,6,58,0,6
2020-05-07,SS,South Sudan,AFRO,16,74,0,6
2020-05-08,SS,South Sudan,AFRO,16,90,0,6
2020-05-09,SS,South Sudan,AFRO,30,120,0,6
2020-05-10,SS,South Sudan,AFRO,0,120,0,6
2020-05-11,SS,South Sudan,AFRO,36,156,0,6
2020-05-12,SS,South Sudan,AFRO,18,174,0,6
2020-05-13,SS,South Sudan,AFRO,20,194,0,6
2020-05-14,SS,South Sudan,AFRO,9,203,0,6
2020-05-15,SS,South Sudan,AFRO,79,282,0,6
2020-05-16,SS,South Sudan,AFRO,0,282,0,6
2020-05-17,SS,South Sudan,AFRO,3,285,0,6
2020-05-18,SS,South Sudan,AFRO,0,285,0,6
2020-05-19,SS,South Sudan,AFRO,57,342,2,8
2020-05-20,SS,South Sudan,AFRO,66,408,0,8
2020-05-21,SS,South Sudan,AFRO,73,481,0,8
2020-05-22,SS,South Sudan,AFRO,0,481,0,8
2020-05-23,SS,South Sudan,AFRO,82,563,0,8
2020-05-24,SS,South Sudan,AFRO,92,655,2,10
2020-05-25,SS,South Sudan,AFRO,137,792,0,10
2020-05-26,SS,South Sudan,AFRO,14,806,0,10
2020-05-27,SS,South Sudan,AFRO,0,806,0,10
2020-05-28,SS,South Sudan,AFRO,188,994,2,12
2020-05-29,SS,South Sudan,AFRO,0,994,0,12
2020-05-30,SS,South Sudan,AFRO,76,1070,1,13
2020-05-31,SS,South Sudan,AFRO,77,1147,1,14
2020-06-01,SS,South Sudan,AFRO,0,1147,0,14
2020-06-02,SS,South Sudan,AFRO,104,1251,1,15
2020-06-03,SS,South Sudan,AFRO,66,1317,1,16
2020-06-04,SS,South Sudan,AFRO,39,1356,0,16
2020-06-05,SS,South Sudan,AFRO,39,1395,0,16
2020-06-06,SS,South Sudan,AFRO,39,1434,6,22
2020-06-07,SS,South Sudan,AFRO,39,1473,0,22
2020-06-08,SS,South Sudan,AFRO,65,1538,0,22
2020-03-29,ES,Spain,EURO,9096,96214,909,6927
2020-03-30,ES,Spain,EURO,7100,103314,839,7766
2020-03-31,ES,Spain,EURO,5093,108407,811,8577
2020-04-01,ES,Spain,EURO,8010,116417,913,9490
2020-04-02,ES,Spain,EURO,7926,124343,899,10389
2020-04-03,ES,Spain,EURO,7065,131408,895,11284
2020-04-04,ES,Spain,EURO,6910,138318,858,12142
2020-04-05,ES,Spain,EURO,6822,145140,786,12928
2020-04-06,ES,Spain,EURO,4672,149812,740,13668
2020-04-07,ES,Spain,EURO,3147,152959,750,14418
2020-04-08,ES,Spain,EURO,5400,158359,766,15184
2020-04-09,ES,Spain,EURO,5323,163682,736,15920
2020-04-10,ES,Spain,EURO,5488,169170,749,16669
2020-04-11,ES,Spain,EURO,4612,173782,667,17336
2020-04-12,ES,Spain,EURO,4441,178223,676,18012
2020-04-13,ES,Spain,EURO,3075,181298,628,18640
2020-04-14,ES,Spain,EURO,2379,183677,544,19184
2020-04-15,ES,Spain,EURO,3128,186805,587,19771
2020-04-16,ES,Spain,EURO,3996,190801,607,20378
2020-04-17,ES,Spain,EURO,3702,194503,552,20930
2020-04-18,ES,Spain,EURO,3417,197920,487,21417
2020-04-19,ES,Spain,EURO,3462,201382,507,21924
2020-04-20,ES,Spain,EURO,2182,203564,435,22359
2020-04-21,ES,Spain,EURO,1445,205009,401,22760
2020-04-22,ES,Spain,EURO,2518,207527,387,23147
2020-04-23,ES,Spain,EURO,2729,210256,427,23574
2020-04-24,ES,Spain,EURO,2769,213025,344,23918
2020-04-25,ES,Spain,EURO,2223,215248,331,24249
2020-04-26,ES,Spain,EURO,2286,217534,330,24579
2020-04-27,ES,Spain,EURO,1290,218824,295,24874
2020-04-28,ES,Spain,EURO,820,219644,272,25146
2020-04-29,ES,Spain,EURO,1653,221297,258,25404
2020-04-30,ES,Spain,EURO,1737,223034,259,25663
2020-05-01,ES,Spain,EURO,1484,224518,236,25899
2020-05-02,ES,Spain,EURO,1439,225957,223,26122
2020-05-03,ES,Spain,EURO,793,226750,176,26298
2020-05-04,ES,Spain,EURO,566,227316,202,26500
2020-05-05,ES,Spain,EURO,452,227768,197,26697
2020-05-06,ES,Spain,EURO,1013,228781,186,26883
2020-05-07,ES,Spain,EURO,982,229763,183,27066
2020-05-08,ES,Spain,EURO,984,230747,153,27219
2020-05-09,ES,Spain,EURO,956,231703,166,27385
2020-05-10,ES,Spain,EURO,918,232621,146,27531
2020-05-11,ES,Spain,EURO,491,233112,125,27656
2020-05-12,ES,Spain,EURO,316,233428,110,27766
2020-05-13,ES,Spain,EURO,1288,234716,122,27888
2020-05-14,ES,Spain,EURO,734,235450,114,28002
2020-05-15,ES,Spain,EURO,810,236260,87,28089
2020-05-16,ES,Spain,EURO,788,237048,87,28176
2020-05-17,ES,Spain,EURO,800,237848,77,28253
2020-05-18,ES,Spain,EURO,349,238197,63,28316
2020-05-19,ES,Spain,EURO,244,238441,61,28377
2020-05-20,ES,Spain,EURO,634,239075,72,28449
2020-05-21,ES,Spain,EURO,855,239930,70,28519
2020-05-22,ES,Spain,EURO,751,240681,57,28576
2020-05-23,ES,Spain,EURO,781,241462,69,28645
2020-05-24,ES,Spain,EURO,824,242286,71,28716
2020-05-25,ES,Spain,EURO,315,242601,60,28776
2020-05-26,ES,Spain,EURO,262,242863,55,28831
2020-05-27,ES,Spain,EURO,550,243413,68,28899
2020-05-28,ES,Spain,EURO,743,244156,54,28953
2020-05-29,ES,Spain,EURO,622,244778,46,28999
2020-05-30,ES,Spain,EURO,661,245439,44,29043
2020-05-31,ES,Spain,EURO,735,246174,45,29088
2020-06-01,ES,Spain,EURO,338,246512,43,29131
2020-06-02,ES,Spain,EURO,183,246695,40,29171
2020-06-03,ES,Spain,EURO,363,247058,34,29205
2020-06-04,ES,Spain,EURO,479,247537,47,29252
2020-06-05,ES,Spain,EURO,606,248143,39,29291
2020-06-06,ES,Spain,EURO,519,248662,48,29339
2020-06-07,ES,Spain,EURO,652,249314,24,29363
2020-06-08,ES,Spain,EURO,275,249589,29,29392
2020-03-29,LK,Sri Lanka,SEARO,9,115,1,1
2020-03-30,LK,Sri Lanka,SEARO,5,120,0,1
2020-03-31,LK,Sri Lanka,SEARO,2,122,1,2
2020-04-01,LK,Sri Lanka,SEARO,21,143,0,2
2020-04-02,LK,Sri Lanka,SEARO,5,148,1,3
2020-04-03,LK,Sri Lanka,SEARO,3,151,1,4
2020-04-04,LK,Sri Lanka,SEARO,8,159,1,5
2020-04-05,LK,Sri Lanka,SEARO,7,166,0,5
2020-04-06,LK,Sri Lanka,SEARO,10,176,0,5
2020-04-07,LK,Sri Lanka,SEARO,4,180,1,6
2020-04-08,LK,Sri Lanka,SEARO,6,186,-6,0
2020-04-09,LK,Sri Lanka,SEARO,3,189,7,7
2020-04-10,LK,Sri Lanka,SEARO,1,190,0,7
2020-04-11,LK,Sri Lanka,SEARO,7,197,0,7
2020-04-12,LK,Sri Lanka,SEARO,2,199,0,7
2020-04-13,LK,Sri Lanka,SEARO,11,210,0,7
2020-04-14,LK,Sri Lanka,SEARO,8,218,0,7
2020-04-15,LK,Sri Lanka,SEARO,15,233,0,7
2020-04-16,LK,Sri Lanka,SEARO,5,238,0,7
2020-04-17,LK,Sri Lanka,SEARO,0,238,0,7
2020-04-18,LK,Sri Lanka,SEARO,6,244,0,7
2020-04-19,LK,Sri Lanka,SEARO,10,254,0,7
2020-04-20,LK,Sri Lanka,SEARO,17,271,0,7
2020-04-21,LK,Sri Lanka,SEARO,33,304,0,7
2020-04-22,LK,Sri Lanka,SEARO,6,310,0,7
2020-04-23,LK,Sri Lanka,SEARO,20,330,0,7
2020-04-24,LK,Sri Lanka,SEARO,38,368,0,7
2020-04-25,LK,Sri Lanka,SEARO,52,420,0,7
2020-04-26,LK,Sri Lanka,SEARO,40,460,0,7
2020-04-27,LK,Sri Lanka,SEARO,63,523,0,7
2020-04-28,LK,Sri Lanka,SEARO,65,588,0,7
2020-04-29,LK,Sri Lanka,SEARO,31,619,0,7
2020-04-30,LK,Sri Lanka,SEARO,30,649,0,7
2020-05-01,LK,Sri Lanka,SEARO,16,665,0,7
2020-05-02,LK,Sri Lanka,SEARO,25,690,0,7
2020-05-03,LK,Sri Lanka,SEARO,15,705,0,7
2020-05-04,LK,Sri Lanka,SEARO,13,718,1,8
2020-05-05,LK,Sri Lanka,SEARO,37,755,0,8
2020-05-06,LK,Sri Lanka,SEARO,16,771,1,9
2020-05-07,LK,Sri Lanka,SEARO,26,797,0,9
2020-05-08,LK,Sri Lanka,SEARO,27,824,0,9
2020-05-09,LK,Sri Lanka,SEARO,11,835,0,9
2020-05-10,LK,Sri Lanka,SEARO,12,847,0,9
2020-05-11,LK,Sri Lanka,SEARO,16,863,0,9
2020-05-12,LK,Sri Lanka,SEARO,26,889,0,9
2020-05-13,LK,Sri Lanka,SEARO,26,915,0,9
2020-05-14,LK,Sri Lanka,SEARO,10,925,0,9
2020-05-15,LK,Sri Lanka,SEARO,10,935,0,9
2020-05-16,LK,Sri Lanka,SEARO,25,960,0,9
2020-05-17,LK,Sri Lanka,SEARO,21,981,0,9
2020-05-18,LK,Sri Lanka,SEARO,11,992,0,9
2020-05-19,LK,Sri Lanka,SEARO,35,1027,0,9
2020-05-20,LK,Sri Lanka,SEARO,1,1028,0,9
2020-05-21,LK,Sri Lanka,SEARO,27,1055,0,9
2020-05-22,LK,Sri Lanka,SEARO,13,1068,0,9
2020-05-23,LK,Sri Lanka,SEARO,21,1089,0,9
2020-05-24,LK,Sri Lanka,SEARO,52,1141,0,9
2020-05-25,LK,Sri Lanka,SEARO,41,1182,1,10
2020-05-26,LK,Sri Lanka,SEARO,137,1319,0,10
2020-05-27,LK,Sri Lanka,SEARO,150,1469,0,10
2020-05-28,LK,Sri Lanka,SEARO,61,1530,0,10
2020-05-29,LK,Sri Lanka,SEARO,28,1558,0,10
2020-05-30,LK,Sri Lanka,SEARO,62,1620,0,10
2020-05-31,LK,Sri Lanka,SEARO,13,1633,0,10
2020-06-01,LK,Sri Lanka,SEARO,10,1643,1,11
2020-06-02,LK,Sri Lanka,SEARO,40,1683,0,11
2020-06-03,LK,Sri Lanka,SEARO,66,1749,0,11
2020-06-04,LK,Sri Lanka,SEARO,48,1797,0,11
2020-06-05,LK,Sri Lanka,SEARO,4,1801,0,11
2020-06-06,LK,Sri Lanka,SEARO,13,1814,0,11
2020-06-07,LK,Sri Lanka,SEARO,21,1835,0,11
2020-06-08,LK,Sri Lanka,SEARO,22,1857,0,11
2020-03-29,SD,Sudan,EMRO,2,5,0,1
2020-03-30,SD,Sudan,EMRO,1,6,1,2
2020-03-31,SD,Sudan,EMRO,0,6,0,2
2020-04-01,SD,Sudan,EMRO,1,7,0,2
2020-04-02,SD,Sudan,EMRO,0,7,0,2
2020-04-03,SD,Sudan,EMRO,0,7,0,2
2020-04-04,SD,Sudan,EMRO,3,10,0,2
2020-04-05,SD,Sudan,EMRO,0,10,0,2
2020-04-06,SD,Sudan,EMRO,2,12,0,2
2020-04-07,SD,Sudan,EMRO,0,12,0,2
2020-04-08,SD,Sudan,EMRO,2,14,0,2
2020-04-09,SD,Sudan,EMRO,0,14,0,2
2020-04-10,SD,Sudan,EMRO,0,14,0,2
2020-04-11,SD,Sudan,EMRO,1,15,0,2
2020-04-12,SD,Sudan,EMRO,4,19,0,2
2020-04-13,SD,Sudan,EMRO,0,19,0,2
2020-04-14,SD,Sudan,EMRO,10,29,2,4
2020-04-15,SD,Sudan,EMRO,3,32,1,5
2020-04-16,SD,Sudan,EMRO,0,32,0,5
2020-04-17,SD,Sudan,EMRO,0,32,0,5
2020-04-18,SD,Sudan,EMRO,1,33,1,6
2020-04-19,SD,Sudan,EMRO,33,66,4,10
2020-04-20,SD,Sudan,EMRO,0,66,0,10
2020-04-21,SD,Sudan,EMRO,41,107,2,12
2020-04-22,SD,Sudan,EMRO,0,107,0,12
2020-04-23,SD,Sudan,EMRO,33,140,1,13
2020-04-24,SD,Sudan,EMRO,22,162,0,13
2020-04-25,SD,Sudan,EMRO,12,174,3,16
2020-04-26,SD,Sudan,EMRO,39,213,1,17
2020-04-27,SD,Sudan,EMRO,24,237,4,21
2020-04-28,SD,Sudan,EMRO,38,275,1,22
2020-04-29,SD,Sudan,EMRO,43,318,3,25
2020-04-30,SD,Sudan,EMRO,57,375,3,28
2020-05-01,SD,Sudan,EMRO,67,442,3,31
2020-05-02,SD,Sudan,EMRO,91,533,5,36
2020-05-03,SD,Sudan,EMRO,59,592,5,41
2020-05-04,SD,Sudan,EMRO,0,592,0,41
2020-05-05,SD,Sudan,EMRO,86,678,4,45
2020-05-06,SD,Sudan,EMRO,100,778,4,49
2020-05-07,SD,Sudan,EMRO,74,852,4,53
2020-05-08,SD,Sudan,EMRO,78,930,3,56
2020-05-09,SD,Sudan,EMRO,181,1111,7,63
2020-05-10,SD,Sudan,EMRO,53,1164,5,68
2020-05-11,SD,Sudan,EMRO,201,1365,6,74
2020-05-12,SD,Sudan,EMRO,161,1526,4,78
2020-05-13,SD,Sudan,EMRO,135,1661,6,84
2020-05-14,SD,Sudan,EMRO,157,1818,10,94
2020-05-15,SD,Sudan,EMRO,146,1964,1,95
2020-05-16,SD,Sudan,EMRO,0,1964,0,95
2020-05-17,SD,Sudan,EMRO,325,2289,6,101
2020-05-18,SD,Sudan,EMRO,302,2591,8,109
2020-05-19,SD,Sudan,EMRO,0,2591,0,109
2020-05-20,SD,Sudan,EMRO,137,2728,6,115
2020-05-21,SD,Sudan,EMRO,410,3138,9,124
2020-05-22,SD,Sudan,EMRO,0,3138,0,124
2020-05-23,SD,Sudan,EMRO,240,3378,13,137
2020-05-24,SD,Sudan,EMRO,256,3634,9,146
2020-05-25,SD,Sudan,EMRO,192,3826,19,165
2020-05-26,SD,Sudan,EMRO,150,3976,5,170
2020-05-27,SD,Sudan,EMRO,170,4146,14,184
2020-05-28,SD,Sudan,EMRO,200,4346,11,195
2020-05-29,SD,Sudan,EMRO,0,4346,0,195
2020-05-30,SD,Sudan,EMRO,175,4521,38,233
2020-05-31,SD,Sudan,EMRO,279,4800,29,262
2020-06-01,SD,Sudan,EMRO,226,5026,24,286
2020-06-02,SD,Sudan,EMRO,147,5173,12,298
2020-06-03,SD,Sudan,EMRO,137,5310,9,307
2020-06-04,SD,Sudan,EMRO,189,5499,7,314
2020-06-05,SD,Sudan,EMRO,215,5714,19,333
2020-06-06,SD,Sudan,EMRO,152,5866,14,347
2020-06-07,SD,Sudan,EMRO,215,6081,12,359
2020-06-08,SD,Sudan,EMRO,0,6081,0,359
2020-03-29,SR,Suriname,AMRO,0,8,0,0
2020-03-30,SR,Suriname,AMRO,0,8,0,0
2020-03-31,SR,Suriname,AMRO,0,8,0,0
2020-04-01,SR,Suriname,AMRO,0,8,0,0
2020-04-02,SR,Suriname,AMRO,0,8,0,0
2020-04-03,SR,Suriname,AMRO,0,8,0,0
2020-04-04,SR,Suriname,AMRO,2,10,0,0
2020-04-05,SR,Suriname,AMRO,0,10,0,0
2020-04-06,SR,Suriname,AMRO,0,10,0,0
2020-04-07,SR,Suriname,AMRO,0,10,1,1
2020-04-08,SR,Suriname,AMRO,0,10,0,1
2020-04-09,SR,Suriname,AMRO,0,10,0,1
2020-04-10,SR,Suriname,AMRO,0,10,0,1
2020-04-11,SR,Suriname,AMRO,0,10,0,1
2020-04-12,SR,Suriname,AMRO,0,10,0,1
2020-04-13,SR,Suriname,AMRO,0,10,0,1
2020-04-14,SR,Suriname,AMRO,0,10,0,1
2020-04-15,SR,Suriname,AMRO,0,10,0,1
2020-04-16,SR,Suriname,AMRO,0,10,0,1
2020-04-17,SR,Suriname,AMRO,0,10,0,1
2020-04-18,SR,Suriname,AMRO,0,10,0,1
2020-04-19,SR,Suriname,AMRO,0,10,0,1
2020-04-20,SR,Suriname,AMRO,0,10,0,1
2020-04-21,SR,Suriname,AMRO,0,10,0,1
2020-04-22,SR,Suriname,AMRO,0,10,0,1
2020-04-23,SR,Suriname,AMRO,0,10,0,1
2020-04-24,SR,Suriname,AMRO,0,10,0,1
2020-04-25,SR,Suriname,AMRO,0,10,0,1
2020-04-26,SR,Suriname,AMRO,0,10,0,1
2020-04-27,SR,Suriname,AMRO,0,10,0,1
2020-04-28,SR,Suriname,AMRO,0,10,0,1
2020-04-29,SR,Suriname,AMRO,0,10,0,1
2020-04-30,SR,Suriname,AMRO,0,10,0,1
2020-05-01,SR,Suriname,AMRO,0,10,0,1
2020-05-02,SR,Suriname,AMRO,0,10,0,1
2020-05-03,SR,Suriname,AMRO,0,10,0,1
2020-05-04,SR,Suriname,AMRO,0,10,0,1
2020-05-05,SR,Suriname,AMRO,0,10,0,1
2020-05-06,SR,Suriname,AMRO,0,10,0,1
2020-05-07,SR,Suriname,AMRO,0,10,0,1
2020-05-08,SR,Suriname,AMRO,0,10,0,1
2020-05-09,SR,Suriname,AMRO,0,10,0,1
2020-05-10,SR,Suriname,AMRO,0,10,0,1
2020-05-11,SR,Suriname,AMRO,0,10,0,1
2020-05-12,SR,Suriname,AMRO,0,10,0,1
2020-05-13,SR,Suriname,AMRO,0,10,0,1
2020-05-14,SR,Suriname,AMRO,0,10,0,1
2020-05-15,SR,Suriname,AMRO,0,10,0,1
2020-05-16,SR,Suriname,AMRO,0,10,0,1
2020-05-17,SR,Suriname,AMRO,0,10,0,1
2020-05-18,SR,Suriname,AMRO,0,10,0,1
2020-05-19,SR,Suriname,AMRO,1,11,0,1
2020-05-20,SR,Suriname,AMRO,0,11,0,1
2020-05-21,SR,Suriname,AMRO,0,11,0,1
2020-05-22,SR,Suriname,AMRO,0,11,0,1
2020-05-23,SR,Suriname,AMRO,0,11,0,1
2020-05-24,SR,Suriname,AMRO,0,11,0,1
2020-05-25,SR,Suriname,AMRO,0,11,0,1
2020-05-26,SR,Suriname,AMRO,0,11,0,1
2020-05-27,SR,Suriname,AMRO,0,11,0,1
2020-05-28,SR,Suriname,AMRO,0,11,0,1
2020-05-29,SR,Suriname,AMRO,1,12,0,1
2020-05-30,SR,Suriname,AMRO,0,12,0,1
2020-05-31,SR,Suriname,AMRO,0,12,0,1
2020-06-01,SR,Suriname,AMRO,2,14,0,1
2020-06-02,SR,Suriname,AMRO,13,27,0,1
2020-06-03,SR,Suriname,AMRO,26,53,0,1
2020-06-04,SR,Suriname,AMRO,1,54,0,1
2020-06-05,SR,Suriname,AMRO,28,82,0,1
2020-06-06,SR,Suriname,AMRO,0,82,0,1
2020-06-07,SR,Suriname,AMRO,8,90,0,1
2020-06-08,SR,Suriname,AMRO,11,101,0,1
2020-03-29,SE,Sweden,EURO,300,3664,35,201
2020-03-30,SE,Sweden,EURO,280,3944,38,239
2020-03-31,SE,Sweden,EURO,416,4360,45,284
2020-04-01,SE,Sweden,EURO,474,4834,48,332
2020-04-02,SE,Sweden,EURO,486,5320,53,385
2020-04-03,SE,Sweden,EURO,554,5874,70,455
2020-04-04,SE,Sweden,EURO,602,6476,80,535
2020-04-05,SE,Sweden,EURO,357,6833,70,605
2020-04-06,SE,Sweden,EURO,340,7173,85,690
2020-04-07,SE,Sweden,EURO,389,7562,90,780
2020-04-08,SE,Sweden,EURO,739,8301,84,864
2020-04-09,SE,Sweden,EURO,654,8955,115,979
2020-04-10,SE,Sweden,EURO,645,9600,86,1065
2020-04-11,SE,Sweden,EURO,454,10054,90,1155
2020-04-12,SE,Sweden,EURO,395,10449,102,1257
2020-04-13,SE,Sweden,EURO,464,10913,97,1354
2020-04-14,SE,Sweden,EURO,437,11350,84,1438
2020-04-15,SE,Sweden,EURO,479,11829,91,1529
2020-04-16,SE,Sweden,EURO,604,12433,115,1644
2020-04-17,SE,Sweden,EURO,623,13056,111,1755
2020-04-18,SE,Sweden,EURO,689,13745,83,1838
2020-04-19,SE,Sweden,EURO,532,14277,86,1924
2020-04-20,SE,Sweden,EURO,388,14665,87,2011
2020-04-21,SE,Sweden,EURO,461,15126,85,2096
2020-04-22,SE,Sweden,EURO,707,15833,62,2158
2020-04-23,SE,Sweden,EURO,723,16556,77,2235
2020-04-24,SE,Sweden,EURO,758,17314,86,2321
2020-04-25,SE,Sweden,EURO,781,18095,89,2410
2020-04-26,SE,Sweden,EURO,473,18568,73,2483
2020-04-27,SE,Sweden,EURO,300,18868,74,2557
2020-04-28,SE,Sweden,EURO,563,19431,74,2631
2020-04-29,SE,Sweden,EURO,742,20173,83,2714
2020-04-30,SE,Sweden,EURO,799,20972,83,2797
2020-05-01,SE,Sweden,EURO,636,21608,78,2875
2020-05-02,SE,Sweden,EURO,532,22140,78,2953
2020-05-03,SE,Sweden,EURO,299,22439,72,3025
2020-05-04,SE,Sweden,EURO,261,22700,75,3100
2020-05-05,SE,Sweden,EURO,477,23177,83,3183
2020-05-06,SE,Sweden,EURO,657,23834,72,3255
2020-05-07,SE,Sweden,EURO,745,24579,73,3328
2020-05-08,SE,Sweden,EURO,785,25364,80,3408
2020-05-09,SE,Sweden,EURO,701,26065,60,3468
2020-05-10,SE,Sweden,EURO,509,26574,68,3536
2020-05-11,SE,Sweden,EURO,279,26853,73,3609
2020-05-12,SE,Sweden,EURO,455,27308,65,3674
2020-05-13,SE,Sweden,EURO,754,28062,61,3735
2020-05-14,SE,Sweden,EURO,698,28760,50,3785
2020-05-15,SE,Sweden,EURO,657,29417,46,3831
2020-05-16,SE,Sweden,EURO,688,30105,58,3889
2020-05-17,SE,Sweden,EURO,358,30463,48,3937
2020-05-18,SE,Sweden,EURO,259,30722,52,3989
2020-05-19,SE,Sweden,EURO,430,31152,59,4048
2020-05-20,SE,Sweden,EURO,666,31818,41,4089
2020-05-21,SE,Sweden,EURO,808,32626,52,4141
2020-05-22,SE,Sweden,EURO,610,33236,53,4194
2020-05-23,SE,Sweden,EURO,532,33768,56,4250
2020-05-24,SE,Sweden,EURO,403,34171,55,4305
2020-05-25,SE,Sweden,EURO,210,34381,44,4349
2020-05-26,SE,Sweden,EURO,490,34871,42,4391
2020-05-27,SE,Sweden,EURO,746,35617,28,4419
2020-05-28,SE,Sweden,EURO,800,36417,38,4457
2020-05-29,SE,Sweden,EURO,774,37191,40,4497
2020-05-30,SE,Sweden,EURO,773,37964,40,4537
2020-05-31,SE,Sweden,EURO,432,38396,38,4575
2020-06-01,SE,Sweden,EURO,265,38661,46,4621
2020-06-02,SE,Sweden,EURO,648,39309,39,4660
2020-06-03,SE,Sweden,EURO,900,40209,36,4696
2020-06-04,SE,Sweden,EURO,1046,41255,28,4724
2020-06-05,SE,Sweden,EURO,1039,42294,44,4768
2020-06-06,SE,Sweden,EURO,1146,43440,37,4805
2020-06-07,SE,Sweden,EURO,780,44220,29,4834
2020-06-08,SE,Sweden,EURO,462,44682,33,4867
2020-03-29,CH,Switzerland,EURO,722,16170,57,335
2020-03-30,CH,Switzerland,EURO,432,16602,45,380
2020-03-31,CH,Switzerland,EURO,1307,17909,58,438
2020-04-01,CH,Switzerland,EURO,1132,19041,44,482
2020-04-02,CH,Switzerland,EURO,1013,20054,59,541
2020-04-03,CH,Switzerland,EURO,877,20931,61,602
2020-04-04,CH,Switzerland,EURO,928,21859,57,659
2020-04-05,CH,Switzerland,EURO,486,22345,55,714
2020-04-06,CH,Switzerland,EURO,281,22626,51,765
2020-04-07,CH,Switzerland,EURO,928,23554,50,815
2020-04-08,CH,Switzerland,EURO,713,24267,57,872
2020-04-09,CH,Switzerland,EURO,612,24879,58,930
2020-04-10,CH,Switzerland,EURO,560,25439,45,975
2020-04-11,CH,Switzerland,EURO,310,25749,52,1027
2020-04-12,CH,Switzerland,EURO,258,26007,45,1072
2020-04-13,CH,Switzerland,EURO,219,26226,36,1108
2020-04-14,CH,Switzerland,EURO,245,26471,36,1144
2020-04-15,CH,Switzerland,EURO,424,26895,37,1181
2020-04-16,CH,Switzerland,EURO,327,27222,38,1219
2020-04-17,CH,Switzerland,EURO,321,27543,38,1257
2020-04-18,CH,Switzerland,EURO,289,27832,37,1294
2020-04-19,CH,Switzerland,EURO,145,27977,34,1328
2020-04-20,CH,Switzerland,EURO,86,28063,22,1350
2020-04-21,CH,Switzerland,EURO,277,28340,38,1388
2020-04-22,CH,Switzerland,EURO,213,28553,33,1421
2020-04-23,CH,Switzerland,EURO,155,28708,27,1448
2020-04-24,CH,Switzerland,EURO,207,28915,31,1479
2020-04-25,CH,Switzerland,EURO,167,29082,27,1506
2020-04-26,CH,Switzerland,EURO,87,29169,25,1531
2020-04-27,CH,Switzerland,EURO,61,29230,13,1544
2020-04-28,CH,Switzerland,EURO,173,29403,23,1567
2020-04-29,CH,Switzerland,EURO,154,29557,12,1579
2020-04-30,CH,Switzerland,EURO,120,29677,11,1590
2020-05-01,CH,Switzerland,EURO,101,29778,15,1605
2020-05-02,CH,Switzerland,EURO,83,29861,12,1617
2020-05-03,CH,Switzerland,EURO,47,29908,9,1626
2020-05-04,CH,Switzerland,EURO,22,29930,8,1634
2020-05-05,CH,Switzerland,EURO,89,30019,9,1643
2020-05-06,CH,Switzerland,EURO,73,30092,10,1653
2020-05-07,CH,Switzerland,EURO,79,30171,4,1657
2020-05-08,CH,Switzerland,EURO,46,30217,12,1669
2020-05-09,CH,Switzerland,EURO,59,30276,7,1676
2020-05-10,CH,Switzerland,EURO,39,30315,5,1681
2020-05-11,CH,Switzerland,EURO,15,30330,7,1688
2020-05-12,CH,Switzerland,EURO,47,30377,3,1691
2020-05-13,CH,Switzerland,EURO,42,30419,1,1692
2020-05-14,CH,Switzerland,EURO,37,30456,1,1693
2020-05-15,CH,Switzerland,EURO,37,30493,2,1695
2020-05-16,CH,Switzerland,EURO,41,30534,5,1700
2020-05-17,CH,Switzerland,EURO,15,30549,1,1701
2020-05-18,CH,Switzerland,EURO,12,30561,5,1706
2020-05-19,CH,Switzerland,EURO,34,30595,3,1709
2020-05-20,CH,Switzerland,EURO,36,30631,4,1713
2020-05-21,CH,Switzerland,EURO,29,30660,0,1713
2020-05-22,CH,Switzerland,EURO,11,30671,5,1718
2020-05-23,CH,Switzerland,EURO,20,30691,1,1719
2020-05-24,CH,Switzerland,EURO,13,30704,1,1720
2020-05-25,CH,Switzerland,EURO,10,30714,0,1720
2020-05-26,CH,Switzerland,EURO,15,30729,2,1722
2020-05-27,CH,Switzerland,EURO,18,30747,2,1724
2020-05-28,CH,Switzerland,EURO,25,30772,0,1724
2020-05-29,CH,Switzerland,EURO,30,30802,0,1724
2020-05-30,CH,Switzerland,EURO,21,30823,0,1724
2020-05-31,CH,Switzerland,EURO,10,30833,0,1724
2020-06-01,CH,Switzerland,EURO,7,30840,0,1724
2020-06-02,CH,Switzerland,EURO,3,30843,0,1724
2020-06-03,CH,Switzerland,EURO,22,30865,0,1724
2020-06-04,CH,Switzerland,EURO,23,30888,0,1724
2020-06-05,CH,Switzerland,EURO,17,30905,0,1724
2020-06-06,CH,Switzerland,EURO,15,30920,0,1724
2020-06-07,CH,Switzerland,EURO,10,30930,1,1725
2020-06-08,CH,Switzerland,EURO,8,30938,0,1725
2020-03-29,SY,Syrian Arab Republic,EMRO,0,5,0,0
2020-03-30,SY,Syrian Arab Republic,EMRO,4,9,0,0
2020-03-31,SY,Syrian Arab Republic,EMRO,1,10,2,2
2020-04-01,SY,Syrian Arab Republic,EMRO,0,10,0,2
2020-04-02,SY,Syrian Arab Republic,EMRO,0,10,0,2
2020-04-03,SY,Syrian Arab Republic,EMRO,0,10,0,2
2020-04-04,SY,Syrian Arab Republic,EMRO,6,16,0,2
2020-04-05,SY,Syrian Arab Republic,EMRO,0,16,0,2
2020-04-06,SY,Syrian Arab Republic,EMRO,3,19,0,2
2020-04-07,SY,Syrian Arab Republic,EMRO,0,19,0,2
2020-04-08,SY,Syrian Arab Republic,EMRO,0,19,0,2
2020-04-09,SY,Syrian Arab Republic,EMRO,0,19,0,2
2020-04-10,SY,Syrian Arab Republic,EMRO,0,19,0,2
2020-04-11,SY,Syrian Arab Republic,EMRO,0,19,0,2
2020-04-12,SY,Syrian Arab Republic,EMRO,6,25,0,2
2020-04-13,SY,Syrian Arab Republic,EMRO,0,25,0,2
2020-04-14,SY,Syrian Arab Republic,EMRO,0,25,0,2
2020-04-15,SY,Syrian Arab Republic,EMRO,4,29,0,2
2020-04-16,SY,Syrian Arab Republic,EMRO,4,33,0,2
2020-04-17,SY,Syrian Arab Republic,EMRO,0,33,0,2
2020-04-18,SY,Syrian Arab Republic,EMRO,5,38,0,2
2020-04-19,SY,Syrian Arab Republic,EMRO,0,38,0,2
2020-04-20,SY,Syrian Arab Republic,EMRO,1,39,1,3
2020-04-21,SY,Syrian Arab Republic,EMRO,0,39,0,3
2020-04-22,SY,Syrian Arab Republic,EMRO,3,42,0,3
2020-04-23,SY,Syrian Arab Republic,EMRO,0,42,0,3
2020-04-24,SY,Syrian Arab Republic,EMRO,0,42,0,3
2020-04-25,SY,Syrian Arab Republic,EMRO,0,42,0,3
2020-04-26,SY,Syrian Arab Republic,EMRO,0,42,0,3
2020-04-27,SY,Syrian Arab Republic,EMRO,1,43,0,3
2020-04-28,SY,Syrian Arab Republic,EMRO,0,43,0,3
2020-04-29,SY,Syrian Arab Republic,EMRO,0,43,0,3
2020-04-30,SY,Syrian Arab Republic,EMRO,0,43,0,3
2020-05-01,SY,Syrian Arab Republic,EMRO,0,43,0,3
2020-05-02,SY,Syrian Arab Republic,EMRO,1,44,0,3
2020-05-03,SY,Syrian Arab Republic,EMRO,0,44,0,3
2020-05-04,SY,Syrian Arab Republic,EMRO,0,44,0,3
2020-05-05,SY,Syrian Arab Republic,EMRO,0,44,0,3
2020-05-06,SY,Syrian Arab Republic,EMRO,0,44,0,3
2020-05-07,SY,Syrian Arab Republic,EMRO,1,45,0,3
2020-05-08,SY,Syrian Arab Republic,EMRO,0,45,0,3
2020-05-09,SY,Syrian Arab Republic,EMRO,2,47,0,3
2020-05-10,SY,Syrian Arab Republic,EMRO,0,47,0,3
2020-05-11,SY,Syrian Arab Republic,EMRO,0,47,0,3
2020-05-12,SY,Syrian Arab Republic,EMRO,0,47,0,3
2020-05-13,SY,Syrian Arab Republic,EMRO,0,47,0,3
2020-05-14,SY,Syrian Arab Republic,EMRO,1,48,0,3
2020-05-15,SY,Syrian Arab Republic,EMRO,0,48,0,3
2020-05-16,SY,Syrian Arab Republic,EMRO,2,50,0,3
2020-05-17,SY,Syrian Arab Republic,EMRO,1,51,0,3
2020-05-18,SY,Syrian Arab Republic,EMRO,7,58,0,3
2020-05-19,SY,Syrian Arab Republic,EMRO,0,58,0,3
2020-05-20,SY,Syrian Arab Republic,EMRO,0,58,0,3
2020-05-21,SY,Syrian Arab Republic,EMRO,0,58,0,3
2020-05-22,SY,Syrian Arab Republic,EMRO,0,58,0,3
2020-05-23,SY,Syrian Arab Republic,EMRO,1,59,1,4
2020-05-24,SY,Syrian Arab Republic,EMRO,11,70,0,4
2020-05-25,SY,Syrian Arab Republic,EMRO,16,86,0,4
2020-05-26,SY,Syrian Arab Republic,EMRO,20,106,0,4
2020-05-27,SY,Syrian Arab Republic,EMRO,15,121,0,4
2020-05-28,SY,Syrian Arab Republic,EMRO,0,121,0,4
2020-05-29,SY,Syrian Arab Republic,EMRO,1,122,0,4
2020-05-30,SY,Syrian Arab Republic,EMRO,0,122,0,4
2020-05-31,SY,Syrian Arab Republic,EMRO,0,122,0,4
2020-06-01,SY,Syrian Arab Republic,EMRO,0,122,1,5
2020-06-02,SY,Syrian Arab Republic,EMRO,1,123,0,5
2020-06-03,SY,Syrian Arab Republic,EMRO,0,123,1,6
2020-06-04,SY,Syrian Arab Republic,EMRO,0,123,0,6
2020-06-05,SY,Syrian Arab Republic,EMRO,1,124,0,6
2020-06-06,SY,Syrian Arab Republic,EMRO,0,124,0,6
2020-06-07,SY,Syrian Arab Republic,EMRO,1,125,0,6
2020-06-08,SY,Syrian Arab Republic,EMRO,16,141,0,6
2020-03-29,TJ,Tajikistan,EURO,0,0,0,0
2020-03-30,TJ,Tajikistan,EURO,0,0,0,0
2020-03-31,TJ,Tajikistan,EURO,0,0,0,0
2020-04-01,TJ,Tajikistan,EURO,0,0,0,0
2020-04-02,TJ,Tajikistan,EURO,0,0,0,0
2020-04-03,TJ,Tajikistan,EURO,0,0,0,0
2020-04-04,TJ,Tajikistan,EURO,0,0,0,0
2020-04-05,TJ,Tajikistan,EURO,0,0,0,0
2020-04-06,TJ,Tajikistan,EURO,0,0,0,0
2020-04-07,TJ,Tajikistan,EURO,0,0,0,0
2020-04-08,TJ,Tajikistan,EURO,0,0,0,0
2020-04-09,TJ,Tajikistan,EURO,0,0,0,0
2020-04-10,TJ,Tajikistan,EURO,0,0,0,0
2020-04-11,TJ,Tajikistan,EURO,0,0,0,0
2020-04-12,TJ,Tajikistan,EURO,0,0,0,0
2020-04-13,TJ,Tajikistan,EURO,0,0,0,0
2020-04-14,TJ,Tajikistan,EURO,0,0,0,0
2020-04-15,TJ,Tajikistan,EURO,0,0,0,0
2020-04-16,TJ,Tajikistan,EURO,0,0,0,0
2020-04-17,TJ,Tajikistan,EURO,0,0,0,0
2020-04-18,TJ,Tajikistan,EURO,0,0,0,0
2020-04-19,TJ,Tajikistan,EURO,0,0,0,0
2020-04-20,TJ,Tajikistan,EURO,0,0,0,0
2020-04-21,TJ,Tajikistan,EURO,0,0,0,0
2020-04-22,TJ,Tajikistan,EURO,0,0,0,0
2020-04-23,TJ,Tajikistan,EURO,0,0,0,0
2020-04-24,TJ,Tajikistan,EURO,0,0,0,0
2020-04-25,TJ,Tajikistan,EURO,0,0,0,0
2020-04-26,TJ,Tajikistan,EURO,0,0,0,0
2020-04-27,TJ,Tajikistan,EURO,0,0,0,0
2020-04-28,TJ,Tajikistan,EURO,0,0,0,0
2020-04-29,TJ,Tajikistan,EURO,0,0,0,0
2020-04-30,TJ,Tajikistan,EURO,0,0,0,0
2020-05-01,TJ,Tajikistan,EURO,15,15,0,0
2020-05-02,TJ,Tajikistan,EURO,17,32,0,0
2020-05-03,TJ,Tajikistan,EURO,44,76,2,2
2020-05-04,TJ,Tajikistan,EURO,52,128,2,4
2020-05-05,TJ,Tajikistan,EURO,102,230,3,7
2020-05-06,TJ,Tajikistan,EURO,63,293,0,7
2020-05-07,TJ,Tajikistan,EURO,86,379,2,9
2020-05-08,TJ,Tajikistan,EURO,82,461,7,16
2020-05-09,TJ,Tajikistan,EURO,61,522,2,18
2020-05-10,TJ,Tajikistan,EURO,39,561,1,19
2020-05-11,TJ,Tajikistan,EURO,51,612,1,20
2020-05-12,TJ,Tajikistan,EURO,49,661,1,21
2020-05-13,TJ,Tajikistan,EURO,68,729,2,23
2020-05-14,TJ,Tajikistan,EURO,178,907,9,32
2020-05-15,TJ,Tajikistan,EURO,178,1085,4,36
2020-05-16,TJ,Tajikistan,EURO,33,1118,0,36
2020-05-17,TJ,Tajikistan,EURO,204,1322,3,39
2020-05-18,TJ,Tajikistan,EURO,0,1322,0,39
2020-05-19,TJ,Tajikistan,EURO,407,1729,5,44
2020-05-20,TJ,Tajikistan,EURO,207,1936,0,44
2020-05-21,TJ,Tajikistan,EURO,204,2140,0,44
2020-05-22,TJ,Tajikistan,EURO,210,2350,0,44
2020-05-23,TJ,Tajikistan,EURO,201,2551,0,44
2020-05-24,TJ,Tajikistan,EURO,187,2738,0,44
2020-05-25,TJ,Tajikistan,EURO,191,2929,2,46
2020-05-26,TJ,Tajikistan,EURO,171,3100,0,46
2020-05-27,TJ,Tajikistan,EURO,166,3266,1,47
2020-05-28,TJ,Tajikistan,EURO,158,3424,0,47
2020-05-29,TJ,Tajikistan,EURO,139,3563,0,47
2020-05-30,TJ,Tajikistan,EURO,123,3686,0,47
2020-05-31,TJ,Tajikistan,EURO,121,3807,0,47
2020-06-01,TJ,Tajikistan,EURO,123,3930,0,47
2020-06-02,TJ,Tajikistan,EURO,83,4013,0,47
2020-06-03,TJ,Tajikistan,EURO,87,4100,0,47
2020-06-04,TJ,Tajikistan,EURO,91,4191,1,48
2020-06-05,TJ,Tajikistan,EURO,98,4289,0,48
2020-06-06,TJ,Tajikistan,EURO,81,4370,0,48
2020-06-07,TJ,Tajikistan,EURO,83,4453,0,48
2020-06-08,TJ,Tajikistan,EURO,76,4529,0,48
2020-03-29,TH,Thailand,SEARO,143,1388,1,7
2020-03-30,TH,Thailand,SEARO,136,1524,2,9
2020-03-31,TH,Thailand,SEARO,127,1651,1,10
2020-04-01,TH,Thailand,SEARO,120,1771,2,12
2020-04-02,TH,Thailand,SEARO,104,1875,3,15
2020-04-03,TH,Thailand,SEARO,103,1978,4,19
2020-04-04,TH,Thailand,SEARO,89,2067,1,20
2020-04-05,TH,Thailand,SEARO,102,2169,3,23
2020-04-06,TH,Thailand,SEARO,51,2220,3,26
2020-04-07,TH,Thailand,SEARO,38,2258,1,27
2020-04-08,TH,Thailand,SEARO,111,2369,3,30
2020-04-09,TH,Thailand,SEARO,54,2423,2,32
2020-04-10,TH,Thailand,SEARO,50,2473,1,33
2020-04-11,TH,Thailand,SEARO,45,2518,2,35
2020-04-12,TH,Thailand,SEARO,33,2551,3,38
2020-04-13,TH,Thailand,SEARO,28,2579,2,40
2020-04-14,TH,Thailand,SEARO,34,2613,1,41
2020-04-15,TH,Thailand,SEARO,30,2643,2,43
2020-04-16,TH,Thailand,SEARO,29,2672,3,46
2020-04-17,TH,Thailand,SEARO,28,2700,1,47
2020-04-18,TH,Thailand,SEARO,33,2733,0,47
2020-04-19,TH,Thailand,SEARO,32,2765,0,47
2020-04-20,TH,Thailand,SEARO,27,2792,0,47
2020-04-21,TH,Thailand,SEARO,19,2811,1,48
2020-04-22,TH,Thailand,SEARO,15,2826,1,49
2020-04-23,TH,Thailand,SEARO,13,2839,1,50
2020-04-24,TH,Thailand,SEARO,15,2854,0,50
2020-04-25,TH,Thailand,SEARO,53,2907,1,51
2020-04-26,TH,Thailand,SEARO,15,2922,0,51
2020-04-27,TH,Thailand,SEARO,9,2931,1,52
2020-04-28,TH,Thailand,SEARO,7,2938,2,54
2020-04-29,TH,Thailand,SEARO,9,2947,0,54
2020-04-30,TH,Thailand,SEARO,7,2954,0,54
2020-05-01,TH,Thailand,SEARO,6,2960,0,54
2020-05-02,TH,Thailand,SEARO,6,2966,0,54
2020-05-03,TH,Thailand,SEARO,3,2969,0,54
2020-05-04,TH,Thailand,SEARO,18,2987,0,54
2020-05-05,TH,Thailand,SEARO,1,2988,0,54
2020-05-06,TH,Thailand,SEARO,1,2989,1,55
2020-05-07,TH,Thailand,SEARO,3,2992,0,55
2020-05-08,TH,Thailand,SEARO,8,3000,0,55
2020-05-09,TH,Thailand,SEARO,4,3004,1,56
2020-05-10,TH,Thailand,SEARO,5,3009,0,56
2020-05-11,TH,Thailand,SEARO,6,3015,0,56
2020-05-12,TH,Thailand,SEARO,2,3017,0,56
2020-05-13,TH,Thailand,SEARO,0,3017,0,56
2020-05-14,TH,Thailand,SEARO,1,3018,0,56
2020-05-15,TH,Thailand,SEARO,7,3025,0,56
2020-05-16,TH,Thailand,SEARO,0,3025,0,56
2020-05-17,TH,Thailand,SEARO,3,3028,0,56
2020-05-18,TH,Thailand,SEARO,3,3031,0,56
2020-05-19,TH,Thailand,SEARO,2,3033,0,56
2020-05-20,TH,Thailand,SEARO,1,3034,0,56
2020-05-21,TH,Thailand,SEARO,3,3037,0,56
2020-05-22,TH,Thailand,SEARO,0,3037,0,56
2020-05-23,TH,Thailand,SEARO,3,3040,0,56
2020-05-24,TH,Thailand,SEARO,0,3040,0,56
2020-05-25,TH,Thailand,SEARO,2,3042,1,57
2020-05-26,TH,Thailand,SEARO,3,3045,0,57
2020-05-27,TH,Thailand,SEARO,9,3054,0,57
2020-05-28,TH,Thailand,SEARO,11,3065,0,57
2020-05-29,TH,Thailand,SEARO,11,3076,0,57
2020-05-30,TH,Thailand,SEARO,1,3077,0,57
2020-05-31,TH,Thailand,SEARO,4,3081,0,57
2020-06-01,TH,Thailand,SEARO,1,3082,0,57
2020-06-02,TH,Thailand,SEARO,1,3083,1,58
2020-06-03,TH,Thailand,SEARO,1,3084,0,58
2020-06-04,TH,Thailand,SEARO,17,3101,0,58
2020-06-05,TH,Thailand,SEARO,1,3102,0,58
2020-06-06,TH,Thailand,SEARO,2,3104,0,58
2020-06-07,TH,Thailand,SEARO,8,3112,0,58
2020-06-08,TH,Thailand,SEARO,7,3119,0,58
2020-03-29,GB,The United Kingdom,EURO,3154,23041,463,2489
2020-03-30,GB,The United Kingdom,EURO,2608,25649,516,3005
2020-03-31,GB,The United Kingdom,EURO,2661,28310,585,3590
2020-04-01,GB,The United Kingdom,EURO,3857,32167,710,4300
2020-04-02,GB,The United Kingdom,EURO,4463,36630,827,5127
2020-04-03,GB,The United Kingdom,EURO,4891,41521,922,6049
2020-04-04,GB,The United Kingdom,EURO,4489,46010,1006,7055
2020-04-05,GB,The United Kingdom,EURO,4524,50534,1056,8111
2020-04-06,GB,The United Kingdom,EURO,3976,54510,1146,9257
2020-04-07,GB,The United Kingdom,EURO,3556,58066,1219,10476
2020-04-08,GB,The United Kingdom,EURO,4893,62959,1168,11644
2020-04-09,GB,The United Kingdom,EURO,5099,68058,1292,12936
2020-04-10,GB,The United Kingdom,EURO,4762,72820,1459,14395
2020-04-11,GB,The United Kingdom,EURO,4484,77304,1371,15766
2020-04-12,GB,The United Kingdom,EURO,4022,81326,1319,17085
2020-04-13,GB,The United Kingdom,EURO,3585,84911,1362,18447
2020-04-14,GB,The United Kingdom,EURO,3260,88171,1376,19823
2020-04-15,GB,The United Kingdom,EURO,4203,92374,1230,21053
2020-04-16,GB,The United Kingdom,EURO,4335,96709,1252,22305
2020-04-17,GB,The United Kingdom,EURO,4713,101422,1275,23580
2020-04-18,GB,The United Kingdom,EURO,4933,106355,1320,24900
2020-04-19,GB,The United Kingdom,EURO,4977,111332,1267,26167
2020-04-20,GB,The United Kingdom,EURO,4498,115830,1188,27355
2020-04-21,GB,The United Kingdom,EURO,3701,119531,1122,28477
2020-04-22,GB,The United Kingdom,EURO,4441,123972,1159,29636
2020-04-23,GB,The United Kingdom,EURO,4796,128768,1082,30718
2020-04-24,GB,The United Kingdom,EURO,5517,134285,1101,31819
2020-04-25,GB,The United Kingdom,EURO,4968,139253,1037,32856
2020-04-26,GB,The United Kingdom,EURO,4751,144004,1004,33860
2020-04-27,GB,The United Kingdom,EURO,3621,147625,918,34778
2020-04-28,GB,The United Kingdom,EURO,3355,150980,894,35672
2020-04-29,GB,The United Kingdom,EURO,4567,155547,866,36538
2020-04-30,GB,The United Kingdom,EURO,4568,160115,800,37338
2020-05-01,GB,The United Kingdom,EURO,5261,165376,817,38155
2020-05-02,GB,The United Kingdom,EURO,4961,170337,780,38935
2020-05-03,GB,The United Kingdom,EURO,4766,175103,785,39720
2020-05-04,GB,The United Kingdom,EURO,3258,178361,705,40425
2020-05-05,GB,The United Kingdom,EURO,3002,181363,661,41086
2020-05-06,GB,The United Kingdom,EURO,3398,184761,676,41762
2020-05-07,GB,The United Kingdom,EURO,3514,188275,642,42404
2020-05-08,GB,The United Kingdom,EURO,3661,191936,627,43031
2020-05-09,GB,The United Kingdom,EURO,3787,195723,629,43660
2020-05-10,GB,The United Kingdom,EURO,3064,198787,568,44228
2020-05-11,GB,The United Kingdom,EURO,2170,200957,539,44767
2020-05-12,GB,The United Kingdom,EURO,2232,203189,493,45260
2020-05-13,GB,The United Kingdom,EURO,3436,206625,427,45687
2020-05-14,GB,The United Kingdom,EURO,3260,209885,441,46128
2020-05-15,GB,The United Kingdom,EURO,3330,213215,454,46582
2020-05-16,GB,The United Kingdom,EURO,2630,215845,465,47047
2020-05-17,GB,The United Kingdom,EURO,2530,218375,421,47468
2020-05-18,GB,The United Kingdom,EURO,1916,220291,419,47887
2020-05-19,GB,The United Kingdom,EURO,1720,222011,377,48264
2020-05-20,GB,The United Kingdom,EURO,2581,224592,407,48671
2020-05-21,GB,The United Kingdom,EURO,3063,227655,371,49042
2020-05-22,GB,The United Kingdom,EURO,2553,230208,353,49395
2020-05-23,GB,The United Kingdom,EURO,2435,232643,342,49737
2020-05-24,GB,The United Kingdom,EURO,2057,234700,300,50037
2020-05-25,GB,The United Kingdom,EURO,1410,236110,284,50321
2020-05-26,GB,The United Kingdom,EURO,1290,237400,281,50602
2020-05-27,GB,The United Kingdom,EURO,1625,239025,279,50881
2020-05-28,GB,The United Kingdom,EURO,1968,240993,299,51180
2020-05-29,GB,The United Kingdom,EURO,1707,242700,281,51461
2020-05-30,GB,The United Kingdom,EURO,1655,244355,288,51749
2020-05-31,GB,The United Kingdom,EURO,1426,245781,254,52003
2020-06-01,GB,The United Kingdom,EURO,1132,246913,219,52222
2020-06-02,GB,The United Kingdom,EURO,1080,247993,195,52417
2020-06-03,GB,The United Kingdom,EURO,1375,249368,199,52616
2020-06-04,GB,The United Kingdom,EURO,1422,250790,233,52849
2020-06-05,GB,The United Kingdom,EURO,1295,252085,203,53052
2020-06-06,GB,The United Kingdom,EURO,1191,253276,183,53235
2020-06-07,GB,The United Kingdom,EURO,1068,254344,184,53419
2020-06-08,GB,The United Kingdom,EURO,753,255097,151,53570
2020-03-29,TL,Timor-Leste,SEARO,0,1,0,0
2020-03-30,TL,Timor-Leste,SEARO,0,1,0,0
2020-03-31,TL,Timor-Leste,SEARO,0,1,0,0
2020-04-01,TL,Timor-Leste,SEARO,0,1,0,0
2020-04-02,TL,Timor-Leste,SEARO,0,1,0,0
2020-04-03,TL,Timor-Leste,SEARO,0,1,0,0
2020-04-04,TL,Timor-Leste,SEARO,0,1,0,0
2020-04-05,TL,Timor-Leste,SEARO,0,1,0,0
2020-04-06,TL,Timor-Leste,SEARO,0,1,0,0
2020-04-07,TL,Timor-Leste,SEARO,0,1,0,0
2020-04-08,TL,Timor-Leste,SEARO,0,1,0,0
2020-04-09,TL,Timor-Leste,SEARO,0,1,0,0
2020-04-10,TL,Timor-Leste,SEARO,0,1,0,0
2020-04-11,TL,Timor-Leste,SEARO,1,2,0,0
2020-04-12,TL,Timor-Leste,SEARO,0,2,0,0
2020-04-13,TL,Timor-Leste,SEARO,2,4,0,0
2020-04-14,TL,Timor-Leste,SEARO,2,6,0,0
2020-04-15,TL,Timor-Leste,SEARO,2,8,0,0
2020-04-16,TL,Timor-Leste,SEARO,10,18,0,0
2020-04-17,TL,Timor-Leste,SEARO,0,18,0,0
2020-04-18,TL,Timor-Leste,SEARO,0,18,0,0
2020-04-19,TL,Timor-Leste,SEARO,1,19,0,0
2020-04-20,TL,Timor-Leste,SEARO,3,22,0,0
2020-04-21,TL,Timor-Leste,SEARO,1,23,0,0
2020-04-22,TL,Timor-Leste,SEARO,0,23,0,0
2020-04-23,TL,Timor-Leste,SEARO,0,23,0,0
2020-04-24,TL,Timor-Leste,SEARO,1,24,0,0
2020-04-25,TL,Timor-Leste,SEARO,0,24,0,0
2020-04-26,TL,Timor-Leste,SEARO,0,24,0,0
2020-04-27,TL,Timor-Leste,SEARO,0,24,0,0
2020-04-28,TL,Timor-Leste,SEARO,0,24,0,0
2020-04-29,TL,Timor-Leste,SEARO,0,24,0,0
2020-04-30,TL,Timor-Leste,SEARO,0,24,0,0
2020-05-01,TL,Timor-Leste,SEARO,0,24,0,0
2020-05-02,TL,Timor-Leste,SEARO,0,24,0,0
2020-05-03,TL,Timor-Leste,SEARO,0,24,0,0
2020-05-04,TL,Timor-Leste,SEARO,0,24,0,0
2020-05-05,TL,Timor-Leste,SEARO,0,24,0,0
2020-05-06,TL,Timor-Leste,SEARO,0,24,0,0
2020-05-07,TL,Timor-Leste,SEARO,0,24,0,0
2020-05-08,TL,Timor-Leste,SEARO,0,24,0,0
2020-05-09,TL,Timor-Leste,SEARO,0,24,0,0
2020-05-10,TL,Timor-Leste,SEARO,0,24,0,0
2020-05-11,TL,Timor-Leste,SEARO,0,24,0,0
2020-05-12,TL,Timor-Leste,SEARO,0,24,0,0
2020-05-13,TL,Timor-Leste,SEARO,0,24,0,0
2020-05-14,TL,Timor-Leste,SEARO,0,24,0,0
2020-05-15,TL,Timor-Leste,SEARO,0,24,0,0
2020-05-16,TL,Timor-Leste,SEARO,0,24,0,0
2020-05-17,TL,Timor-Leste,SEARO,0,24,0,0
2020-05-18,TL,Timor-Leste,SEARO,0,24,0,0
2020-05-19,TL,Timor-Leste,SEARO,0,24,0,0
2020-05-20,TL,Timor-Leste,SEARO,0,24,0,0
2020-05-21,TL,Timor-Leste,SEARO,0,24,0,0
2020-05-22,TL,Timor-Leste,SEARO,0,24,0,0
2020-05-23,TL,Timor-Leste,SEARO,0,24,0,0
2020-05-24,TL,Timor-Leste,SEARO,0,24,0,0
2020-05-25,TL,Timor-Leste,SEARO,0,24,0,0
2020-05-26,TL,Timor-Leste,SEARO,0,24,0,0
2020-05-27,TL,Timor-Leste,SEARO,0,24,0,0
2020-05-28,TL,Timor-Leste,SEARO,0,24,0,0
2020-05-29,TL,Timor-Leste,SEARO,0,24,0,0
2020-05-30,TL,Timor-Leste,SEARO,0,24,0,0
2020-05-31,TL,Timor-Leste,SEARO,0,24,0,0
2020-06-01,TL,Timor-Leste,SEARO,0,24,0,0
2020-06-02,TL,Timor-Leste,SEARO,0,24,0,0
2020-06-03,TL,Timor-Leste,SEARO,0,24,0,0
2020-06-04,TL,Timor-Leste,SEARO,0,24,0,0
2020-06-05,TL,Timor-Leste,SEARO,0,24,0,0
2020-06-06,TL,Timor-Leste,SEARO,0,24,0,0
2020-06-07,TL,Timor-Leste,SEARO,0,24,0,0
2020-06-08,TL,Timor-Leste,SEARO,0,24,0,0
2020-03-29,TG,Togo,AFRO,3,28,0,1
2020-03-30,TG,Togo,AFRO,2,30,0,1
2020-03-31,TG,Togo,AFRO,4,34,0,1
2020-04-01,TG,Togo,AFRO,0,34,1,2
2020-04-02,TG,Togo,AFRO,2,36,0,2
2020-04-03,TG,Togo,AFRO,3,39,1,3
2020-04-04,TG,Togo,AFRO,1,40,0,3
2020-04-05,TG,Togo,AFRO,1,41,0,3
2020-04-06,TG,Togo,AFRO,3,44,0,3
2020-04-07,TG,Togo,AFRO,14,58,0,3
2020-04-08,TG,Togo,AFRO,7,65,0,3
2020-04-09,TG,Togo,AFRO,5,70,0,3
2020-04-10,TG,Togo,AFRO,3,73,0,3
2020-04-11,TG,Togo,AFRO,0,73,0,3
2020-04-12,TG,Togo,AFRO,3,76,0,3
2020-04-13,TG,Togo,AFRO,0,76,0,3
2020-04-14,TG,Togo,AFRO,1,77,0,3
2020-04-15,TG,Togo,AFRO,0,77,0,3
2020-04-16,TG,Togo,AFRO,4,81,2,5
2020-04-17,TG,Togo,AFRO,2,83,0,5
2020-04-18,TG,Togo,AFRO,1,84,0,5
2020-04-19,TG,Togo,AFRO,0,84,0,5
2020-04-20,TG,Togo,AFRO,0,84,1,6
2020-04-21,TG,Togo,AFRO,2,86,0,6
2020-04-22,TG,Togo,AFRO,2,88,0,6
2020-04-23,TG,Togo,AFRO,0,88,0,6
2020-04-24,TG,Togo,AFRO,0,88,0,6
2020-04-25,TG,Togo,AFRO,2,90,0,6
2020-04-26,TG,Togo,AFRO,6,96,0,6
2020-04-27,TG,Togo,AFRO,2,98,0,6
2020-04-28,TG,Togo,AFRO,1,99,0,6
2020-04-29,TG,Togo,AFRO,0,99,0,6
2020-04-30,TG,Togo,AFRO,10,109,1,7
2020-05-01,TG,Togo,AFRO,7,116,2,9
2020-05-02,TG,Togo,AFRO,7,123,0,9
2020-05-03,TG,Togo,AFRO,0,123,0,9
2020-05-04,TG,Togo,AFRO,1,124,0,9
2020-05-05,TG,Togo,AFRO,2,126,0,9
2020-05-06,TG,Togo,AFRO,2,128,0,9
2020-05-07,TG,Togo,AFRO,0,128,0,9
2020-05-08,TG,Togo,AFRO,7,135,0,9
2020-05-09,TG,Togo,AFRO,10,145,1,10
2020-05-10,TG,Togo,AFRO,28,173,1,11
2020-05-11,TG,Togo,AFRO,1,174,0,11
2020-05-12,TG,Togo,AFRO,7,181,0,11
2020-05-13,TG,Togo,AFRO,18,199,0,11
2020-05-14,TG,Togo,AFRO,20,219,0,11
2020-05-15,TG,Togo,AFRO,19,238,0,11
2020-05-16,TG,Togo,AFRO,25,263,0,11
2020-05-17,TG,Togo,AFRO,35,298,0,11
2020-05-18,TG,Togo,AFRO,3,301,0,11
2020-05-19,TG,Togo,AFRO,29,330,1,12
2020-05-20,TG,Togo,AFRO,8,338,0,12
2020-05-21,TG,Togo,AFRO,0,338,0,12
2020-05-22,TG,Togo,AFRO,16,354,0,12
2020-05-23,TG,Togo,AFRO,9,363,0,12
2020-05-24,TG,Togo,AFRO,10,373,0,12
2020-05-25,TG,Togo,AFRO,8,381,0,12
2020-05-26,TG,Togo,AFRO,5,386,1,13
2020-05-27,TG,Togo,AFRO,5,391,0,13
2020-05-28,TG,Togo,AFRO,4,395,0,13
2020-05-29,TG,Togo,AFRO,27,422,0,13
2020-05-30,TG,Togo,AFRO,6,428,0,13
2020-05-31,TG,Togo,AFRO,5,433,0,13
2020-06-01,TG,Togo,AFRO,9,442,0,13
2020-06-02,TG,Togo,AFRO,1,443,0,13
2020-06-03,TG,Togo,AFRO,2,445,0,13
2020-06-04,TG,Togo,AFRO,7,452,0,13
2020-06-05,TG,Togo,AFRO,13,465,0,13
2020-06-06,TG,Togo,AFRO,20,485,0,13
2020-06-07,TG,Togo,AFRO,2,487,0,13
2020-06-08,TG,Togo,AFRO,8,495,0,13
2020-03-29,TK,Tokelau,WPRO,0,0,0,0
2020-03-30,TK,Tokelau,WPRO,0,0,0,0
2020-03-31,TK,Tokelau,WPRO,0,0,0,0
2020-04-01,TK,Tokelau,WPRO,0,0,0,0
2020-04-02,TK,Tokelau,WPRO,0,0,0,0
2020-04-03,TK,Tokelau,WPRO,0,0,0,0
2020-04-04,TK,Tokelau,WPRO,0,0,0,0
2020-04-05,TK,Tokelau,WPRO,0,0,0,0
2020-04-06,TK,Tokelau,WPRO,0,0,0,0
2020-04-07,TK,Tokelau,WPRO,0,0,0,0
2020-04-08,TK,Tokelau,WPRO,0,0,0,0
2020-04-09,TK,Tokelau,WPRO,0,0,0,0
2020-04-10,TK,Tokelau,WPRO,0,0,0,0
2020-04-11,TK,Tokelau,WPRO,0,0,0,0
2020-04-12,TK,Tokelau,WPRO,0,0,0,0
2020-04-13,TK,Tokelau,WPRO,0,0,0,0
2020-04-14,TK,Tokelau,WPRO,0,0,0,0
2020-04-15,TK,Tokelau,WPRO,0,0,0,0
2020-04-16,TK,Tokelau,WPRO,0,0,0,0
2020-04-17,TK,Tokelau,WPRO,0,0,0,0
2020-04-18,TK,Tokelau,WPRO,0,0,0,0
2020-04-19,TK,Tokelau,WPRO,0,0,0,0
2020-04-20,TK,Tokelau,WPRO,0,0,0,0
2020-04-21,TK,Tokelau,WPRO,0,0,0,0
2020-04-22,TK,Tokelau,WPRO,0,0,0,0
2020-04-23,TK,Tokelau,WPRO,0,0,0,0
2020-04-24,TK,Tokelau,WPRO,0,0,0,0
2020-04-25,TK,Tokelau,WPRO,0,0,0,0
2020-04-26,TK,Tokelau,WPRO,0,0,0,0
2020-04-27,TK,Tokelau,WPRO,0,0,0,0
2020-04-28,TK,Tokelau,WPRO,0,0,0,0
2020-04-29,TK,Tokelau,WPRO,0,0,0,0
2020-04-30,TK,Tokelau,WPRO,0,0,0,0
2020-05-01,TK,Tokelau,WPRO,0,0,0,0
2020-05-02,TK,Tokelau,WPRO,0,0,0,0
2020-05-03,TK,Tokelau,WPRO,0,0,0,0
2020-05-04,TK,Tokelau,WPRO,0,0,0,0
2020-05-05,TK,Tokelau,WPRO,0,0,0,0
2020-05-06,TK,Tokelau,WPRO,0,0,0,0
2020-05-07,TK,Tokelau,WPRO,0,0,0,0
2020-05-08,TK,Tokelau,WPRO,0,0,0,0
2020-05-09,TK,Tokelau,WPRO,0,0,0,0
2020-05-10,TK,Tokelau,WPRO,0,0,0,0
2020-05-11,TK,Tokelau,WPRO,0,0,0,0
2020-05-12,TK,Tokelau,WPRO,0,0,0,0
2020-05-13,TK,Tokelau,WPRO,0,0,0,0
2020-05-14,TK,Tokelau,WPRO,0,0,0,0
2020-05-15,TK,Tokelau,WPRO,0,0,0,0
2020-05-16,TK,Tokelau,WPRO,0,0,0,0
2020-05-17,TK,Tokelau,WPRO,0,0,0,0
2020-05-18,TK,Tokelau,WPRO,0,0,0,0
2020-05-19,TK,Tokelau,WPRO,0,0,0,0
2020-05-20,TK,Tokelau,WPRO,0,0,0,0
2020-05-21,TK,Tokelau,WPRO,0,0,0,0
2020-05-22,TK,Tokelau,WPRO,0,0,0,0
2020-05-23,TK,Tokelau,WPRO,0,0,0,0
2020-05-24,TK,Tokelau,WPRO,0,0,0,0
2020-05-25,TK,Tokelau,WPRO,0,0,0,0
2020-05-26,TK,Tokelau,WPRO,0,0,0,0
2020-05-27,TK,Tokelau,WPRO,0,0,0,0
2020-05-28,TK,Tokelau,WPRO,0,0,0,0
2020-05-29,TK,Tokelau,WPRO,0,0,0,0
2020-05-30,TK,Tokelau,WPRO,0,0,0,0
2020-05-31,TK,Tokelau,WPRO,0,0,0,0
2020-06-01,TK,Tokelau,WPRO,0,0,0,0
2020-06-02,TK,Tokelau,WPRO,0,0,0,0
2020-06-03,TK,Tokelau,WPRO,0,0,0,0
2020-06-04,TK,Tokelau,WPRO,0,0,0,0
2020-06-05,TK,Tokelau,WPRO,0,0,0,0
2020-06-06,TK,Tokelau,WPRO,0,0,0,0
2020-06-07,TK,Tokelau,WPRO,0,0,0,0
2020-06-08,TK,Tokelau,WPRO,0,0,0,0
2020-03-29,TO,Tonga,WPRO,0,0,0,0
2020-03-30,TO,Tonga,WPRO,0,0,0,0
2020-03-31,TO,Tonga,WPRO,0,0,0,0
2020-04-01,TO,Tonga,WPRO,0,0,0,0
2020-04-02,TO,Tonga,WPRO,0,0,0,0
2020-04-03,TO,Tonga,WPRO,0,0,0,0
2020-04-04,TO,Tonga,WPRO,0,0,0,0
2020-04-05,TO,Tonga,WPRO,0,0,0,0
2020-04-06,TO,Tonga,WPRO,0,0,0,0
2020-04-07,TO,Tonga,WPRO,0,0,0,0
2020-04-08,TO,Tonga,WPRO,0,0,0,0
2020-04-09,TO,Tonga,WPRO,0,0,0,0
2020-04-10,TO,Tonga,WPRO,0,0,0,0
2020-04-11,TO,Tonga,WPRO,0,0,0,0
2020-04-12,TO,Tonga,WPRO,0,0,0,0
2020-04-13,TO,Tonga,WPRO,0,0,0,0
2020-04-14,TO,Tonga,WPRO,0,0,0,0
2020-04-15,TO,Tonga,WPRO,0,0,0,0
2020-04-16,TO,Tonga,WPRO,0,0,0,0
2020-04-17,TO,Tonga,WPRO,0,0,0,0
2020-04-18,TO,Tonga,WPRO,0,0,0,0
2020-04-19,TO,Tonga,WPRO,0,0,0,0
2020-04-20,TO,Tonga,WPRO,0,0,0,0
2020-04-21,TO,Tonga,WPRO,0,0,0,0
2020-04-22,TO,Tonga,WPRO,0,0,0,0
2020-04-23,TO,Tonga,WPRO,0,0,0,0
2020-04-24,TO,Tonga,WPRO,0,0,0,0
2020-04-25,TO,Tonga,WPRO,0,0,0,0
2020-04-26,TO,Tonga,WPRO,0,0,0,0
2020-04-27,TO,Tonga,WPRO,0,0,0,0
2020-04-28,TO,Tonga,WPRO,0,0,0,0
2020-04-29,TO,Tonga,WPRO,0,0,0,0
2020-04-30,TO,Tonga,WPRO,0,0,0,0
2020-05-01,TO,Tonga,WPRO,0,0,0,0
2020-05-02,TO,Tonga,WPRO,0,0,0,0
2020-05-03,TO,Tonga,WPRO,0,0,0,0
2020-05-04,TO,Tonga,WPRO,0,0,0,0
2020-05-05,TO,Tonga,WPRO,0,0,0,0
2020-05-06,TO,Tonga,WPRO,0,0,0,0
2020-05-07,TO,Tonga,WPRO,0,0,0,0
2020-05-08,TO,Tonga,WPRO,0,0,0,0
2020-05-09,TO,Tonga,WPRO,0,0,0,0
2020-05-10,TO,Tonga,WPRO,0,0,0,0
2020-05-11,TO,Tonga,WPRO,0,0,0,0
2020-05-12,TO,Tonga,WPRO,0,0,0,0
2020-05-13,TO,Tonga,WPRO,0,0,0,0
2020-05-14,TO,Tonga,WPRO,0,0,0,0
2020-05-15,TO,Tonga,WPRO,0,0,0,0
2020-05-16,TO,Tonga,WPRO,0,0,0,0
2020-05-17,TO,Tonga,WPRO,0,0,0,0
2020-05-18,TO,Tonga,WPRO,0,0,0,0
2020-05-19,TO,Tonga,WPRO,0,0,0,0
2020-05-20,TO,Tonga,WPRO,0,0,0,0
2020-05-21,TO,Tonga,WPRO,0,0,0,0
2020-05-22,TO,Tonga,WPRO,0,0,0,0
2020-05-23,TO,Tonga,WPRO,0,0,0,0
2020-05-24,TO,Tonga,WPRO,0,0,0,0
2020-05-25,TO,Tonga,WPRO,0,0,0,0
2020-05-26,TO,Tonga,WPRO,0,0,0,0
2020-05-27,TO,Tonga,WPRO,0,0,0,0
2020-05-28,TO,Tonga,WPRO,0,0,0,0
2020-05-29,TO,Tonga,WPRO,0,0,0,0
2020-05-30,TO,Tonga,WPRO,0,0,0,0
2020-05-31,TO,Tonga,WPRO,0,0,0,0
2020-06-01,TO,Tonga,WPRO,0,0,0,0
2020-06-02,TO,Tonga,WPRO,0,0,0,0
2020-06-03,TO,Tonga,WPRO,0,0,0,0
2020-06-04,TO,Tonga,WPRO,0,0,0,0
2020-06-05,TO,Tonga,WPRO,0,0,0,0
2020-06-06,TO,Tonga,WPRO,0,0,0,0
2020-06-07,TO,Tonga,WPRO,0,0,0,0
2020-06-08,TO,Tonga,WPRO,0,0,0,0
2020-03-29,TT,Trinidad and Tobago,AMRO,8,74,0,2
2020-03-30,TT,Trinidad and Tobago,AMRO,2,76,1,3
2020-03-31,TT,Trinidad and Tobago,AMRO,6,82,0,3
2020-04-01,TT,Trinidad and Tobago,AMRO,3,85,0,3
2020-04-02,TT,Trinidad and Tobago,AMRO,4,89,2,5
2020-04-03,TT,Trinidad and Tobago,AMRO,1,90,0,5
2020-04-04,TT,Trinidad and Tobago,AMRO,7,97,1,6
2020-04-05,TT,Trinidad and Tobago,AMRO,3,100,0,6
2020-04-06,TT,Trinidad and Tobago,AMRO,0,100,0,6
2020-04-07,TT,Trinidad and Tobago,AMRO,5,105,2,8
2020-04-08,TT,Trinidad and Tobago,AMRO,1,106,0,8
2020-04-09,TT,Trinidad and Tobago,AMRO,1,107,0,8
2020-04-10,TT,Trinidad and Tobago,AMRO,2,109,0,8
2020-04-11,TT,Trinidad and Tobago,AMRO,0,109,0,8
2020-04-12,TT,Trinidad and Tobago,AMRO,0,109,0,8
2020-04-13,TT,Trinidad and Tobago,AMRO,3,112,0,8
2020-04-14,TT,Trinidad and Tobago,AMRO,1,113,0,8
2020-04-15,TT,Trinidad and Tobago,AMRO,0,113,0,8
2020-04-16,TT,Trinidad and Tobago,AMRO,1,114,0,8
2020-04-17,TT,Trinidad and Tobago,AMRO,0,114,0,8
2020-04-18,TT,Trinidad and Tobago,AMRO,0,114,0,8
2020-04-19,TT,Trinidad and Tobago,AMRO,0,114,0,8
2020-04-20,TT,Trinidad and Tobago,AMRO,0,114,0,8
2020-04-21,TT,Trinidad and Tobago,AMRO,0,114,0,8
2020-04-22,TT,Trinidad and Tobago,AMRO,0,114,0,8
2020-04-23,TT,Trinidad and Tobago,AMRO,1,115,0,8
2020-04-24,TT,Trinidad and Tobago,AMRO,0,115,0,8
2020-04-25,TT,Trinidad and Tobago,AMRO,0,115,0,8
2020-04-26,TT,Trinidad and Tobago,AMRO,0,115,0,8
2020-04-27,TT,Trinidad and Tobago,AMRO,0,115,0,8
2020-04-28,TT,Trinidad and Tobago,AMRO,1,116,0,8
2020-04-29,TT,Trinidad and Tobago,AMRO,0,116,0,8
2020-04-30,TT,Trinidad and Tobago,AMRO,0,116,0,8
2020-05-01,TT,Trinidad and Tobago,AMRO,0,116,0,8
2020-05-02,TT,Trinidad and Tobago,AMRO,0,116,0,8
2020-05-03,TT,Trinidad and Tobago,AMRO,0,116,0,8
2020-05-04,TT,Trinidad and Tobago,AMRO,0,116,0,8
2020-05-05,TT,Trinidad and Tobago,AMRO,0,116,0,8
2020-05-06,TT,Trinidad and Tobago,AMRO,0,116,0,8
2020-05-07,TT,Trinidad and Tobago,AMRO,0,116,0,8
2020-05-08,TT,Trinidad and Tobago,AMRO,0,116,0,8
2020-05-09,TT,Trinidad and Tobago,AMRO,0,116,0,8
2020-05-10,TT,Trinidad and Tobago,AMRO,0,116,0,8
2020-05-11,TT,Trinidad and Tobago,AMRO,0,116,0,8
2020-05-12,TT,Trinidad and Tobago,AMRO,0,116,0,8
2020-05-13,TT,Trinidad and Tobago,AMRO,0,116,0,8
2020-05-14,TT,Trinidad and Tobago,AMRO,0,116,0,8
2020-05-15,TT,Trinidad and Tobago,AMRO,0,116,0,8
2020-05-16,TT,Trinidad and Tobago,AMRO,0,116,0,8
2020-05-17,TT,Trinidad and Tobago,AMRO,0,116,0,8
2020-05-18,TT,Trinidad and Tobago,AMRO,0,116,0,8
2020-05-19,TT,Trinidad and Tobago,AMRO,0,116,0,8
2020-05-20,TT,Trinidad and Tobago,AMRO,0,116,0,8
2020-05-21,TT,Trinidad and Tobago,AMRO,0,116,0,8
2020-05-22,TT,Trinidad and Tobago,AMRO,0,116,0,8
2020-05-23,TT,Trinidad and Tobago,AMRO,0,116,0,8
2020-05-24,TT,Trinidad and Tobago,AMRO,0,116,0,8
2020-05-25,TT,Trinidad and Tobago,AMRO,0,116,0,8
2020-05-26,TT,Trinidad and Tobago,AMRO,0,116,0,8
2020-05-27,TT,Trinidad and Tobago,AMRO,0,116,0,8
2020-05-28,TT,Trinidad and Tobago,AMRO,0,116,0,8
2020-05-29,TT,Trinidad and Tobago,AMRO,0,116,0,8
2020-05-30,TT,Trinidad and Tobago,AMRO,0,116,0,8
2020-05-31,TT,Trinidad and Tobago,AMRO,0,116,0,8
2020-06-01,TT,Trinidad and Tobago,AMRO,1,117,0,8
2020-06-02,TT,Trinidad and Tobago,AMRO,0,117,0,8
2020-06-03,TT,Trinidad and Tobago,AMRO,0,117,0,8
2020-06-04,TT,Trinidad and Tobago,AMRO,0,117,0,8
2020-06-05,TT,Trinidad and Tobago,AMRO,0,117,0,8
2020-06-06,TT,Trinidad and Tobago,AMRO,0,117,0,8
2020-06-07,TT,Trinidad and Tobago,AMRO,0,117,0,8
2020-06-08,TT,Trinidad and Tobago,AMRO,0,117,0,8
2020-03-29,TN,Tunisia,EMRO,51,278,2,8
2020-03-30,TN,Tunisia,EMRO,34,312,0,8
2020-03-31,TN,Tunisia,EMRO,50,362,1,9
2020-04-01,TN,Tunisia,EMRO,30,392,1,10
2020-04-02,TN,Tunisia,EMRO,30,422,2,12
2020-04-03,TN,Tunisia,EMRO,33,455,1,13
2020-04-04,TN,Tunisia,EMRO,40,495,5,18
2020-04-05,TN,Tunisia,EMRO,58,553,1,19
2020-04-06,TN,Tunisia,EMRO,21,574,3,22
2020-04-07,TN,Tunisia,EMRO,22,596,0,22
2020-04-08,TN,Tunisia,EMRO,27,623,1,23
2020-04-09,TN,Tunisia,EMRO,5,628,1,24
2020-04-10,TN,Tunisia,EMRO,15,643,1,25
2020-04-11,TN,Tunisia,EMRO,28,671,0,25
2020-04-12,TN,Tunisia,EMRO,14,685,3,28
2020-04-13,TN,Tunisia,EMRO,22,707,3,31
2020-04-14,TN,Tunisia,EMRO,19,726,3,34
2020-04-15,TN,Tunisia,EMRO,21,747,0,34
2020-04-16,TN,Tunisia,EMRO,33,780,1,35
2020-04-17,TN,Tunisia,EMRO,42,822,2,37
2020-04-18,TN,Tunisia,EMRO,42,864,0,37
2020-04-19,TN,Tunisia,EMRO,2,866,0,37
2020-04-20,TN,Tunisia,EMRO,13,879,1,38
2020-04-21,TN,Tunisia,EMRO,5,884,0,38
2020-04-22,TN,Tunisia,EMRO,17,901,0,38
2020-04-23,TN,Tunisia,EMRO,8,909,0,38
2020-04-24,TN,Tunisia,EMRO,9,918,0,38
2020-04-25,TN,Tunisia,EMRO,4,922,0,38
2020-04-26,TN,Tunisia,EMRO,17,939,0,38
2020-04-27,TN,Tunisia,EMRO,10,949,0,38
2020-04-28,TN,Tunisia,EMRO,18,967,1,39
2020-04-29,TN,Tunisia,EMRO,8,975,1,40
2020-04-30,TN,Tunisia,EMRO,5,980,0,40
2020-05-01,TN,Tunisia,EMRO,14,994,1,41
2020-05-02,TN,Tunisia,EMRO,4,998,0,41
2020-05-03,TN,Tunisia,EMRO,11,1009,1,42
2020-05-04,TN,Tunisia,EMRO,4,1013,0,42
2020-05-05,TN,Tunisia,EMRO,5,1018,1,43
2020-05-06,TN,Tunisia,EMRO,4,1022,0,43
2020-05-07,TN,Tunisia,EMRO,3,1025,0,43
2020-05-08,TN,Tunisia,EMRO,1,1026,1,44
2020-05-09,TN,Tunisia,EMRO,0,1026,0,44
2020-05-10,TN,Tunisia,EMRO,4,1030,1,45
2020-05-11,TN,Tunisia,EMRO,2,1032,0,45
2020-05-12,TN,Tunisia,EMRO,0,1032,0,45
2020-05-13,TN,Tunisia,EMRO,0,1032,0,45
2020-05-14,TN,Tunisia,EMRO,0,1032,0,45
2020-05-15,TN,Tunisia,EMRO,0,1032,0,45
2020-05-16,TN,Tunisia,EMRO,0,1032,0,45
2020-05-17,TN,Tunisia,EMRO,3,1035,0,45
2020-05-18,TN,Tunisia,EMRO,2,1037,0,45
2020-05-19,TN,Tunisia,EMRO,0,1037,0,45
2020-05-20,TN,Tunisia,EMRO,6,1043,1,46
2020-05-21,TN,Tunisia,EMRO,1,1044,1,47
2020-05-22,TN,Tunisia,EMRO,1,1045,0,47
2020-05-23,TN,Tunisia,EMRO,1,1046,0,47
2020-05-24,TN,Tunisia,EMRO,2,1048,0,47
2020-05-25,TN,Tunisia,EMRO,0,1048,1,48
2020-05-26,TN,Tunisia,EMRO,3,1051,0,48
2020-05-27,TN,Tunisia,EMRO,0,1051,0,48
2020-05-28,TN,Tunisia,EMRO,0,1051,0,48
2020-05-29,TN,Tunisia,EMRO,17,1068,0,48
2020-05-30,TN,Tunisia,EMRO,3,1071,0,48
2020-05-31,TN,Tunisia,EMRO,5,1076,0,48
2020-06-01,TN,Tunisia,EMRO,1,1077,0,48
2020-06-02,TN,Tunisia,EMRO,7,1084,0,48
2020-06-03,TN,Tunisia,EMRO,2,1086,0,48
2020-06-04,TN,Tunisia,EMRO,1,1087,1,49
2020-06-05,TN,Tunisia,EMRO,0,1087,0,49
2020-06-06,TN,Tunisia,EMRO,0,1087,0,49
2020-06-07,TN,Tunisia,EMRO,0,1087,0,49
2020-06-08,TN,Tunisia,EMRO,0,1087,0,49
2020-03-29,TR,Türkiye,EURO,1704,7402,16,108
2020-03-30,TR,Türkiye,EURO,1815,9217,23,131
2020-03-31,TR,Türkiye,EURO,1610,10827,37,168
2020-04-01,TR,Türkiye,EURO,2704,13531,46,214
2020-04-02,TR,Türkiye,EURO,2148,15679,63,277
2020-04-03,TR,Türkiye,EURO,2456,18135,79,356
2020-04-04,TR,Türkiye,EURO,2786,20921,69,425
2020-04-05,TR,Türkiye,EURO,3013,23934,76,501
2020-04-06,TR,Türkiye,EURO,3135,27069,73,574
2020-04-07,TR,Türkiye,EURO,3148,30217,75,649
2020-04-08,TR,Türkiye,EURO,3892,34109,76,725
2020-04-09,TR,Türkiye,EURO,4117,38226,87,812
2020-04-10,TR,Türkiye,EURO,4056,42282,96,908
2020-04-11,TR,Türkiye,EURO,4747,47029,98,1006
2020-04-12,TR,Türkiye,EURO,5138,52167,95,1101
2020-04-13,TR,Türkiye,EURO,4789,56956,97,1198
2020-04-14,TR,Türkiye,EURO,4093,61049,98,1296
2020-04-15,TR,Türkiye,EURO,4062,65111,107,1403
2020-04-16,TR,Türkiye,EURO,4281,69392,115,1518
2020-04-17,TR,Türkiye,EURO,4801,74193,125,1643
2020-04-18,TR,Türkiye,EURO,4353,78546,126,1769
2020-04-19,TR,Türkiye,EURO,3783,82329,121,1890
2020-04-20,TR,Türkiye,EURO,3977,86306,127,2017
2020-04-21,TR,Türkiye,EURO,4674,90980,123,2140
2020-04-22,TR,Türkiye,EURO,4611,95591,119,2259
2020-04-23,TR,Türkiye,EURO,3083,98674,117,2376
2020-04-24,TR,Türkiye,EURO,3116,101790,115,2491
2020-04-25,TR,Türkiye,EURO,3122,104912,109,2600
2020-04-26,TR,Türkiye,EURO,2861,107773,106,2706
2020-04-27,TR,Türkiye,EURO,2357,110130,99,2805
2020-04-28,TR,Türkiye,EURO,2131,112261,95,2900
2020-04-29,TR,Türkiye,EURO,2392,114653,92,2992
2020-04-30,TR,Türkiye,EURO,2936,117589,89,3081
2020-05-01,TR,Türkiye,EURO,2615,120204,93,3174
2020-05-02,TR,Türkiye,EURO,2188,122392,84,3258
2020-05-03,TR,Türkiye,EURO,1983,124375,78,3336
2020-05-04,TR,Türkiye,EURO,1670,126045,61,3397
2020-05-05,TR,Türkiye,EURO,1614,127659,64,3461
2020-05-06,TR,Türkiye,EURO,1832,129491,59,3520
2020-05-07,TR,Türkiye,EURO,2253,131744,64,3584
2020-05-08,TR,Türkiye,EURO,1977,133721,57,3641
2020-05-09,TR,Türkiye,EURO,1848,135569,48,3689
2020-05-10,TR,Türkiye,EURO,1546,137115,50,3739
2020-05-11,TR,Türkiye,EURO,1542,138657,47,3786
2020-05-12,TR,Türkiye,EURO,1114,139771,55,3841
2020-05-13,TR,Türkiye,EURO,1704,141475,53,3894
2020-05-14,TR,Türkiye,EURO,1639,143114,58,3952
2020-05-15,TR,Türkiye,EURO,1635,144749,55,4007
2020-05-16,TR,Türkiye,EURO,1708,146457,48,4055
2020-05-17,TR,Türkiye,EURO,1610,148067,41,4096
2020-05-18,TR,Türkiye,EURO,1368,149435,44,4140
2020-05-19,TR,Türkiye,EURO,1158,150593,31,4171
2020-05-20,TR,Türkiye,EURO,1022,151615,28,4199
2020-05-21,TR,Türkiye,EURO,972,152587,23,4222
2020-05-22,TR,Türkiye,EURO,961,153548,27,4249
2020-05-23,TR,Türkiye,EURO,952,154500,27,4276
2020-05-24,TR,Türkiye,EURO,1186,155686,32,4308
2020-05-25,TR,Türkiye,EURO,1141,156827,32,4340
2020-05-26,TR,Türkiye,EURO,987,157814,29,4369
2020-05-27,TR,Türkiye,EURO,948,158762,28,4397
2020-05-28,TR,Türkiye,EURO,1035,159797,34,4431
2020-05-29,TR,Türkiye,EURO,1182,160979,30,4461
2020-05-30,TR,Türkiye,EURO,1141,162120,28,4489
2020-05-31,TR,Türkiye,EURO,983,163103,26,4515
2020-06-01,TR,Türkiye,EURO,839,163942,25,4540
2020-06-02,TR,Türkiye,EURO,827,164769,23,4563
2020-06-03,TR,Türkiye,EURO,786,165555,22,4585
2020-06-04,TR,Türkiye,EURO,867,166422,24,4609
2020-06-05,TR,Türkiye,EURO,988,167410,21,4630
2020-06-06,TR,Türkiye,EURO,930,168340,18,4648
2020-06-07,TR,Türkiye,EURO,878,169218,21,4669
2020-06-08,TR,Türkiye,EURO,914,170132,23,4692
2020-03-29,TM,Turkmenistan,EURO,0,0,0,0
2020-03-30,TM,Turkmenistan,EURO,0,0,0,0
2020-03-31,TM,Turkmenistan,EURO,0,0,0,0
2020-04-01,TM,Turkmenistan,EURO,0,0,0,0
2020-04-02,TM,Turkmenistan,EURO,0,0,0,0
2020-04-03,TM,Turkmenistan,EURO,0,0,0,0
2020-04-04,TM,Turkmenistan,EURO,0,0,0,0
2020-04-05,TM,Turkmenistan,EURO,0,0,0,0
2020-04-06,TM,Turkmenistan,EURO,0,0,0,0
2020-04-07,TM,Turkmenistan,EURO,0,0,0,0
2020-04-08,TM,Turkmenistan,EURO,0,0,0,0
2020-04-09,TM,Turkmenistan,EURO,0,0,0,0
2020-04-10,TM,Turkmenistan,EURO,0,0,0,0
2020-04-11,TM,Turkmenistan,EURO,0,0,0,0
2020-04-12,TM,Turkmenistan,EURO,0,0,0,0
2020-04-13,TM,Turkmenistan,EURO,0,0,0,0
2020-04-14,TM,Turkmenistan,EURO,0,0,0,0
2020-04-15,TM,Turkmenistan,EURO,0,0,0,0
2020-04-16,TM,Turkmenistan,EURO,0,0,0,0
2020-04-17,TM,Turkmenistan,EURO,0,0,0,0
2020-04-18,TM,Turkmenistan,EURO,0,0,0,0
2020-04-19,TM,Turkmenistan,EURO,0,0,0,0
2020-04-20,TM,Turkmenistan,EURO,0,0,0,0
2020-04-21,TM,Turkmenistan,EURO,0,0,0,0
2020-04-22,TM,Turkmenistan,EURO,0,0,0,0
2020-04-23,TM,Turkmenistan,EURO,0,0,0,0
2020-04-24,TM,Turkmenistan,EURO,0,0,0,0
2020-04-25,TM,Turkmenistan,EURO,0,0,0,0
2020-04-26,TM,Turkmenistan,EURO,0,0,0,0
2020-04-27,TM,Turkmenistan,EURO,0,0,0,0
2020-04-28,TM,Turkmenistan,EURO,0,0,0,0
2020-04-29,TM,Turkmenistan,EURO,0,0,0,0
2020-04-30,TM,Turkmenistan,EURO,0,0,0,0
2020-05-01,TM,Turkmenistan,EURO,0,0,0,0
2020-05-02,TM,Turkmenistan,EURO,0,0,0,0
2020-05-03,TM,Turkmenistan,EURO,0,0,0,0
2020-05-04,TM,Turkmenistan,EURO,0,0,0,0
2020-05-05,TM,Turkmenistan,EURO,0,0,0,0
2020-05-06,TM,Turkmenistan,EURO,0,0,0,0
2020-05-07,TM,Turkmenistan,EURO,0,0,0,0
2020-05-08,TM,Turkmenistan,EURO,0,0,0,0
2020-05-09,TM,Turkmenistan,EURO,0,0,0,0
2020-05-10,TM,Turkmenistan,EURO,0,0,0,0
2020-05-11,TM,Turkmenistan,EURO,0,0,0,0
2020-05-12,TM,Turkmenistan,EURO,0,0,0,0
2020-05-13,TM,Turkmenistan,EURO,0,0,0,0
2020-05-14,TM,Turkmenistan,EURO,0,0,0,0
2020-05-15,TM,Turkmenistan,EURO,0,0,0,0
2020-05-16,TM,Turkmenistan,EURO,0,0,0,0
2020-05-17,TM,Turkmenistan,EURO,0,0,0,0
2020-05-18,TM,Turkmenistan,EURO,0,0,0,0
2020-05-19,TM,Turkmenistan,EURO,0,0,0,0
2020-05-20,TM,Turkmenistan,EURO,0,0,0,0
2020-05-21,TM,Turkmenistan,EURO,0,0,0,0
2020-05-22,TM,Turkmenistan,EURO,0,0,0,0
2020-05-23,TM,Turkmenistan,EURO,0,0,0,0
2020-05-24,TM,Turkmenistan,EURO,0,0,0,0
2020-05-25,TM,Turkmenistan,EURO,0,0,0,0
2020-05-26,TM,Turkmenistan,EURO,0,0,0,0
2020-05-27,TM,Turkmenistan,EURO,0,0,0,0
2020-05-28,TM,Turkmenistan,EURO,0,0,0,0
2020-05-29,TM,Turkmenistan,EURO,0,0,0,0
2020-05-30,TM,Turkmenistan,EURO,0,0,0,0
2020-05-31,TM,Turkmenistan,EURO,0,0,0,0
2020-06-01,TM,Turkmenistan,EURO,0,0,0,0
2020-06-02,TM,Turkmenistan,EURO,0,0,0,0
2020-06-03,TM,Turkmenistan,EURO,0,0,0,0
2020-06-04,TM,Turkmenistan,EURO,0,0,0,0
2020-06-05,TM,Turkmenistan,EURO,0,0,0,0
2020-06-06,TM,Turkmenistan,EURO,0,0,0,0
2020-06-07,TM,Turkmenistan,EURO,0,0,0,0
2020-06-08,TM,Turkmenistan,EURO,0,0,0,0
2020-03-29,TC,Turks and Caicos Islands,AMRO,0,2,0,0
2020-03-30,TC,Turks and Caicos Islands,AMRO,0,2,0,0
2020-03-31,TC,Turks and Caicos Islands,AMRO,3,5,0,0
2020-04-01,TC,Turks and Caicos Islands,AMRO,0,5,0,0
2020-04-02,TC,Turks and Caicos Islands,AMRO,0,5,0,0
2020-04-03,TC,Turks and Caicos Islands,AMRO,0,5,0,0
2020-04-04,TC,Turks and Caicos Islands,AMRO,0,5,0,0
2020-04-05,TC,Turks and Caicos Islands,AMRO,0,5,0,0
2020-04-06,TC,Turks and Caicos Islands,AMRO,0,5,1,1
2020-04-07,TC,Turks and Caicos Islands,AMRO,0,5,0,1
2020-04-08,TC,Turks and Caicos Islands,AMRO,3,8,0,1
2020-04-09,TC,Turks and Caicos Islands,AMRO,0,8,0,1
2020-04-10,TC,Turks and Caicos Islands,AMRO,0,8,0,1
2020-04-11,TC,Turks and Caicos Islands,AMRO,0,8,0,1
2020-04-12,TC,Turks and Caicos Islands,AMRO,0,8,0,1
2020-04-13,TC,Turks and Caicos Islands,AMRO,1,9,0,1
2020-04-14,TC,Turks and Caicos Islands,AMRO,0,9,0,1
2020-04-15,TC,Turks and Caicos Islands,AMRO,1,10,0,1
2020-04-16,TC,Turks and Caicos Islands,AMRO,0,10,0,1
2020-04-17,TC,Turks and Caicos Islands,AMRO,1,11,0,1
2020-04-18,TC,Turks and Caicos Islands,AMRO,0,11,0,1
2020-04-19,TC,Turks and Caicos Islands,AMRO,0,11,0,1
2020-04-20,TC,Turks and Caicos Islands,AMRO,0,11,0,1
2020-04-21,TC,Turks and Caicos Islands,AMRO,0,11,0,1
2020-04-22,TC,Turks and Caicos Islands,AMRO,0,11,0,1
2020-04-23,TC,Turks and Caicos Islands,AMRO,0,11,0,1
2020-04-24,TC,Turks and Caicos Islands,AMRO,0,11,0,1
2020-04-25,TC,Turks and Caicos Islands,AMRO,0,11,0,1
2020-04-26,TC,Turks and Caicos Islands,AMRO,0,11,0,1
2020-04-27,TC,Turks and Caicos Islands,AMRO,0,11,0,1
2020-04-28,TC,Turks and Caicos Islands,AMRO,1,12,0,1
2020-04-29,TC,Turks and Caicos Islands,AMRO,0,12,0,1
2020-04-30,TC,Turks and Caicos Islands,AMRO,0,12,0,1
2020-05-01,TC,Turks and Caicos Islands,AMRO,0,12,0,1
2020-05-02,TC,Turks and Caicos Islands,AMRO,0,12,0,1
2020-05-03,TC,Turks and Caicos Islands,AMRO,0,12,0,1
2020-05-04,TC,Turks and Caicos Islands,AMRO,0,12,0,1
2020-05-05,TC,Turks and Caicos Islands,AMRO,0,12,0,1
2020-05-06,TC,Turks and Caicos Islands,AMRO,0,12,0,1
2020-05-07,TC,Turks and Caicos Islands,AMRO,0,12,0,1
2020-05-08,TC,Turks and Caicos Islands,AMRO,0,12,0,1
2020-05-09,TC,Turks and Caicos Islands,AMRO,0,12,0,1
2020-05-10,TC,Turks and Caicos Islands,AMRO,0,12,0,1
2020-05-11,TC,Turks and Caicos Islands,AMRO,0,12,0,1
2020-05-12,TC,Turks and Caicos Islands,AMRO,0,12,0,1
2020-05-13,TC,Turks and Caicos Islands,AMRO,0,12,0,1
2020-05-14,TC,Turks and Caicos Islands,AMRO,0,12,0,1
2020-05-15,TC,Turks and Caicos Islands,AMRO,0,12,0,1
2020-05-16,TC,Turks and Caicos Islands,AMRO,0,12,0,1
2020-05-17,TC,Turks and Caicos Islands,AMRO,0,12,0,1
2020-05-18,TC,Turks and Caicos Islands,AMRO,0,12,0,1
2020-05-19,TC,Turks and Caicos Islands,AMRO,0,12,0,1
2020-05-20,TC,Turks and Caicos Islands,AMRO,0,12,0,1
2020-05-21,TC,Turks and Caicos Islands,AMRO,0,12,0,1
2020-05-22,TC,Turks and Caicos Islands,AMRO,0,12,0,1
2020-05-23,TC,Turks and Caicos Islands,AMRO,0,12,0,1
2020-05-24,TC,Turks and Caicos Islands,AMRO,0,12,0,1
2020-05-25,TC,Turks and Caicos Islands,AMRO,0,12,0,1
2020-05-26,TC,Turks and Caicos Islands,AMRO,0,12,0,1
2020-05-27,TC,Turks and Caicos Islands,AMRO,0,12,0,1
2020-05-28,TC,Turks and Caicos Islands,AMRO,0,12,0,1
2020-05-29,TC,Turks and Caicos Islands,AMRO,0,12,0,1
2020-05-30,TC,Turks and Caicos Islands,AMRO,0,12,0,1
2020-05-31,TC,Turks and Caicos Islands,AMRO,0,12,0,1
2020-06-01,TC,Turks and Caicos Islands,AMRO,0,12,0,1
2020-06-02,TC,Turks and Caicos Islands,AMRO,0,12,0,1
2020-06-03,TC,Turks and Caicos Islands,AMRO,0,12,0,1
2020-06-04,TC,Turks and Caicos Islands,AMRO,0,12,0,1
2020-06-05,TC,Turks and Caicos Islands,AMRO,0,12,0,1
2020-06-06,TC,Turks and Caicos Islands,AMRO,0,12,0,1
2020-06-07,TC,Turks and Caicos Islands,AMRO,0,12,0,1
2020-06-08,TC,Turks and Caicos Islands,AMRO,0,12,0,1
2020-03-29,TV,Tuvalu,WPRO,0,0,0,0
2020-03-30,TV,Tuvalu,WPRO,0,0,0,0
2020-03-31,TV,Tuvalu,WPRO,0,0,0,0
2020-04-01,TV,Tuvalu,WPRO,0,0,0,0
2020-04-02,TV,Tuvalu,WPRO,0,0,0,0
2020-04-03,TV,Tuvalu,WPRO,0,0,0,0
2020-04-04,TV,Tuvalu,WPRO,0,0,0,0
2020-04-05,TV,Tuvalu,WPRO,0,0,0,0
2020-04-06,TV,Tuvalu,WPRO,0,0,0,0
2020-04-07,TV,Tuvalu,WPRO,0,0,0,0
2020-04-08,TV,Tuvalu,WPRO,0,0,0,0
2020-04-09,TV,Tuvalu,WPRO,0,0,0,0
2020-04-10,TV,Tuvalu,WPRO,0,0,0,0
2020-04-11,TV,Tuvalu,WPRO,0,0,0,0
2020-04-12,TV,Tuvalu,WPRO,0,0,0,0
2020-04-13,TV,Tuvalu,WPRO,0,0,0,0
2020-04-14,TV,Tuvalu,WPRO,0,0,0,0
2020-04-15,TV,Tuvalu,WPRO,0,0,0,0
2020-04-16,TV,Tuvalu,WPRO,0,0,0,0
2020-04-17,TV,Tuvalu,WPRO,0,0,0,0
2020-04-18,TV,Tuvalu,WPRO,0,0,0,0
2020-04-19,TV,Tuvalu,WPRO,0,0,0,0
2020-04-20,TV,Tuvalu,WPRO,0,0,0,0
2020-04-21,TV,Tuvalu,WPRO,0,0,0,0
2020-04-22,TV,Tuvalu,WPRO,0,0,0,0
2020-04-23,TV,Tuvalu,WPRO,0,0,0,0
2020-04-24,TV,Tuvalu,WPRO,0,0,0,0
2020-04-25,TV,Tuvalu,WPRO,0,0,0,0
2020-04-26,TV,Tuvalu,WPRO,0,0,0,0
2020-04-27,TV,Tuvalu,WPRO,0,0,0,0
2020-04-28,TV,Tuvalu,WPRO,0,0,0,0
2020-04-29,TV,Tuvalu,WPRO,0,0,0,0
2020-04-30,TV,Tuvalu,WPRO,0,0,0,0
2020-05-01,TV,Tuvalu,WPRO,0,0,0,0
2020-05-02,TV,Tuvalu,WPRO,0,0,0,0
2020-05-03,TV,Tuvalu,WPRO,0,0,0,0
2020-05-04,TV,Tuvalu,WPRO,0,0,0,0
2020-05-05,TV,Tuvalu,WPRO,0,0,0,0
2020-05-06,TV,Tuvalu,WPRO,0,0,0,0
2020-05-07,TV,Tuvalu,WPRO,0,0,0,0
2020-05-08,TV,Tuvalu,WPRO,0,0,0,0
2020-05-09,TV,Tuvalu,WPRO,0,0,0,0
2020-05-10,TV,Tuvalu,WPRO,0,0,0,0
2020-05-11,TV,Tuvalu,WPRO,0,0,0,0
2020-05-12,TV,Tuvalu,WPRO,0,0,0,0
2020-05-13,TV,Tuvalu,WPRO,0,0,0,0
2020-05-14,TV,Tuvalu,WPRO,0,0,0,0
2020-05-15,TV,Tuvalu,WPRO,0,0,0,0
2020-05-16,TV,Tuvalu,WPRO,0,0,0,0
2020-05-17,TV,Tuvalu,WPRO,0,0,0,0
2020-05-18,TV,Tuvalu,WPRO,0,0,0,0
2020-05-19,TV,Tuvalu,WPRO,0,0,0,0
2020-05-20,TV,Tuvalu,WPRO,0,0,0,0
2020-05-21,TV,Tuvalu,WPRO,0,0,0,0
2020-05-22,TV,Tuvalu,WPRO,0,0,0,0
2020-05-23,TV,Tuvalu,WPRO,0,0,0,0
2020-05-24,TV,Tuvalu,WPRO,0,0,0,0
2020-05-25,TV,Tuvalu,WPRO,0,0,0,0
2020-05-26,TV,Tuvalu,WPRO,0,0,0,0
2020-05-27,TV,Tuvalu,WPRO,0,0,0,0
2020-05-28,TV,Tuvalu,WPRO,0,0,0,0
2020-05-29,TV,Tuvalu,WPRO,0,0,0,0
2020-05-30,TV,Tuvalu,WPRO,0,0,0,0
2020-05-31,TV,Tuvalu,WPRO,0,0,0,0
2020-06-01,TV,Tuvalu,WPRO,0,0,0,0
2020-06-02,TV,Tuvalu,WPRO,0,0,0,0
2020-06-03,TV,Tuvalu,WPRO,0,0,0,0
2020-06-04,TV,Tuvalu,WPRO,0,0,0,0
2020-06-05,TV,Tuvalu,WPRO,0,0,0,0
2020-06-06,TV,Tuvalu,WPRO,0,0,0,0
2020-06-07,TV,Tuvalu,WPRO,0,0,0,0
2020-06-08,TV,Tuvalu,WPRO,0,0,0,0
2020-03-29,UG,Uganda,AFRO,7,27,0,1
2020-03-30,UG,Uganda,AFRO,3,30,0,1
2020-03-31,UG,Uganda,AFRO,0,30,0,1
2020-04-01,UG,Uganda,AFRO,11,41,0,1
2020-04-02,UG,Uganda,AFRO,0,41,0,1
2020-04-03,UG,Uganda,AFRO,1,42,0,1
2020-04-04,UG,Uganda,AFRO,1,43,0,1
2020-04-05,UG,Uganda,AFRO,0,43,0,1
2020-04-06,UG,Uganda,AFRO,4,47,0,1
2020-04-07,UG,Uganda,AFRO,0,47,0,1
2020-04-08,UG,Uganda,AFRO,0,47,0,1
2020-04-09,UG,Uganda,AFRO,1,48,0,1
2020-04-10,UG,Uganda,AFRO,0,48,0,1
2020-04-11,UG,Uganda,AFRO,0,48,0,1
2020-04-12,UG,Uganda,AFRO,0,48,0,1
2020-04-13,UG,Uganda,AFRO,1,49,0,1
2020-04-14,UG,Uganda,AFRO,0,49,0,1
2020-04-15,UG,Uganda,AFRO,1,50,0,1
2020-04-16,UG,Uganda,AFRO,0,50,0,1
2020-04-17,UG,Uganda,AFRO,0,50,0,1
2020-04-18,UG,Uganda,AFRO,0,50,0,1
2020-04-19,UG,Uganda,AFRO,0,50,0,1
2020-04-20,UG,Uganda,AFRO,0,50,0,1
2020-04-21,UG,Uganda,AFRO,0,50,0,1
2020-04-22,UG,Uganda,AFRO,0,50,0,1
2020-04-23,UG,Uganda,AFRO,0,50,0,1
2020-04-24,UG,Uganda,AFRO,0,50,0,1
2020-04-25,UG,Uganda,AFRO,1,51,0,1
2020-04-26,UG,Uganda,AFRO,0,51,0,1
2020-04-27,UG,Uganda,AFRO,0,51,0,1
2020-04-28,UG,Uganda,AFRO,0,51,0,1
2020-04-29,UG,Uganda,AFRO,0,51,0,1
2020-04-30,UG,Uganda,AFRO,1,52,0,1
2020-05-01,UG,Uganda,AFRO,0,52,0,1
2020-05-02,UG,Uganda,AFRO,1,53,0,1
2020-05-03,UG,Uganda,AFRO,1,54,0,1
2020-05-04,UG,Uganda,AFRO,0,54,0,1
2020-05-05,UG,Uganda,AFRO,3,57,0,1
2020-05-06,UG,Uganda,AFRO,0,57,0,1
2020-05-07,UG,Uganda,AFRO,0,57,0,1
2020-05-08,UG,Uganda,AFRO,0,57,0,1
2020-05-09,UG,Uganda,AFRO,3,60,0,1
2020-05-10,UG,Uganda,AFRO,1,61,0,1
2020-05-11,UG,Uganda,AFRO,2,63,0,1
2020-05-12,UG,Uganda,AFRO,1,64,0,1
2020-05-13,UG,Uganda,AFRO,2,66,0,1
2020-05-14,UG,Uganda,AFRO,6,72,0,1
2020-05-15,UG,Uganda,AFRO,5,77,0,1
2020-05-16,UG,Uganda,AFRO,17,94,0,1
2020-05-17,UG,Uganda,AFRO,4,98,0,1
2020-05-18,UG,Uganda,AFRO,21,119,0,1
2020-05-19,UG,Uganda,AFRO,12,131,0,1
2020-05-20,UG,Uganda,AFRO,4,135,0,1
2020-05-21,UG,Uganda,AFRO,10,145,0,1
2020-05-22,UG,Uganda,AFRO,15,160,0,1
2020-05-23,UG,Uganda,AFRO,13,173,0,1
2020-05-24,UG,Uganda,AFRO,25,198,0,1
2020-05-25,UG,Uganda,AFRO,14,212,0,1
2020-05-26,UG,Uganda,AFRO,10,222,0,1
2020-05-27,UG,Uganda,AFRO,31,253,0,1
2020-05-28,UG,Uganda,AFRO,28,281,0,1
2020-05-29,UG,Uganda,AFRO,34,315,0,1
2020-05-30,UG,Uganda,AFRO,12,327,0,1
2020-05-31,UG,Uganda,AFRO,83,410,0,1
2020-06-01,UG,Uganda,AFRO,43,453,0,1
2020-06-02,UG,Uganda,AFRO,30,483,0,1
2020-06-03,UG,Uganda,AFRO,17,500,0,1
2020-06-04,UG,Uganda,AFRO,15,515,0,1
2020-06-05,UG,Uganda,AFRO,33,548,0,1
2020-06-06,UG,Uganda,AFRO,35,583,0,1
2020-06-07,UG,Uganda,AFRO,23,606,0,1
2020-06-08,UG,Uganda,AFRO,29,635,0,1
2020-03-29,UA,Ukraine,EURO,107,418,1,9
2020-03-30,UA,Ukraine,EURO,62,480,2,11
2020-03-31,UA,Ukraine,EURO,69,549,2,13
2020-04-01,UA,Ukraine,EURO,120,669,4,17
2020-04-02,UA,Ukraine,EURO,135,804,3,20
2020-04-03,UA,Ukraine,EURO,183,987,3,23
2020-04-04,UA,Ukraine,EURO,109,1096,5,28
2020-04-05,UA,Ukraine,EURO,155,1251,4,32
2020-04-06,UA,Ukraine,EURO,68,1319,6,38
2020-04-07,UA,Ukraine,EURO,143,1462,7,45
2020-04-08,UA,Ukraine,EURO,206,1668,7,52
2020-04-09,UA,Ukraine,EURO,224,1892,5,57
2020-04-10,UA,Ukraine,EURO,311,2203,12,69
2020-04-11,UA,Ukraine,EURO,308,2511,4,73
2020-04-12,UA,Ukraine,EURO,266,2777,10,83
2020-04-13,UA,Ukraine,EURO,325,3102,10,93
2020-04-14,UA,Ukraine,EURO,270,3372,5,98
2020-04-15,UA,Ukraine,EURO,392,3764,10,108
2020-04-16,UA,Ukraine,EURO,398,4162,7,115
2020-04-17,UA,Ukraine,EURO,500,4662,10,125
2020-04-18,UA,Ukraine,EURO,444,5106,8,133
2020-04-19,UA,Ukraine,EURO,343,5449,8,141
2020-04-20,UA,Ukraine,EURO,261,5710,10,151
2020-04-21,UA,Ukraine,EURO,415,6125,10,161
2020-04-22,UA,Ukraine,EURO,467,6592,13,174
2020-04-23,UA,Ukraine,EURO,578,7170,13,187
2020-04-24,UA,Ukraine,EURO,477,7647,6,193
2020-04-25,UA,Ukraine,EURO,478,8125,8,201
2020-04-26,UA,Ukraine,EURO,492,8617,8,209
2020-04-27,UA,Ukraine,EURO,392,9009,11,220
2020-04-28,UA,Ukraine,EURO,401,9410,19,239
2020-04-29,UA,Ukraine,EURO,456,9866,11,250
2020-04-30,UA,Ukraine,EURO,540,10406,11,261
2020-05-01,UA,Ukraine,EURO,455,10861,11,272
2020-05-02,UA,Ukraine,EURO,550,11411,7,279
2020-05-03,UA,Ukraine,EURO,502,11913,9,288
2020-05-04,UA,Ukraine,EURO,418,12331,15,303
2020-05-05,UA,Ukraine,EURO,366,12697,13,316
2020-05-06,UA,Ukraine,EURO,487,13184,11,327
2020-05-07,UA,Ukraine,EURO,507,13691,13,340
2020-05-08,UA,Ukraine,EURO,504,14195,21,361
2020-05-09,UA,Ukraine,EURO,515,14710,15,376
2020-05-10,UA,Ukraine,EURO,522,15232,15,391
2020-05-11,UA,Ukraine,EURO,416,15648,17,408
2020-05-12,UA,Ukraine,EURO,375,16023,17,425
2020-05-13,UA,Ukraine,EURO,402,16425,14,439
2020-05-14,UA,Ukraine,EURO,422,16847,17,456
2020-05-15,UA,Ukraine,EURO,483,17330,20,476
2020-05-16,UA,Ukraine,EURO,528,17858,21,497
2020-05-17,UA,Ukraine,EURO,433,18291,17,514
2020-05-18,UA,Ukraine,EURO,325,18616,21,535
2020-05-19,UA,Ukraine,EURO,260,18876,13,548
2020-05-20,UA,Ukraine,EURO,354,19230,16,564
2020-05-21,UA,Ukraine,EURO,476,19706,15,579
2020-05-22,UA,Ukraine,EURO,442,20148,9,588
2020-05-23,UA,Ukraine,EURO,432,20580,17,605
2020-05-24,UA,Ukraine,EURO,406,20986,12,617
2020-05-25,UA,Ukraine,EURO,259,21245,6,623
2020-05-26,UA,Ukraine,EURO,339,21584,21,644
2020-05-27,UA,Ukraine,EURO,321,21905,14,658
2020-05-28,UA,Ukraine,EURO,477,22382,11,669
2020-05-29,UA,Ukraine,EURO,429,22811,10,679
2020-05-30,UA,Ukraine,EURO,393,23204,17,696
2020-05-31,UA,Ukraine,EURO,468,23672,12,708
2020-06-01,UA,Ukraine,EURO,340,24012,10,718
2020-06-02,UA,Ukraine,EURO,328,24340,9,727
2020-06-03,UA,Ukraine,EURO,483,24823,8,735
2020-06-04,UA,Ukraine,EURO,588,25411,13,748
2020-06-05,UA,Ukraine,EURO,553,25964,14,762
2020-06-06,UA,Ukraine,EURO,550,26514,15,777
2020-06-07,UA,Ukraine,EURO,485,26999,11,788
2020-06-08,UA,Ukraine,EURO,463,27462,9,797
2020-03-29,AE,United Arab Emirates,EMRO,63,468,0,2
2020-03-30,AE,United Arab Emirates,EMRO,102,570,1,3
2020-03-31,AE,United Arab Emirates,EMRO,41,611,2,5
2020-04-01,AE,United Arab Emirates,EMRO,53,664,1,6
2020-04-02,AE,United Arab Emirates,EMRO,150,814,2,8
2020-04-03,AE,United Arab Emirates,EMRO,210,1024,0,8
2020-04-04,AE,United Arab Emirates,EMRO,240,1264,1,9
2020-04-05,AE,United Arab Emirates,EMRO,241,1505,1,10
2020-04-06,AE,United Arab Emirates,EMRO,294,1799,0,10
2020-04-07,AE,United Arab Emirates,EMRO,277,2076,1,11
2020-04-08,AE,United Arab Emirates,EMRO,283,2359,1,12
2020-04-09,AE,United Arab Emirates,EMRO,300,2659,0,12
2020-04-10,AE,United Arab Emirates,EMRO,331,2990,2,14
2020-04-11,AE,United Arab Emirates,EMRO,370,3360,2,16
2020-04-12,AE,United Arab Emirates,EMRO,376,3736,4,20
2020-04-13,AE,United Arab Emirates,EMRO,387,4123,2,22
2020-04-14,AE,United Arab Emirates,EMRO,398,4521,3,25
2020-04-15,AE,United Arab Emirates,EMRO,412,4933,3,28
2020-04-16,AE,United Arab Emirates,EMRO,432,5365,5,33
2020-04-17,AE,United Arab Emirates,EMRO,460,5825,2,35
2020-04-18,AE,United Arab Emirates,EMRO,477,6302,2,37
2020-04-19,AE,United Arab Emirates,EMRO,0,6302,0,37
2020-04-20,AE,United Arab Emirates,EMRO,479,6781,4,41
2020-04-21,AE,United Arab Emirates,EMRO,484,7265,2,43
2020-04-22,AE,United Arab Emirates,EMRO,490,7755,3,46
2020-04-23,AE,United Arab Emirates,EMRO,483,8238,6,52
2020-04-24,AE,United Arab Emirates,EMRO,518,8756,4,56
2020-04-25,AE,United Arab Emirates,EMRO,525,9281,8,64
2020-04-26,AE,United Arab Emirates,EMRO,532,9813,7,71
2020-04-27,AE,United Arab Emirates,EMRO,536,10349,5,76
2020-04-28,AE,United Arab Emirates,EMRO,490,10839,6,82
2020-04-29,AE,United Arab Emirates,EMRO,541,11380,7,89
2020-04-30,AE,United Arab Emirates,EMRO,549,11929,9,98
2020-05-01,AE,United Arab Emirates,EMRO,552,12481,7,105
2020-05-02,AE,United Arab Emirates,EMRO,557,13038,6,111
2020-05-03,AE,United Arab Emirates,EMRO,561,13599,8,119
2020-05-04,AE,United Arab Emirates,EMRO,564,14163,7,126
2020-05-05,AE,United Arab Emirates,EMRO,567,14730,11,137
2020-05-06,AE,United Arab Emirates,EMRO,462,15192,9,146
2020-05-07,AE,United Arab Emirates,EMRO,546,15738,11,157
2020-05-08,AE,United Arab Emirates,EMRO,502,16240,8,165
2020-05-09,AE,United Arab Emirates,EMRO,553,16793,9,174
2020-05-10,AE,United Arab Emirates,EMRO,624,17417,11,185
2020-05-11,AE,United Arab Emirates,EMRO,781,18198,13,198
2020-05-12,AE,United Arab Emirates,EMRO,680,18878,3,201
2020-05-13,AE,United Arab Emirates,EMRO,783,19661,2,203
2020-05-14,AE,United Arab Emirates,EMRO,725,20386,3,206
2020-05-15,AE,United Arab Emirates,EMRO,698,21084,2,208
2020-05-16,AE,United Arab Emirates,EMRO,747,21831,2,210
2020-05-17,AE,United Arab Emirates,EMRO,796,22627,4,214
2020-05-18,AE,United Arab Emirates,EMRO,731,23358,6,220
2020-05-19,AE,United Arab Emirates,EMRO,832,24190,4,224
2020-05-20,AE,United Arab Emirates,EMRO,873,25063,3,227
2020-05-21,AE,United Arab Emirates,EMRO,941,26004,6,233
2020-05-22,AE,United Arab Emirates,EMRO,894,26898,4,237
2020-05-23,AE,United Arab Emirates,EMRO,994,27892,4,241
2020-05-24,AE,United Arab Emirates,EMRO,812,28704,3,244
2020-05-25,AE,United Arab Emirates,EMRO,781,29485,1,245
2020-05-26,AE,United Arab Emirates,EMRO,822,30307,3,248
2020-05-27,AE,United Arab Emirates,EMRO,779,31086,5,253
2020-05-28,AE,United Arab Emirates,EMRO,883,31969,2,255
2020-05-29,AE,United Arab Emirates,EMRO,563,32532,3,258
2020-05-30,AE,United Arab Emirates,EMRO,638,33170,2,260
2020-05-31,AE,United Arab Emirates,EMRO,726,33896,2,262
2020-06-01,AE,United Arab Emirates,EMRO,661,34557,2,264
2020-06-02,AE,United Arab Emirates,EMRO,635,35192,2,266
2020-06-03,AE,United Arab Emirates,EMRO,596,35788,3,269
2020-06-04,AE,United Arab Emirates,EMRO,571,36359,1,270
2020-06-05,AE,United Arab Emirates,EMRO,659,37018,3,273
2020-06-06,AE,United Arab Emirates,EMRO,624,37642,1,274
2020-06-07,AE,United Arab Emirates,EMRO,626,38268,1,275
2020-06-08,AE,United Arab Emirates,EMRO,540,38808,1,276
2020-03-29,TZ,United Republic of Tanzania,AFRO,1,14,0,1
2020-03-30,TZ,United Republic of Tanzania,AFRO,0,14,0,1
2020-03-31,TZ,United Republic of Tanzania,AFRO,5,19,0,1
2020-04-01,TZ,United Republic of Tanzania,AFRO,0,19,0,1
2020-04-02,TZ,United Republic of Tanzania,AFRO,1,20,0,1
2020-04-03,TZ,United Republic of Tanzania,AFRO,0,20,0,1
2020-04-04,TZ,United Republic of Tanzania,AFRO,0,20,0,1
2020-04-05,TZ,United Republic of Tanzania,AFRO,0,20,0,1
2020-04-06,TZ,United Republic of Tanzania,AFRO,2,22,0,1
2020-04-07,TZ,United Republic of Tanzania,AFRO,2,24,0,1
2020-04-08,TZ,United Republic of Tanzania,AFRO,0,24,0,1
2020-04-09,TZ,United Republic of Tanzania,AFRO,1,25,0,1
2020-04-10,TZ,United Republic of Tanzania,AFRO,0,25,0,1
2020-04-11,TZ,United Republic of Tanzania,AFRO,7,32,2,3
2020-04-12,TZ,United Republic of Tanzania,AFRO,0,32,0,3
2020-04-13,TZ,United Republic of Tanzania,AFRO,0,32,0,3
2020-04-14,TZ,United Republic of Tanzania,AFRO,17,49,0,3
2020-04-15,TZ,United Republic of Tanzania,AFRO,4,53,0,3
2020-04-16,TZ,United Republic of Tanzania,AFRO,35,88,1,4
2020-04-17,TZ,United Republic of Tanzania,AFRO,6,94,0,4
2020-04-18,TZ,United Republic of Tanzania,AFRO,54,148,1,5
2020-04-19,TZ,United Republic of Tanzania,AFRO,0,148,0,5
2020-04-20,TZ,United Republic of Tanzania,AFRO,23,171,2,7
2020-04-21,TZ,United Republic of Tanzania,AFRO,84,255,3,10
2020-04-22,TZ,United Republic of Tanzania,AFRO,0,255,0,10
2020-04-23,TZ,United Republic of Tanzania,AFRO,30,285,0,10
2020-04-24,TZ,United Republic of Tanzania,AFRO,0,285,0,10
2020-04-25,TZ,United Republic of Tanzania,AFRO,15,300,0,10
2020-04-26,TZ,United Republic of Tanzania,AFRO,0,300,0,10
2020-04-27,TZ,United Republic of Tanzania,AFRO,0,300,0,10
2020-04-28,TZ,United Republic of Tanzania,AFRO,0,300,0,10
2020-04-29,TZ,United Republic of Tanzania,AFRO,0,300,0,10
2020-04-30,TZ,United Republic of Tanzania,AFRO,180,480,6,16
2020-05-01,TZ,United Republic of Tanzania,AFRO,0,480,2,18
2020-05-02,TZ,United Republic of Tanzania,AFRO,0,480,0,18
2020-05-03,TZ,United Republic of Tanzania,AFRO,0,480,0,18
2020-05-04,TZ,United Republic of Tanzania,AFRO,0,480,0,18
2020-05-05,TZ,United Republic of Tanzania,AFRO,0,480,0,18
2020-05-06,TZ,United Republic of Tanzania,AFRO,0,480,0,18
2020-05-07,TZ,United Republic of Tanzania,AFRO,0,480,0,18
2020-05-08,TZ,United Republic of Tanzania,AFRO,29,509,3,21
2020-05-09,TZ,United Republic of Tanzania,AFRO,0,509,0,21
2020-05-10,TZ,United Republic of Tanzania,AFRO,0,509,0,21
2020-05-11,TZ,United Republic of Tanzania,AFRO,0,509,0,21
2020-05-12,TZ,United Republic of Tanzania,AFRO,0,509,0,21
2020-05-13,TZ,United Republic of Tanzania,AFRO,0,509,0,21
2020-05-14,TZ,United Republic of Tanzania,AFRO,0,509,0,21
2020-05-15,TZ,United Republic of Tanzania,AFRO,0,509,0,21
2020-05-16,TZ,United Republic of Tanzania,AFRO,0,509,0,21
2020-05-17,TZ,United Republic of Tanzania,AFRO,0,509,0,21
2020-05-18,TZ,United Republic of Tanzania,AFRO,0,509,0,21
2020-05-19,TZ,United Republic of Tanzania,AFRO,0,509,0,21
2020-05-20,TZ,United Republic of Tanzania,AFRO,0,509,0,21
2020-05-21,TZ,United Republic of Tanzania,AFRO,0,509,0,21
2020-05-22,TZ,United Republic of Tanzania,AFRO,0,509,0,21
2020-05-23,TZ,United Republic of Tanzania,AFRO,0,509,0,21
2020-05-24,TZ,United Republic of Tanzania,AFRO,0,509,0,21
2020-05-25,TZ,United Republic of Tanzania,AFRO,0,509,0,21
2020-05-26,TZ,United Republic of Tanzania,AFRO,0,509,0,21
2020-05-27,TZ,United Republic of Tanzania,AFRO,0,509,0,21
2020-05-28,TZ,United Republic of Tanzania,AFRO,0,509,0,21
2020-05-29,TZ,United Republic of Tanzania,AFRO,0,509,0,21
2020-05-30,TZ,United Republic of Tanzania,AFRO,0,509,0,21
2020-05-31,TZ,United Republic of Tanzania,AFRO,0,509,0,21
2020-06-01,TZ,United Republic of Tanzania,AFRO,0,509,0,21
2020-06-02,TZ,United Republic of Tanzania,AFRO,0,509,0,21
2020-06-03,TZ,United Republic of Tanzania,AFRO,0,509,0,21
2020-06-04,TZ,United Republic of Tanzania,AFRO,0,509,0,21
2020-06-05,TZ,United Republic of Tanzania,AFRO,0,509,0,21
2020-06-06,TZ,United Republic of Tanzania,AFRO,0,509,0,21
2020-06-07,TZ,United Republic of Tanzania,AFRO,0,509,0,21
2020-06-08,TZ,United Republic of Tanzania,AFRO,0,509,0,21
2020-03-29,US,United States of America,AMRO,20344,126309,487,2106
2020-03-30,US,United States of America,AMRO,20673,146982,556,2662
2020-03-31,US,United States of America,AMRO,26161,173143,665,3327
2020-04-01,US,United States of America,AMRO,15536,188679,631,3958
2020-04-02,US,United States of America,AMRO,23260,211939,982,4940
2020-04-03,US,United States of America,AMRO,28674,240613,1121,6061
2020-04-04,US,United States of America,AMRO,29790,270403,1311,7372
2020-04-05,US,United States of America,AMRO,32057,302460,1376,8748
2020-04-06,US,United States of America,AMRO,32134,334594,1540,10288
2020-04-07,US,United States of America,AMRO,26984,361578,1873,12161
2020-04-08,US,United States of America,AMRO,28629,390207,1691,13852
2020-04-09,US,United States of America,AMRO,29355,419562,2093,15945
2020-04-10,US,United States of America,AMRO,34148,453710,2221,18166
2020-04-11,US,United States of America,AMRO,34743,488453,2230,20396
2020-04-12,US,United States of America,AMRO,33179,521632,2241,22637
2020-04-13,US,United States of America,AMRO,31535,553167,2192,24829
2020-04-14,US,United States of America,AMRO,27094,580261,1857,26686
2020-04-15,US,United States of America,AMRO,25244,605505,1905,28591
2020-04-16,US,United States of America,AMRO,25259,630764,2432,31023
2020-04-17,US,United States of America,AMRO,25208,655972,2731,33754
2020-04-18,US,United States of America,AMRO,31494,687466,2445,36199
2020-04-19,US,United States of America,AMRO,30316,717782,2336,38535
2020-04-20,US,United States of America,AMRO,28281,746063,1848,40383
2020-04-21,US,United States of America,AMRO,26070,772133,1993,42376
2020-04-22,US,United States of America,AMRO,26428,798561,2077,44453
2020-04-23,US,United States of America,AMRO,25927,824488,2673,47126
2020-04-24,US,United States of America,AMRO,30470,854958,2221,49347
2020-04-25,US,United States of America,AMRO,33211,888169,1984,51331
2020-04-26,US,United States of America,AMRO,34778,922947,2103,53434
2020-04-27,US,United States of America,AMRO,33603,956550,1892,55326
2020-04-28,US,United States of America,AMRO,26063,982613,1535,56861
2020-04-29,US,United States of America,AMRO,23758,1006371,1489,58350
2020-04-30,US,United States of America,AMRO,23935,1030306,2111,60461
2020-05-01,US,United States of America,AMRO,26774,1057080,2417,62878
2020-05-02,US,United States of America,AMRO,31221,1088301,2238,65116
2020-05-03,US,United States of America,AMRO,33082,1121383,1953,67069
2020-05-04,US,United States of America,AMRO,28292,1149675,1609,68678
2020-05-05,US,United States of America,AMRO,25927,1175602,1412,70090
2020-05-06,US,United States of America,AMRO,22324,1197926,1271,71361
2020-05-07,US,United States of America,AMRO,22878,1220804,2434,73795
2020-05-08,US,United States of America,AMRO,25440,1246244,2341,76136
2020-05-09,US,United States of America,AMRO,28552,1274796,2033,78169
2020-05-10,US,United States of America,AMRO,28833,1303629,1658,79827
2020-05-11,US,United States of America,AMRO,25917,1329546,1491,81318
2020-05-12,US,United States of America,AMRO,20656,1350202,1073,82391
2020-05-13,US,United States of America,AMRO,19950,1370152,1034,83425
2020-05-14,US,United States of America,AMRO,23902,1394054,1533,84958
2020-05-15,US,United States of America,AMRO,17336,1411390,1507,86465
2020-05-16,US,United States of America,AMRO,34643,1446033,1943,88408
2020-05-17,US,United States of America,AMRO,26628,1472661,1549,89957
2020-05-18,US,United States of America,AMRO,26081,1498742,1239,91196
2020-05-19,US,United States of America,AMRO,19917,1518659,927,92123
2020-05-20,US,United States of America,AMRO,22744,1541403,946,93069
2020-05-21,US,United States of America,AMRO,21923,1563326,1179,94248
2020-05-22,US,United States of America,AMRO,23506,1586832,1374,95622
2020-05-23,US,United States of America,AMRO,26191,1613023,1083,96705
2020-05-24,US,United States of America,AMRO,25963,1638986,1810,98515
2020-05-25,US,United States of America,AMRO,21465,1660451,937,99452
2020-05-26,US,United States of America,AMRO,20651,1681102,788,100240
2020-05-27,US,United States of America,AMRO,19379,1700481,687,100927
2020-05-28,US,United States of America,AMRO,17510,1717991,811,101738
2020-05-29,US,United States of America,AMRO,19508,1737499,1285,103023
2020-05-30,US,United States of America,AMRO,24182,1761681,1251,104274
2020-05-31,US,United States of America,AMRO,23741,1785422,1051,105325
2020-06-01,US,United States of America,AMRO,24127,1809549,906,106231
2020-06-02,US,United States of America,AMRO,21466,1831015,673,106904
2020-06-03,US,United States of America,AMRO,17157,1848172,691,107595
2020-06-04,US,United States of America,AMRO,20974,1869146,934,108529
2020-06-05,US,United States of America,AMRO,20695,1889841,1022,109551
2020-06-06,US,United States of America,AMRO,20870,1910711,885,110436
2020-06-07,US,United States of America,AMRO,24491,1935202,876,111312
2020-06-08,US,United States of America,AMRO,23285,1958487,669,111981
2020-03-29,VI,United States Virgin Islands,AMRO,0,17,0,0
2020-03-30,VI,United States Virgin Islands,AMRO,5,22,0,0
2020-03-31,VI,United States Virgin Islands,AMRO,8,30,0,0
2020-04-01,VI,United States Virgin Islands,AMRO,0,30,0,0
2020-04-02,VI,United States Virgin Islands,AMRO,0,30,0,0
2020-04-03,VI,United States Virgin Islands,AMRO,3,33,0,0
2020-04-04,VI,United States Virgin Islands,AMRO,4,37,0,0
2020-04-05,VI,United States Virgin Islands,AMRO,3,40,0,0
2020-04-06,VI,United States Virgin Islands,AMRO,2,42,0,0
2020-04-07,VI,United States Virgin Islands,AMRO,1,43,1,1
2020-04-08,VI,United States Virgin Islands,AMRO,0,43,0,1
2020-04-09,VI,United States Virgin Islands,AMRO,2,45,0,1
2020-04-10,VI,United States Virgin Islands,AMRO,1,46,0,1
2020-04-11,VI,United States Virgin Islands,AMRO,4,50,0,1
2020-04-12,VI,United States Virgin Islands,AMRO,1,51,0,1
2020-04-13,VI,United States Virgin Islands,AMRO,0,51,0,1
2020-04-14,VI,United States Virgin Islands,AMRO,0,51,0,1
2020-04-15,VI,United States Virgin Islands,AMRO,0,51,0,1
2020-04-16,VI,United States Virgin Islands,AMRO,0,51,0,1
2020-04-17,VI,United States Virgin Islands,AMRO,0,51,0,1
2020-04-18,VI,United States Virgin Islands,AMRO,0,51,1,2
2020-04-19,VI,United States Virgin Islands,AMRO,2,53,1,3
2020-04-20,VI,United States Virgin Islands,AMRO,0,53,0,3
2020-04-21,VI,United States Virgin Islands,AMRO,0,53,0,3
2020-04-22,VI,United States Virgin Islands,AMRO,1,54,0,3
2020-04-23,VI,United States Virgin Islands,AMRO,0,54,0,3
2020-04-24,VI,United States Virgin Islands,AMRO,0,54,0,3
2020-04-25,VI,United States Virgin Islands,AMRO,0,54,0,3
2020-04-26,VI,United States Virgin Islands,AMRO,1,55,0,3
2020-04-27,VI,United States Virgin Islands,AMRO,0,55,0,3
2020-04-28,VI,United States Virgin Islands,AMRO,4,59,1,4
2020-04-29,VI,United States Virgin Islands,AMRO,0,59,0,4
2020-04-30,VI,United States Virgin Islands,AMRO,3,62,0,4
2020-05-01,VI,United States Virgin Islands,AMRO,4,66,0,4
2020-05-02,VI,United States Virgin Islands,AMRO,0,66,0,4
2020-05-03,VI,United States Virgin Islands,AMRO,0,66,0,4
2020-05-04,VI,United States Virgin Islands,AMRO,0,66,0,4
2020-05-05,VI,United States Virgin Islands,AMRO,0,66,0,4
2020-05-06,VI,United States Virgin Islands,AMRO,0,66,0,4
2020-05-07,VI,United States Virgin Islands,AMRO,0,66,0,4
2020-05-08,VI,United States Virgin Islands,AMRO,0,66,0,4
2020-05-09,VI,United States Virgin Islands,AMRO,2,68,0,4
2020-05-10,VI,United States Virgin Islands,AMRO,0,68,0,4
2020-05-11,VI,United States Virgin Islands,AMRO,1,69,0,4
2020-05-12,VI,United States Virgin Islands,AMRO,0,69,1,5
2020-05-13,VI,United States Virgin Islands,AMRO,0,69,0,5
2020-05-14,VI,United States Virgin Islands,AMRO,0,69,1,6
2020-05-15,VI,United States Virgin Islands,AMRO,0,69,0,6
2020-05-16,VI,United States Virgin Islands,AMRO,0,69,0,6
2020-05-17,VI,United States Virgin Islands,AMRO,0,69,0,6
2020-05-18,VI,United States Virgin Islands,AMRO,0,69,0,6
2020-05-19,VI,United States Virgin Islands,AMRO,0,69,0,6
2020-05-20,VI,United States Virgin Islands,AMRO,0,69,0,6
2020-05-21,VI,United States Virgin Islands,AMRO,0,69,0,6
2020-05-22,VI,United States Virgin Islands,AMRO,0,69,0,6
2020-05-23,VI,United States Virgin Islands,AMRO,0,69,0,6
2020-05-24,VI,United States Virgin Islands,AMRO,0,69,0,6
2020-05-25,VI,United States Virgin Islands,AMRO,0,69,0,6
2020-05-26,VI,United States Virgin Islands,AMRO,0,69,0,6
2020-05-27,VI,United States Virgin Islands,AMRO,0,69,0,6
2020-05-28,VI,United States Virgin Islands,AMRO,0,69,0,6
2020-05-29,VI,United States Virgin Islands,AMRO,0,69,0,6
2020-05-30,VI,United States Virgin Islands,AMRO,0,69,0,6
2020-05-31,VI,United States Virgin Islands,AMRO,0,69,0,6
2020-06-01,VI,United States Virgin Islands,AMRO,0,69,0,6
2020-06-02,VI,United States Virgin Islands,AMRO,1,70,0,6
2020-06-03,VI,United States Virgin Islands,AMRO,0,70,0,6
2020-06-04,VI,United States Virgin Islands,AMRO,0,70,0,6
2020-06-05,VI,United States Virgin Islands,AMRO,1,71,0,6
2020-06-06,VI,United States Virgin Islands,AMRO,0,71,0,6
2020-06-07,VI,United States Virgin Islands,AMRO,0,71,0,6
2020-06-08,VI,United States Virgin Islands,AMRO,0,71,0,6
2020-03-29,UY,Uruguay,AMRO,36,274,0,0
2020-03-30,UY,Uruguay,AMRO,29,303,0,0
2020-03-31,UY,Uruguay,AMRO,6,309,0,0
2020-04-01,UY,Uruguay,AMRO,11,320,1,1
2020-04-02,UY,Uruguay,AMRO,18,338,1,2
2020-04-03,UY,Uruguay,AMRO,12,350,2,4
2020-04-04,UY,Uruguay,AMRO,19,369,0,4
2020-04-05,UY,Uruguay,AMRO,17,386,0,4
2020-04-06,UY,Uruguay,AMRO,14,400,1,5
2020-04-07,UY,Uruguay,AMRO,6,406,1,6
2020-04-08,UY,Uruguay,AMRO,9,415,0,6
2020-04-09,UY,Uruguay,AMRO,9,424,1,7
2020-04-10,UY,Uruguay,AMRO,32,456,0,7
2020-04-11,UY,Uruguay,AMRO,17,473,0,7
2020-04-12,UY,Uruguay,AMRO,21,494,0,7
2020-04-13,UY,Uruguay,AMRO,7,501,0,7
2020-04-14,UY,Uruguay,AMRO,11,512,0,7
2020-04-15,UY,Uruguay,AMRO,-29,483,1,8
2020-04-16,UY,Uruguay,AMRO,9,492,0,8
2020-04-17,UY,Uruguay,AMRO,1,493,1,9
2020-04-18,UY,Uruguay,AMRO,9,502,0,9
2020-04-19,UY,Uruguay,AMRO,6,508,0,9
2020-04-20,UY,Uruguay,AMRO,9,517,0,9
2020-04-21,UY,Uruguay,AMRO,11,528,1,10
2020-04-22,UY,Uruguay,AMRO,7,535,0,10
2020-04-23,UY,Uruguay,AMRO,8,543,2,12
2020-04-24,UY,Uruguay,AMRO,6,549,0,12
2020-04-25,UY,Uruguay,AMRO,8,557,0,12
2020-04-26,UY,Uruguay,AMRO,6,563,0,12
2020-04-27,UY,Uruguay,AMRO,33,596,2,14
2020-04-28,UY,Uruguay,AMRO,10,606,1,15
2020-04-29,UY,Uruguay,AMRO,14,620,0,15
2020-04-30,UY,Uruguay,AMRO,5,625,0,15
2020-05-01,UY,Uruguay,AMRO,5,630,0,15
2020-05-02,UY,Uruguay,AMRO,13,643,2,17
2020-05-03,UY,Uruguay,AMRO,5,648,0,17
2020-05-04,UY,Uruguay,AMRO,4,652,0,17
2020-05-05,UY,Uruguay,AMRO,3,655,0,17
2020-05-06,UY,Uruguay,AMRO,2,657,0,17
2020-05-07,UY,Uruguay,AMRO,13,670,0,17
2020-05-08,UY,Uruguay,AMRO,3,673,0,17
2020-05-09,UY,Uruguay,AMRO,11,684,0,17
2020-05-10,UY,Uruguay,AMRO,10,694,0,17
2020-05-11,UY,Uruguay,AMRO,8,702,0,17
2020-05-12,UY,Uruguay,AMRO,5,707,2,19
2020-05-13,UY,Uruguay,AMRO,4,711,0,19
2020-05-14,UY,Uruguay,AMRO,6,717,0,19
2020-05-15,UY,Uruguay,AMRO,2,719,0,19
2020-05-16,UY,Uruguay,AMRO,5,724,0,19
2020-05-17,UY,Uruguay,AMRO,8,732,0,19
2020-05-18,UY,Uruguay,AMRO,1,733,0,19
2020-05-19,UY,Uruguay,AMRO,1,734,1,20
2020-05-20,UY,Uruguay,AMRO,3,737,0,20
2020-05-21,UY,Uruguay,AMRO,1,738,0,20
2020-05-22,UY,Uruguay,AMRO,8,746,0,20
2020-05-23,UY,Uruguay,AMRO,3,749,0,20
2020-05-24,UY,Uruguay,AMRO,4,753,0,20
2020-05-25,UY,Uruguay,AMRO,11,764,2,22
2020-05-26,UY,Uruguay,AMRO,5,769,0,22
2020-05-27,UY,Uruguay,AMRO,18,787,0,22
2020-05-28,UY,Uruguay,AMRO,2,789,0,22
2020-05-29,UY,Uruguay,AMRO,14,803,0,22
2020-05-30,UY,Uruguay,AMRO,8,811,0,22
2020-05-31,UY,Uruguay,AMRO,5,816,0,22
2020-06-01,UY,Uruguay,AMRO,5,821,0,22
2020-06-02,UY,Uruguay,AMRO,2,823,0,22
2020-06-03,UY,Uruguay,AMRO,2,825,1,23
2020-06-04,UY,Uruguay,AMRO,1,826,0,23
2020-06-05,UY,Uruguay,AMRO,2,828,0,23
2020-06-06,UY,Uruguay,AMRO,4,832,0,23
2020-06-07,UY,Uruguay,AMRO,2,834,0,23
2020-06-08,UY,Uruguay,AMRO,11,845,0,23
2020-03-29,UZ,Uzbekistan,EURO,40,144,1,2
2020-03-30,UZ,Uzbekistan,EURO,5,149,0,2
2020-03-31,UZ,Uzbekistan,EURO,18,167,0,2
2020-04-01,UZ,Uzbekistan,EURO,6,173,0,2
2020-04-02,UZ,Uzbekistan,EURO,17,190,0,2
2020-04-03,UZ,Uzbekistan,EURO,31,221,0,2
2020-04-04,UZ,Uzbekistan,EURO,20,241,0,2
2020-04-05,UZ,Uzbekistan,EURO,57,298,0,2
2020-04-06,UZ,Uzbekistan,EURO,92,390,0,2
2020-04-07,UZ,Uzbekistan,EURO,82,472,0,2
2020-04-08,UZ,Uzbekistan,EURO,62,534,1,3
2020-04-09,UZ,Uzbekistan,EURO,21,555,0,3
2020-04-10,UZ,Uzbekistan,EURO,69,624,0,3
2020-04-11,UZ,Uzbekistan,EURO,0,624,0,3
2020-04-12,UZ,Uzbekistan,EURO,172,796,0,3
2020-04-13,UZ,Uzbekistan,EURO,100,896,1,4
2020-04-14,UZ,Uzbekistan,EURO,158,1054,0,4
2020-04-15,UZ,Uzbekistan,EURO,160,1214,0,4
2020-04-16,UZ,Uzbekistan,EURO,135,1349,0,4
2020-04-17,UZ,Uzbekistan,EURO,31,1380,0,4
2020-04-18,UZ,Uzbekistan,EURO,70,1450,0,4
2020-04-19,UZ,Uzbekistan,EURO,45,1495,1,5
2020-04-20,UZ,Uzbekistan,EURO,70,1565,0,5
2020-04-21,UZ,Uzbekistan,EURO,92,1657,0,5
2020-04-22,UZ,Uzbekistan,EURO,0,1657,1,6
2020-04-23,UZ,Uzbekistan,EURO,59,1716,1,7
2020-04-24,UZ,Uzbekistan,EURO,62,1778,0,7
2020-04-25,UZ,Uzbekistan,EURO,58,1836,1,8
2020-04-26,UZ,Uzbekistan,EURO,29,1865,0,8
2020-04-27,UZ,Uzbekistan,EURO,22,1887,0,8
2020-04-28,UZ,Uzbekistan,EURO,37,1924,0,8
2020-04-29,UZ,Uzbekistan,EURO,31,1955,0,8
2020-04-30,UZ,Uzbekistan,EURO,76,2031,1,9
2020-05-01,UZ,Uzbekistan,EURO,15,2046,0,9
2020-05-02,UZ,Uzbekistan,EURO,48,2094,0,9
2020-05-03,UZ,Uzbekistan,EURO,33,2127,0,9
2020-05-04,UZ,Uzbekistan,EURO,33,2160,1,10
2020-05-05,UZ,Uzbekistan,EURO,29,2189,0,10
2020-05-06,UZ,Uzbekistan,EURO,28,2217,0,10
2020-05-07,UZ,Uzbekistan,EURO,49,2266,0,10
2020-05-08,UZ,Uzbekistan,EURO,48,2314,0,10
2020-05-09,UZ,Uzbekistan,EURO,22,2336,0,10
2020-05-10,UZ,Uzbekistan,EURO,51,2387,0,10
2020-05-11,UZ,Uzbekistan,EURO,24,2411,0,10
2020-05-12,UZ,Uzbekistan,EURO,98,2509,0,10
2020-05-13,UZ,Uzbekistan,EURO,89,2598,0,10
2020-05-14,UZ,Uzbekistan,EURO,22,2620,1,11
2020-05-15,UZ,Uzbekistan,EURO,32,2652,0,11
2020-05-16,UZ,Uzbekistan,EURO,39,2691,0,11
2020-05-17,UZ,Uzbekistan,EURO,50,2741,0,11
2020-05-18,UZ,Uzbekistan,EURO,21,2762,1,12
2020-05-19,UZ,Uzbekistan,EURO,40,2802,1,13
2020-05-20,UZ,Uzbekistan,EURO,78,2880,0,13
2020-05-21,UZ,Uzbekistan,EURO,70,2950,0,13
2020-05-22,UZ,Uzbekistan,EURO,56,3006,0,13
2020-05-23,UZ,Uzbekistan,EURO,72,3078,0,13
2020-05-24,UZ,Uzbekistan,EURO,54,3132,0,13
2020-05-25,UZ,Uzbekistan,EURO,48,3180,0,13
2020-05-26,UZ,Uzbekistan,EURO,81,3261,0,13
2020-05-27,UZ,Uzbekistan,EURO,72,3333,1,14
2020-05-28,UZ,Uzbekistan,EURO,63,3396,0,14
2020-05-29,UZ,Uzbekistan,EURO,67,3463,0,14
2020-05-30,UZ,Uzbekistan,EURO,50,3513,0,14
2020-05-31,UZ,Uzbekistan,EURO,41,3554,0,14
2020-06-01,UZ,Uzbekistan,EURO,108,3662,1,15
2020-06-02,UZ,Uzbekistan,EURO,56,3718,0,15
2020-06-03,UZ,Uzbekistan,EURO,0,3718,0,15
2020-06-04,UZ,Uzbekistan,EURO,156,3874,1,16
2020-06-05,UZ,Uzbekistan,EURO,91,3965,0,16
2020-06-06,UZ,Uzbekistan,EURO,57,4022,0,16
2020-06-07,UZ,Uzbekistan,EURO,159,4181,1,17
2020-06-08,UZ,Uzbekistan,EURO,171,4352,0,17
2020-03-29,VU,Vanuatu,WPRO,0,0,0,0
2020-03-30,VU,Vanuatu,WPRO,0,0,0,0
2020-03-31,VU,Vanuatu,WPRO,0,0,0,0
2020-04-01,VU,Vanuatu,WPRO,0,0,0,0
2020-04-02,VU,Vanuatu,WPRO,0,0,0,0
2020-04-03,VU,Vanuatu,WPRO,0,0,0,0
2020-04-04,VU,Vanuatu,WPRO,0,0,0,0
2020-04-05,VU,Vanuatu,WPRO,0,0,0,0
2020-04-06,VU,Vanuatu,WPRO,0,0,0,0
2020-04-07,VU,Vanuatu,WPRO,0,0,0,0
2020-04-08,VU,Vanuatu,WPRO,0,0,0,0
2020-04-09,VU,Vanuatu,WPRO,0,0,0,0
2020-04-10,VU,Vanuatu,WPRO,0,0,0,0
2020-04-11,VU,Vanuatu,WPRO,0,0,0,0
2020-04-12,VU,Vanuatu,WPRO,0,0,0,0
2020-04-13,VU,Vanuatu,WPRO,0,0,0,0
2020-04-14,VU,Vanuatu,WPRO,0,0,0,0
2020-04-15,VU,Vanuatu,WPRO,0,0,0,0
2020-04-16,VU,Vanuatu,WPRO,0,0,0,0
2020-04-17,VU,Vanuatu,WPRO,0,0,0,0
2020-04-18,VU,Vanuatu,WPRO,0,0,0,0
2020-04-19,VU,Vanuatu,WPRO,0,0,0,0
2020-04-20,VU,Vanuatu,WPRO,0,0,0,0
2020-04-21,VU,Vanuatu,WPRO,0,0,0,0
2020-04-22,VU,Vanuatu,WPRO,0,0,0,0
2020-04-23,VU,Vanuatu,WPRO,0,0,0,0
2020-04-24,VU,Vanuatu,WPRO,0,0,0,0
2020-04-25,VU,Vanuatu,WPRO,0,0,0,0
2020-04-26,VU,Vanuatu,WPRO,0,0,0,0
2020-04-27,VU,Vanuatu,WPRO,0,0,0,0
2020-04-28,VU,Vanuatu,WPRO,0,0,0,0
2020-04-29,VU,Vanuatu,WPRO,0,0,0,0
2020-04-30,VU,Vanuatu,WPRO,0,0,0,0
2020-05-01,VU,Vanuatu,WPRO,0,0,0,0
2020-05-02,VU,Vanuatu,WPRO,0,0,0,0
2020-05-03,VU,Vanuatu,WPRO,0,0,0,0
2020-05-04,VU,Vanuatu,WPRO,0,0,0,0
2020-05-05,VU,Vanuatu,WPRO,0,0,0,0
2020-05-06,VU,Vanuatu,WPRO,0,0,0,0
2020-05-07,VU,Vanuatu,WPRO,0,0,0,0
2020-05-08,VU,Vanuatu,WPRO,0,0,0,0
2020-05-09,VU,Vanuatu,WPRO,0,0,0,0
2020-05-10,VU,Vanuatu,WPRO,0,0,0,0
2020-05-11,VU,Vanuatu,WPRO,0,0,0,0
2020-05-12,VU,Vanuatu,WPRO,0,0,0,0
2020-05-13,VU,Vanuatu,WPRO,0,0,0,0
2020-05-14,VU,Vanuatu,WPRO,0,0,0,0
2020-05-15,VU,Vanuatu,WPRO,0,0,0,0
2020-05-16,VU,Vanuatu,WPRO,0,0,0,0
2020-05-17,VU,Vanuatu,WPRO,0,0,0,0
2020-05-18,VU,Vanuatu,WPRO,0,0,0,0
2020-05-19,VU,Vanuatu,WPRO,0,0,0,0
2020-05-20,VU,Vanuatu,WPRO,0,0,0,0
2020-05-21,VU,Vanuatu,WPRO,0,0,0,0
2020-05-22,VU,Vanuatu,WPRO,0,0,0,0
2020-05-23,VU,Vanuatu,WPRO,0,0,0,0
2020-05-24,VU,Vanuatu,WPRO,0,0,0,0
2020-05-25,VU,Vanuatu,WPRO,0,0,0,0
2020-05-26,VU,Vanuatu,WPRO,0,0,0,0
2020-05-27,VU,Vanuatu,WPRO,0,0,0,0
2020-05-28,VU,Vanuatu,WPRO,0,0,0,0
2020-05-29,VU,Vanuatu,WPRO,0,0,0,0
2020-05-30,VU,Vanuatu,WPRO,0,0,0,0
2020-05-31,VU,Vanuatu,WPRO,0,0,0,0
2020-06-01,VU,Vanuatu,WPRO,0,0,0,0
2020-06-02,VU,Vanuatu,WPRO,0,0,0,0
2020-06-03,VU,Vanuatu,WPRO,0,0,0,0
2020-06-04,VU,Vanuatu,WPRO,0,0,0,0
2020-06-05,VU,Vanuatu,WPRO,0,0,0,0
2020-06-06,VU,Vanuatu,WPRO,0,0,0,0
2020-06-07,VU,Vanuatu,WPRO,0,0,0,0
2020-06-08,VU,Vanuatu,WPRO,0,0,0,0
2020-03-29,VE,Venezuela (Bolivarian Republic of),AMRO,7,113,2,2
2020-03-30,VE,Venezuela (Bolivarian Republic of),AMRO,0,113,0,2
2020-03-31,VE,Venezuela (Bolivarian Republic of),AMRO,16,129,1,3
2020-04-01,VE,Venezuela (Bolivarian Republic of),AMRO,0,129,0,3
2020-04-02,VE,Venezuela (Bolivarian Republic of),AMRO,14,143,0,3
2020-04-03,VE,Venezuela (Bolivarian Republic of),AMRO,1,144,0,3
2020-04-04,VE,Venezuela (Bolivarian Republic of),AMRO,0,144,0,3
2020-04-05,VE,Venezuela (Bolivarian Republic of),AMRO,0,144,0,3
2020-04-06,VE,Venezuela (Bolivarian Republic of),AMRO,0,144,0,3
2020-04-07,VE,Venezuela (Bolivarian Republic of),AMRO,15,159,0,3
2020-04-08,VE,Venezuela (Bolivarian Republic of),AMRO,6,165,4,7
2020-04-09,VE,Venezuela (Bolivarian Republic of),AMRO,1,166,0,7
2020-04-10,VE,Venezuela (Bolivarian Republic of),AMRO,0,166,0,7
2020-04-11,VE,Venezuela (Bolivarian Republic of),AMRO,5,171,2,9
2020-04-12,VE,Venezuela (Bolivarian Republic of),AMRO,0,171,0,9
2020-04-13,VE,Venezuela (Bolivarian Republic of),AMRO,0,171,0,9
2020-04-14,VE,Venezuela (Bolivarian Republic of),AMRO,10,181,0,9
2020-04-15,VE,Venezuela (Bolivarian Republic of),AMRO,0,181,0,9
2020-04-16,VE,Venezuela (Bolivarian Republic of),AMRO,12,193,0,9
2020-04-17,VE,Venezuela (Bolivarian Republic of),AMRO,4,197,0,9
2020-04-18,VE,Venezuela (Bolivarian Republic of),AMRO,7,204,0,9
2020-04-19,VE,Venezuela (Bolivarian Republic of),AMRO,0,204,0,9
2020-04-20,VE,Venezuela (Bolivarian Republic of),AMRO,24,228,0,9
2020-04-21,VE,Venezuela (Bolivarian Republic of),AMRO,28,256,0,9
2020-04-22,VE,Venezuela (Bolivarian Republic of),AMRO,29,285,1,10
2020-04-23,VE,Venezuela (Bolivarian Republic of),AMRO,3,288,0,10
2020-04-24,VE,Venezuela (Bolivarian Republic of),AMRO,10,298,0,10
2020-04-25,VE,Venezuela (Bolivarian Republic of),AMRO,20,318,0,10
2020-04-26,VE,Venezuela (Bolivarian Republic of),AMRO,0,318,0,10
2020-04-27,VE,Venezuela (Bolivarian Republic of),AMRO,5,323,0,10
2020-04-28,VE,Venezuela (Bolivarian Republic of),AMRO,2,325,0,10
2020-04-29,VE,Venezuela (Bolivarian Republic of),AMRO,4,329,0,10
2020-04-30,VE,Venezuela (Bolivarian Republic of),AMRO,0,329,0,10
2020-05-01,VE,Venezuela (Bolivarian Republic of),AMRO,2,331,0,10
2020-05-02,VE,Venezuela (Bolivarian Republic of),AMRO,2,333,0,10
2020-05-03,VE,Venezuela (Bolivarian Republic of),AMRO,12,345,0,10
2020-05-04,VE,Venezuela (Bolivarian Republic of),AMRO,0,345,0,10
2020-05-05,VE,Venezuela (Bolivarian Republic of),AMRO,12,357,0,10
2020-05-06,VE,Venezuela (Bolivarian Republic of),AMRO,4,361,0,10
2020-05-07,VE,Venezuela (Bolivarian Republic of),AMRO,6,367,0,10
2020-05-08,VE,Venezuela (Bolivarian Republic of),AMRO,12,379,0,10
2020-05-09,VE,Venezuela (Bolivarian Republic of),AMRO,2,381,0,10
2020-05-10,VE,Venezuela (Bolivarian Republic of),AMRO,7,388,0,10
2020-05-11,VE,Venezuela (Bolivarian Republic of),AMRO,14,402,0,10
2020-05-12,VE,Venezuela (Bolivarian Republic of),AMRO,12,414,0,10
2020-05-13,VE,Venezuela (Bolivarian Republic of),AMRO,8,422,0,10
2020-05-14,VE,Venezuela (Bolivarian Republic of),AMRO,18,440,0,10
2020-05-15,VE,Venezuela (Bolivarian Republic of),AMRO,0,440,0,10
2020-05-16,VE,Venezuela (Bolivarian Republic of),AMRO,15,455,0,10
2020-05-17,VE,Venezuela (Bolivarian Republic of),AMRO,49,504,0,10
2020-05-18,VE,Venezuela (Bolivarian Republic of),AMRO,37,541,0,10
2020-05-19,VE,Venezuela (Bolivarian Republic of),AMRO,77,618,0,10
2020-05-20,VE,Venezuela (Bolivarian Republic of),AMRO,0,618,0,10
2020-05-21,VE,Venezuela (Bolivarian Republic of),AMRO,206,824,0,10
2020-05-22,VE,Venezuela (Bolivarian Republic of),AMRO,0,824,0,10
2020-05-23,VE,Venezuela (Bolivarian Republic of),AMRO,58,882,0,10
2020-05-24,VE,Venezuela (Bolivarian Republic of),AMRO,62,944,0,10
2020-05-25,VE,Venezuela (Bolivarian Republic of),AMRO,66,1010,0,10
2020-05-26,VE,Venezuela (Bolivarian Republic of),AMRO,111,1121,0,10
2020-05-27,VE,Venezuela (Bolivarian Republic of),AMRO,56,1177,0,10
2020-05-28,VE,Venezuela (Bolivarian Republic of),AMRO,34,1211,1,11
2020-05-29,VE,Venezuela (Bolivarian Republic of),AMRO,34,1245,0,11
2020-05-30,VE,Venezuela (Bolivarian Republic of),AMRO,82,1327,0,11
2020-05-31,VE,Venezuela (Bolivarian Republic of),AMRO,43,1370,3,14
2020-06-01,VE,Venezuela (Bolivarian Republic of),AMRO,89,1459,0,14
2020-06-02,VE,Venezuela (Bolivarian Republic of),AMRO,51,1510,0,14
2020-06-03,VE,Venezuela (Bolivarian Republic of),AMRO,152,1662,3,17
2020-06-04,VE,Venezuela (Bolivarian Republic of),AMRO,157,1819,1,18
2020-06-05,VE,Venezuela (Bolivarian Republic of),AMRO,133,1952,2,20
2020-06-06,VE,Venezuela (Bolivarian Republic of),AMRO,135,2087,0,20
2020-06-07,VE,Venezuela (Bolivarian Republic of),AMRO,58,2145,0,20
2020-06-08,VE,Venezuela (Bolivarian Republic of),AMRO,171,2316,2,22
2020-03-29,VN,Viet Nam,WPRO,11,174,0,0
2020-03-30,VN,Viet Nam,WPRO,14,188,0,0
2020-03-31,VN,Viet Nam,WPRO,15,203,0,0
2020-04-01,VN,Viet Nam,WPRO,4,207,0,0
2020-04-02,VN,Viet Nam,WPRO,11,218,0,0
2020-04-03,VN,Viet Nam,WPRO,15,233,0,0
2020-04-04,VN,Viet Nam,WPRO,6,239,0,0
2020-04-05,VN,Viet Nam,WPRO,1,240,0,0
2020-04-06,VN,Viet Nam,WPRO,1,241,0,0
2020-04-07,VN,Viet Nam,WPRO,4,245,0,0
2020-04-08,VN,Viet Nam,WPRO,4,249,0,0
2020-04-09,VN,Viet Nam,WPRO,2,251,0,0
2020-04-10,VN,Viet Nam,WPRO,4,255,0,0
2020-04-11,VN,Viet Nam,WPRO,2,257,0,0
2020-04-12,VN,Viet Nam,WPRO,1,258,0,0
2020-04-13,VN,Viet Nam,WPRO,4,262,0,0
2020-04-14,VN,Viet Nam,WPRO,3,265,0,0
2020-04-15,VN,Viet Nam,WPRO,1,266,0,0
2020-04-16,VN,Viet Nam,WPRO,1,267,0,0
2020-04-17,VN,Viet Nam,WPRO,1,268,0,0
2020-04-18,VN,Viet Nam,WPRO,0,268,0,0
2020-04-19,VN,Viet Nam,WPRO,0,268,0,0
2020-04-20,VN,Viet Nam,WPRO,0,268,0,0
2020-04-21,VN,Viet Nam,WPRO,0,268,0,0
2020-04-22,VN,Viet Nam,WPRO,0,268,0,0
2020-04-23,VN,Viet Nam,WPRO,0,268,0,0
2020-04-24,VN,Viet Nam,WPRO,0,268,0,0
2020-04-25,VN,Viet Nam,WPRO,2,270,0,0
2020-04-26,VN,Viet Nam,WPRO,0,270,0,0
2020-04-27,VN,Viet Nam,WPRO,0,270,0,0
2020-04-28,VN,Viet Nam,WPRO,0,270,0,0
2020-04-29,VN,Viet Nam,WPRO,0,270,0,0
2020-04-30,VN,Viet Nam,WPRO,0,270,0,0
2020-05-01,VN,Viet Nam,WPRO,0,270,0,0
2020-05-02,VN,Viet Nam,WPRO,0,270,0,0
2020-05-03,VN,Viet Nam,WPRO,0,270,0,0
2020-05-04,VN,Viet Nam,WPRO,1,271,0,0
2020-05-05,VN,Viet Nam,WPRO,0,271,0,0
2020-05-06,VN,Viet Nam,WPRO,0,271,0,0
2020-05-07,VN,Viet Nam,WPRO,0,271,0,0
2020-05-08,VN,Viet Nam,WPRO,17,288,0,0
2020-05-09,VN,Viet Nam,WPRO,0,288,0,0
2020-05-10,VN,Viet Nam,WPRO,0,288,0,0
2020-05-11,VN,Viet Nam,WPRO,0,288,0,0
2020-05-12,VN,Viet Nam,WPRO,0,288,0,0
2020-05-13,VN,Viet Nam,WPRO,0,288,0,0
2020-05-14,VN,Viet Nam,WPRO,0,288,0,0
2020-05-15,VN,Viet Nam,WPRO,0,288,0,0
2020-05-16,VN,Viet Nam,WPRO,25,313,0,0
2020-05-17,VN,Viet Nam,WPRO,5,318,0,0
2020-05-18,VN,Viet Nam,WPRO,2,320,0,0
2020-05-19,VN,Viet Nam,WPRO,4,324,0,0
2020-05-20,VN,Viet Nam,WPRO,0,324,0,0
2020-05-21,VN,Viet Nam,WPRO,0,324,0,0
2020-05-22,VN,Viet Nam,WPRO,0,324,0,0
2020-05-23,VN,Viet Nam,WPRO,0,324,0,0
2020-05-24,VN,Viet Nam,WPRO,1,325,0,0
2020-05-25,VN,Viet Nam,WPRO,0,325,0,0
2020-05-26,VN,Viet Nam,WPRO,1,326,0,0
2020-05-27,VN,Viet Nam,WPRO,1,327,0,0
2020-05-28,VN,Viet Nam,WPRO,0,327,0,0
2020-05-29,VN,Viet Nam,WPRO,0,327,0,0
2020-05-30,VN,Viet Nam,WPRO,0,327,0,0
2020-05-31,VN,Viet Nam,WPRO,1,328,0,0
2020-06-01,VN,Viet Nam,WPRO,0,328,0,0
2020-06-02,VN,Viet Nam,WPRO,0,328,0,0
2020-06-03,VN,Viet Nam,WPRO,0,328,0,0
2020-06-04,VN,Viet Nam,WPRO,0,328,0,0
2020-06-05,VN,Viet Nam,WPRO,0,328,0,0
2020-06-06,VN,Viet Nam,WPRO,1,329,0,0
2020-06-07,VN,Viet Nam,WPRO,0,329,0,0
2020-06-08,VN,Viet Nam,WPRO,0,329,0,0
2020-03-29,WF,Wallis and Futuna,WPRO,0,0,0,0
2020-03-30,WF,Wallis and Futuna,WPRO,0,0,0,0
2020-03-31,WF,Wallis and Futuna,WPRO,0,0,0,0
2020-04-01,WF,Wallis and Futuna,WPRO,0,0,0,0
2020-04-02,WF,Wallis and Futuna,WPRO,0,0,0,0
2020-04-03,WF,Wallis and Futuna,WPRO,0,0,0,0
2020-04-04,WF,Wallis and Futuna,WPRO,0,0,0,0
2020-04-05,WF,Wallis and Futuna,WPRO,0,0,0,0
2020-04-06,WF,Wallis and Futuna,WPRO,0,0,0,0
2020-04-07,WF,Wallis and Futuna,WPRO,0,0,0,0
2020-04-08,WF,Wallis and Futuna,WPRO,0,0,0,0
2020-04-09,WF,Wallis and Futuna,WPRO,0,0,0,0
2020-04-10,WF,Wallis and Futuna,WPRO,0,0,0,0
2020-04-11,WF,Wallis and Futuna,WPRO,0,0,0,0
2020-04-12,WF,Wallis and Futuna,WPRO,0,0,0,0
2020-04-13,WF,Wallis and Futuna,WPRO,0,0,0,0
2020-04-14,WF,Wallis and Futuna,WPRO,0,0,0,0
2020-04-15,WF,Wallis and Futuna,WPRO,0,0,0,0
2020-04-16,WF,Wallis and Futuna,WPRO,0,0,0,0
2020-04-17,WF,Wallis and Futuna,WPRO,0,0,0,0
2020-04-18,WF,Wallis and Futuna,WPRO,0,0,0,0
2020-04-19,WF,Wallis and Futuna,WPRO,0,0,0,0
2020-04-20,WF,Wallis and Futuna,WPRO,0,0,0,0
2020-04-21,WF,Wallis and Futuna,WPRO,0,0,0,0
2020-04-22,WF,Wallis and Futuna,WPRO,0,0,0,0
2020-04-23,WF,Wallis and Futuna,WPRO,0,0,0,0
2020-04-24,WF,Wallis and Futuna,WPRO,0,0,0,0
2020-04-25,WF,Wallis and Futuna,WPRO,0,0,0,0
2020-04-26,WF,Wallis and Futuna,WPRO,0,0,0,0
2020-04-27,WF,Wallis and Futuna,WPRO,0,0,0,0
2020-04-28,WF,Wallis and Futuna,WPRO,0,0,0,0
2020-04-29,WF,Wallis and Futuna,WPRO,0,0,0,0
2020-04-30,WF,Wallis and Futuna,WPRO,0,0,0,0
2020-05-01,WF,Wallis and Futuna,WPRO,0,0,0,0
2020-05-02,WF,Wallis and Futuna,WPRO,0,0,0,0
2020-05-03,WF,Wallis and Futuna,WPRO,0,0,0,0
2020-05-04,WF,Wallis and Futuna,WPRO,0,0,0,0
2020-05-05,WF,Wallis and Futuna,WPRO,0,0,0,0
2020-05-06,WF,Wallis and Futuna,WPRO,0,0,0,0
2020-05-07,WF,Wallis and Futuna,WPRO,0,0,0,0
2020-05-08,WF,Wallis and Futuna,WPRO,0,0,0,0
2020-05-09,WF,Wallis and Futuna,WPRO,0,0,0,0
2020-05-10,WF,Wallis and Futuna,WPRO,0,0,0,0
2020-05-11,WF,Wallis and Futuna,WPRO,0,0,0,0
2020-05-12,WF,Wallis and Futuna,WPRO,0,0,0,0
2020-05-13,WF,Wallis and Futuna,WPRO,0,0,0,0
2020-05-14,WF,Wallis and Futuna,WPRO,0,0,0,0
2020-05-15,WF,Wallis and Futuna,WPRO,0,0,0,0
2020-05-16,WF,Wallis and Futuna,WPRO,0,0,0,0
2020-05-17,WF,Wallis and Futuna,WPRO,0,0,0,0
2020-05-18,WF,Wallis and Futuna,WPRO,0,0,0,0
2020-05-19,WF,Wallis and Futuna,WPRO,0,0,0,0
2020-05-20,WF,Wallis and Futuna,WPRO,0,0,0,0
2020-05-21,WF,Wallis and Futuna,WPRO,0,0,0,0
2020-05-22,WF,Wallis and Futuna,WPRO,0,0,0,0
2020-05-23,WF,Wallis and Futuna,WPRO,0,0,0,0
2020-05-24,WF,Wallis and Futuna,WPRO,0,0,0,0
2020-05-25,WF,Wallis and Futuna,WPRO,0,0,0,0
2020-05-26,WF,Wallis and Futuna,WPRO,0,0,0,0
2020-05-27,WF,Wallis and Futuna,WPRO,0,0,0,0
2020-05-28,WF,Wallis and Futuna,WPRO,0,0,0,0
2020-05-29,WF,Wallis and Futuna,WPRO,0,0,0,0
2020-05-30,WF,Wallis and Futuna,WPRO,0,0,0,0
2020-05-31,WF,Wallis and Futuna,WPRO,0,0,0,0
2020-06-01,WF,Wallis and Futuna,WPRO,0,0,0,0
2020-06-02,WF,Wallis and Futuna,WPRO,0,0,0,0
2020-06-03,WF,Wallis and Futuna,WPRO,0,0,0,0
2020-06-04,WF,Wallis and Futuna,WPRO,0,0,0,0
2020-06-05,WF,Wallis and Futuna,WPRO,0,0,0,0
2020-06-06,WF,Wallis and Futuna,WPRO,0,0,0,0
2020-06-07,WF,Wallis and Futuna,WPRO,0,0,0,0
2020-06-08,WF,Wallis and Futuna,WPRO,0,0,0,0
2020-03-29,YE,Yemen,EMRO,0,0,0,0
2020-03-30,YE,Yemen,EMRO,0,0,0,0
2020-03-31,YE,Yemen,EMRO,0,0,0,0
2020-04-01,YE,Yemen,EMRO,0,0,0,0
2020-04-02,YE,Yemen,EMRO,0,0,0,0
2020-04-03,YE,Yemen,EMRO,0,0,0,0
2020-04-04,YE,Yemen,EMRO,0,0,0,0
2020-04-05,YE,Yemen,EMRO,0,0,0,0
2020-04-06,YE,Yemen,EMRO,0,0,0,0
2020-04-07,YE,Yemen,EMRO,0,0,0,0
2020-04-08,YE,Yemen,EMRO,0,0,0,0
2020-04-09,YE,Yemen,EMRO,0,0,0,0
2020-04-10,YE,Yemen,EMRO,0,0,0,0
2020-04-11,YE,Yemen,EMRO,0,0,0,0
2020-04-12,YE,Yemen,EMRO,1,1,0,0
2020-04-13,YE,Yemen,EMRO,0,1,0,0
2020-04-14,YE,Yemen,EMRO,0,1,0,0
2020-04-15,YE,Yemen,EMRO,0,1,0,0
2020-04-16,YE,Yemen,EMRO,0,1,0,0
2020-04-17,YE,Yemen,EMRO,0,1,0,0
2020-04-18,YE,Yemen,EMRO,0,1,0,0
2020-04-19,YE,Yemen,EMRO,0,1,0,0
2020-04-20,YE,Yemen,EMRO,0,1,0,0
2020-04-21,YE,Yemen,EMRO,0,1,0,0
2020-04-22,YE,Yemen,EMRO,0,1,0,0
2020-04-23,YE,Yemen,EMRO,0,1,0,0
2020-04-24,YE,Yemen,EMRO,0,1,0,0
2020-04-25,YE,Yemen,EMRO,0,1,0,0
2020-04-26,YE,Yemen,EMRO,0,1,0,0
2020-04-27,YE,Yemen,EMRO,0,1,0,0
2020-04-28,YE,Yemen,EMRO,0,1,0,0
2020-04-29,YE,Yemen,EMRO,0,1,0,0
2020-04-30,YE,Yemen,EMRO,5,6,0,0
2020-05-01,YE,Yemen,EMRO,0,6,0,0
2020-05-02,YE,Yemen,EMRO,1,7,2,2
2020-05-03,YE,Yemen,EMRO,3,10,0,2
2020-05-04,YE,Yemen,EMRO,0,10,0,2
2020-05-05,YE,Yemen,EMRO,1,11,0,2
2020-05-06,YE,Yemen,EMRO,9,20,1,3
2020-05-07,YE,Yemen,EMRO,5,25,3,6
2020-05-08,YE,Yemen,EMRO,0,25,0,6
2020-05-09,YE,Yemen,EMRO,9,34,2,8
2020-05-10,YE,Yemen,EMRO,0,34,0,8
2020-05-11,YE,Yemen,EMRO,17,51,1,9
2020-05-12,YE,Yemen,EMRO,5,56,1,10
2020-05-13,YE,Yemen,EMRO,9,65,1,11
2020-05-14,YE,Yemen,EMRO,5,70,2,13
2020-05-15,YE,Yemen,EMRO,15,85,0,13
2020-05-16,YE,Yemen,EMRO,21,106,3,16
2020-05-17,YE,Yemen,EMRO,16,122,2,18
2020-05-18,YE,Yemen,EMRO,6,128,2,20
2020-05-19,YE,Yemen,EMRO,2,130,0,20
2020-05-20,YE,Yemen,EMRO,37,167,8,28
2020-05-21,YE,Yemen,EMRO,13,180,1,29
2020-05-22,YE,Yemen,EMRO,13,193,3,32
2020-05-23,YE,Yemen,EMRO,12,205,1,33
2020-05-24,YE,Yemen,EMRO,7,212,6,39
2020-05-25,YE,Yemen,EMRO,10,222,3,42
2020-05-26,YE,Yemen,EMRO,11,233,2,44
2020-05-27,YE,Yemen,EMRO,16,249,5,49
2020-05-28,YE,Yemen,EMRO,7,256,4,53
2020-05-29,YE,Yemen,EMRO,22,278,4,57
2020-05-30,YE,Yemen,EMRO,5,283,8,65
2020-05-31,YE,Yemen,EMRO,27,310,12,77
2020-06-01,YE,Yemen,EMRO,13,323,3,80
2020-06-02,YE,Yemen,EMRO,31,354,4,84
2020-06-03,YE,Yemen,EMRO,45,399,3,87
2020-06-04,YE,Yemen,EMRO,20,419,8,95
2020-06-05,YE,Yemen,EMRO,34,453,8,103
2020-06-06,YE,Yemen,EMRO,16,469,8,111
2020-06-07,YE,Yemen,EMRO,13,482,0,111
2020-06-08,YE,Yemen,EMRO,2,484,1,112
2020-03-29,ZM,Zambia,AFRO,6,28,0,3
2020-03-30,ZM,Zambia,AFRO,1,29,0,3
2020-03-31,ZM,Zambia,AFRO,6,35,0,3
2020-04-01,ZM,Zambia,AFRO,1,36,0,3
2020-04-02,ZM,Zambia,AFRO,0,36,0,3
2020-04-03,ZM,Zambia,AFRO,3,39,0,3
2020-04-04,ZM,Zambia,AFRO,0,39,0,3
2020-04-05,ZM,Zambia,AFRO,0,39,0,3
2020-04-06,ZM,Zambia,AFRO,0,39,0,3
2020-04-07,ZM,Zambia,AFRO,0,39,0,3
2020-04-08,ZM,Zambia,AFRO,0,39,0,3
2020-04-09,ZM,Zambia,AFRO,0,39,0,3
2020-04-10,ZM,Zambia,AFRO,0,39,0,3
2020-04-11,ZM,Zambia,AFRO,1,40,1,4
2020-04-12,ZM,Zambia,AFRO,0,40,0,4
2020-04-13,ZM,Zambia,AFRO,3,43,0,4
2020-04-14,ZM,Zambia,AFRO,2,45,0,4
2020-04-15,ZM,Zambia,AFRO,0,45,0,4
2020-04-16,ZM,Zambia,AFRO,3,48,0,4
2020-04-17,ZM,Zambia,AFRO,0,48,0,4
2020-04-18,ZM,Zambia,AFRO,4,52,0,4
2020-04-19,ZM,Zambia,AFRO,5,57,0,4
2020-04-20,ZM,Zambia,AFRO,4,61,1,5
2020-04-21,ZM,Zambia,AFRO,4,65,0,5
2020-04-22,ZM,Zambia,AFRO,5,70,0,5
2020-04-23,ZM,Zambia,AFRO,4,74,0,5
2020-04-24,ZM,Zambia,AFRO,2,76,0,5
2020-04-25,ZM,Zambia,AFRO,8,84,0,5
2020-04-26,ZM,Zambia,AFRO,0,84,0,5
2020-04-27,ZM,Zambia,AFRO,3,87,0,5
2020-04-28,ZM,Zambia,AFRO,2,89,0,5
2020-04-29,ZM,Zambia,AFRO,6,95,0,5
2020-04-30,ZM,Zambia,AFRO,2,97,0,5
2020-05-01,ZM,Zambia,AFRO,9,106,0,5
2020-05-02,ZM,Zambia,AFRO,3,109,0,5
2020-05-03,ZM,Zambia,AFRO,10,119,0,5
2020-05-04,ZM,Zambia,AFRO,5,124,0,5
2020-05-05,ZM,Zambia,AFRO,13,137,0,5
2020-05-06,ZM,Zambia,AFRO,2,139,1,6
2020-05-07,ZM,Zambia,AFRO,7,146,0,6
2020-05-08,ZM,Zambia,AFRO,7,153,0,6
2020-05-09,ZM,Zambia,AFRO,14,167,0,6
2020-05-10,ZM,Zambia,AFRO,85,252,3,9
2020-05-11,ZM,Zambia,AFRO,15,267,0,9
2020-05-12,ZM,Zambia,AFRO,0,267,0,9
2020-05-13,ZM,Zambia,AFRO,174,441,0,9
2020-05-14,ZM,Zambia,AFRO,5,446,0,9
2020-05-15,ZM,Zambia,AFRO,208,654,0,9
2020-05-16,ZM,Zambia,AFRO,14,668,0,9
2020-05-17,ZM,Zambia,AFRO,11,679,0,9
2020-05-18,ZM,Zambia,AFRO,74,753,0,9
2020-05-19,ZM,Zambia,AFRO,8,761,0,9
2020-05-20,ZM,Zambia,AFRO,11,772,0,9
2020-05-21,ZM,Zambia,AFRO,60,832,0,9
2020-05-22,ZM,Zambia,AFRO,34,866,0,9
2020-05-23,ZM,Zambia,AFRO,54,920,0,9
2020-05-24,ZM,Zambia,AFRO,0,920,0,9
2020-05-25,ZM,Zambia,AFRO,0,920,0,9
2020-05-26,ZM,Zambia,AFRO,0,920,0,9
2020-05-27,ZM,Zambia,AFRO,0,920,0,9
2020-05-28,ZM,Zambia,AFRO,137,1057,0,9
2020-05-29,ZM,Zambia,AFRO,0,1057,0,9
2020-05-30,ZM,Zambia,AFRO,0,1057,0,9
2020-05-31,ZM,Zambia,AFRO,0,1057,0,9
2020-06-01,ZM,Zambia,AFRO,22,1079,0,9
2020-06-02,ZM,Zambia,AFRO,32,1111,0,9
2020-06-03,ZM,Zambia,AFRO,31,1142,0,9
2020-06-04,ZM,Zambia,AFRO,12,1154,0,9
2020-06-05,ZM,Zambia,AFRO,0,1154,0,9
2020-06-06,ZM,Zambia,AFRO,0,1154,0,9
2020-06-07,ZM,Zambia,AFRO,0,1154,0,9
2020-06-08,ZM,Zambia,AFRO,0,1154,0,9
2020-03-29,ZW,Zimbabwe,AFRO,0,7,0,6
2020-03-30,ZW,Zimbabwe,AFRO,0,7,0,6
2020-03-31,ZW,Zimbabwe,AFRO,0,7,0,6
2020-04-01,ZW,Zimbabwe,AFRO,1,8,0,6
2020-04-02,ZW,Zimbabwe,AFRO,0,8,0,6
2020-04-03,ZW,Zimbabwe,AFRO,1,9,0,6
2020-04-04,ZW,Zimbabwe,AFRO,0,9,0,6
2020-04-05,ZW,Zimbabwe,AFRO,0,9,0,6
2020-04-06,ZW,Zimbabwe,AFRO,0,9,0,6
2020-04-07,ZW,Zimbabwe,AFRO,1,10,0,6
2020-04-08,ZW,Zimbabwe,AFRO,1,11,0,6
2020-04-09,ZW,Zimbabwe,AFRO,0,11,1,7
2020-04-10,ZW,Zimbabwe,AFRO,0,11,0,7
2020-04-11,ZW,Zimbabwe,AFRO,2,13,0,7
2020-04-12,ZW,Zimbabwe,AFRO,3,16,0,7
2020-04-13,ZW,Zimbabwe,AFRO,0,16,0,7
2020-04-14,ZW,Zimbabwe,AFRO,2,18,0,7
2020-04-15,ZW,Zimbabwe,AFRO,1,19,0,7
2020-04-16,ZW,Zimbabwe,AFRO,5,24,0,7
2020-04-17,ZW,Zimbabwe,AFRO,1,25,0,7
2020-04-18,ZW,Zimbabwe,AFRO,0,25,0,7
2020-04-19,ZW,Zimbabwe,AFRO,1,26,0,7
2020-04-20,ZW,Zimbabwe,AFRO,0,26,0,7
2020-04-21,ZW,Zimbabwe,AFRO,0,26,0,7
2020-04-22,ZW,Zimbabwe,AFRO,3,29,1,8
2020-04-23,ZW,Zimbabwe,AFRO,0,29,0,8
2020-04-24,ZW,Zimbabwe,AFRO,0,29,0,8
2020-04-25,ZW,Zimbabwe,AFRO,0,29,0,8
2020-04-26,ZW,Zimbabwe,AFRO,3,32,0,8
2020-04-27,ZW,Zimbabwe,AFRO,0,32,0,8
2020-04-28,ZW,Zimbabwe,AFRO,1,33,0,8
2020-04-29,ZW,Zimbabwe,AFRO,2,35,0,8
2020-04-30,ZW,Zimbabwe,AFRO,0,35,0,8
2020-05-01,ZW,Zimbabwe,AFRO,0,35,0,8
2020-05-02,ZW,Zimbabwe,AFRO,0,35,0,8
2020-05-03,ZW,Zimbabwe,AFRO,0,35,0,8
2020-05-04,ZW,Zimbabwe,AFRO,0,35,0,8
2020-05-05,ZW,Zimbabwe,AFRO,0,35,0,8
2020-05-06,ZW,Zimbabwe,AFRO,0,35,0,8
2020-05-07,ZW,Zimbabwe,AFRO,0,35,0,8
2020-05-08,ZW,Zimbabwe,AFRO,0,35,0,8
2020-05-09,ZW,Zimbabwe,AFRO,1,36,0,8
2020-05-10,ZW,Zimbabwe,AFRO,1,37,0,8
2020-05-11,ZW,Zimbabwe,AFRO,0,37,0,8
2020-05-12,ZW,Zimbabwe,AFRO,0,37,0,8
2020-05-13,ZW,Zimbabwe,AFRO,0,37,0,8
2020-05-14,ZW,Zimbabwe,AFRO,0,37,0,8
2020-05-15,ZW,Zimbabwe,AFRO,0,37,0,8
2020-05-16,ZW,Zimbabwe,AFRO,5,42,0,8
2020-05-17,ZW,Zimbabwe,AFRO,2,44,0,8
2020-05-18,ZW,Zimbabwe,AFRO,2,46,0,8
2020-05-19,ZW,Zimbabwe,AFRO,0,46,0,8
2020-05-20,ZW,Zimbabwe,AFRO,0,46,0,8
2020-05-21,ZW,Zimbabwe,AFRO,2,48,0,8
2020-05-22,ZW,Zimbabwe,AFRO,3,51,0,8
2020-05-23,ZW,Zimbabwe,AFRO,5,56,0,8
2020-05-24,ZW,Zimbabwe,AFRO,12,68,0,8
2020-05-25,ZW,Zimbabwe,AFRO,0,68,0,8
2020-05-26,ZW,Zimbabwe,AFRO,64,132,0,8
2020-05-27,ZW,Zimbabwe,AFRO,0,132,0,8
2020-05-28,ZW,Zimbabwe,AFRO,0,132,0,8
2020-05-29,ZW,Zimbabwe,AFRO,16,148,0,8
2020-05-30,ZW,Zimbabwe,AFRO,11,159,0,8
2020-05-31,ZW,Zimbabwe,AFRO,14,173,0,8
2020-06-01,ZW,Zimbabwe,AFRO,4,177,0,8
2020-06-02,ZW,Zimbabwe,AFRO,26,203,0,8
2020-06-03,ZW,Zimbabwe,AFRO,3,206,0,8
2020-06-04,ZW,Zimbabwe,AFRO,16,222,0,8
2020-06-05,ZW,Zimbabwe,AFRO,15,237,0,8
2020-06-06,ZW,Zimbabwe,AFRO,28,265,0,8
2020-06-07,ZW,Zimbabwe,AFRO,14,279,0,8
2020-06-08,ZW,Zimbabwe,AFRO,3,282,0,8
